Player,Nation,Pos,Squad,Age,Born,90s,Tackles,TacklesWon,TacklesDef3rd,TacklesMid3rd,TacklesAtt3rd,DribTkl,DribTklAtt,DribTkl%,ChallengesLost,Blocks,ShotsBlocked,PassesBlocked,Int,Tkl+Int,Clr,ErrorsLeadingToShot
Ahmed Abdullahi,NGA,MF,Gent,20-141,2004,0.0,1,0,0,1,0,0,0,,0,0,0,0,0,1,0,0
Francis Abu,GHA,MF,Cercle Brugge,23-194,2001,7.9,32,20,6,17,9,14,22,63.6,8,8,1,7,8,40,11,0
Desmond Acquah,BEL,"MF,DF",Dender,22-107,2002,1.9,5,5,0,4,1,2,12,16.7,10,4,0,4,1,6,2,0
Noah Adedeji,BEL,"FW,MF",Genk,19-141,2005,0.3,4,2,0,1,3,1,1,100.0,0,0,0,0,1,5,1,0
Lawrence Agyekum,GHA,MF,Cercle Brugge,20-350,2003,8.2,27,14,11,12,4,15,26,57.7,11,28,2,26,12,39,7,0
Takahiro Akimoto,JPN,DF,OH Leuven,26-281,1998,11.5,22,11,15,7,0,10,21,47.6,11,11,4,7,14,36,39,0
Ali Akman,TUR,"MF,DF",Dender,22-203,2002,0.4,3,2,0,1,2,2,3,66.7,1,0,0,0,0,3,0,0
Josimar Alcocer,CRC,"MF,DF",Westerlo,20-123,2004,6.8,18,15,10,7,1,7,21,33.3,14,7,1,6,9,27,10,0
Toby Alderweireld,BEL,DF,Antwerp,35-250,1989,13.0,8,5,6,2,0,6,9,66.7,3,10,7,3,13,21,44,1
Ryan Alebiosu,ENG,DF,Kortrijk,22-326,2001,4.3,10,4,7,2,1,5,6,83.3,1,1,0,1,6,16,11,0
Sotiris Alexandropoulos,GRE,"MF,FW",Standard Liège,22-347,2001,2.1,10,5,4,5,1,4,8,50.0,4,6,3,3,1,11,6,0
Arthur Alexis,BEL,MF,Sint-Truiden,18-302,2006,0.1,0,0,0,0,0,0,0,,0,0,0,0,0,0,0,0
Thierry Ambrose,GLP,FW,Kortrijk,27-224,1997,9.5,8,3,1,5,2,1,6,16.7,5,5,1,4,1,9,11,0
Francis Amuzu,BEL,FW,Anderlecht,25-076,1999,3.8,4,3,2,1,1,3,5,60.0,2,0,0,0,1,5,2,0
Frederic Ananou,TOG,"DF,MF",Sint-Truiden,27-048,1997,2.2,9,6,7,2,0,7,9,77.8,2,0,0,0,2,11,8,0
Stelios Andreou,CYP,DF,Charleroi,22-106,2002,12.0,25,15,21,3,1,12,17,70.6,5,19,14,5,22,47,46,1
Nilson Angulo,ECU,FW,Anderlecht,21-141,2003,2.6,5,2,0,3,2,0,4,0.0,4,2,0,2,1,6,2,0
Tiago Araújo,POR,"DF,FW",Gent,23-225,2001,1.3,3,2,1,1,1,1,3,33.3,2,2,1,1,0,3,5,0
Kristian Arnstad,NOR,DF,Anderlecht,21-061,2003,0.3,0,0,0,0,0,0,0,,0,0,0,0,1,1,0,0
Tolu Arokodare,NGA,FW,Genk,23-350,2000,11.6,13,7,2,6,5,4,9,44.4,5,3,0,3,2,15,15,0
Raymond Asante,GHA,FW,Charleroi,20-164,2004,0.2,0,0,0,0,0,0,0,,0,0,0,0,0,0,0,0
Majeed Ashimeru,GHA,MF,Anderlecht,27-028,1997,3.7,9,7,5,3,1,2,5,40.0,3,0,0,0,5,14,4,0
Ludwig Augustinsson,SWE,DF,Anderlecht,30-200,1994,3.9,11,9,5,5,1,4,7,57.1,3,2,2,0,4,15,11,0
Felipe Augusto,BRA,"FW,MF",Cercle Brugge,20-263,2004,5.2,5,5,1,2,2,2,2,100.0,0,4,1,3,2,7,3,0
Muhammed Badamosi,GAM,"FW,DF",Standard Liège,25-316,1998,0.7,1,0,0,1,0,0,0,,0,0,0,0,0,1,1,0
Youssouph Badji,SEN,FW,Charleroi,22-323,2001,2.3,2,1,1,0,1,1,2,50.0,1,3,0,3,0,2,3,0
Bilal Bafdili,BEL,"MF,FW",Mechelen,20-096,2004,5.3,8,6,1,5,2,2,4,50.0,2,2,1,1,0,8,0,0
Michel-Ange Balikwisha,BEL,FW,Antwerp,23-181,2001,1.0,1,1,0,1,0,0,0,,0,4,0,4,3,4,0,0
William Balikwisha,COD,"FW,MF",OH Leuven,25-179,1999,7.5,16,9,5,8,3,5,5,100.0,0,10,0,10,8,24,6,0
Sacha Banse,BFA,MF,Standard Liège,23-236,2001,0.4,2,1,1,1,0,0,0,,0,1,0,1,0,2,3,0
Ezechiel Banzuzi,NED,MF,OH Leuven,19-265,2005,10.8,23,14,8,10,5,8,14,57.1,6,12,6,6,7,30,24,0
Joselpho Barnes,GHA,"FW,MF",Sint-Truiden,22-331,2001,1.2,2,0,0,2,0,0,0,,0,2,0,2,0,2,2,0
Jelle Bataille,BEL,DF,Antwerp,25-171,1999,9.3,27,18,15,9,3,17,32,53.1,15,16,3,13,11,38,11,0
David Bates,SCO,DF,Standard Liège,28-033,1996,8.6,16,11,12,4,0,8,9,88.9,1,15,11,4,17,33,47,0
Emin Bayram,TUR,DF,Westerlo,21-219,2003,6.0,8,4,3,5,0,4,7,57.1,3,10,5,5,11,19,26,1
Zineddine Belaid,ALG,DF,Sint-Truiden,25-232,1999,0.8,0,0,0,0,0,0,0,,0,0,0,0,0,0,3,1
Rafik Belghali,ALG,"DF,MF",Mechelen,22-153,2002,4.7,14,10,9,5,0,11,13,84.6,2,9,0,9,4,18,7,0
Soufiane Benjdida,MAR,FW,Standard Liège,23-063,2001,6.1,2,1,0,2,0,2,4,50.0,2,5,0,5,2,4,5,0
Antoine Bernier,BEL,FW,Charleroi,27-058,1997,9.0,15,11,2,10,3,5,13,38.5,8,9,0,9,2,17,2,0
Adriano Bertaccini,BEL,"FW,MF",Sint-Truiden,24-086,2000,9.7,11,6,4,4,3,3,11,27.3,8,5,2,3,0,11,5,0
Mohamed Berte,BEL,FW,Dender,22-227,2002,4.9,7,4,0,4,3,2,10,20.0,8,3,0,3,1,8,0,0
Mickaël Biron,MTQ,"MF,FW",OH Leuven,27-073,1997,1.0,3,2,1,2,0,0,1,0.0,1,1,0,1,0,3,1,0
Sinan Bolat,TUR,GK,Westerlo,36-065,1988,11.0,1,0,1,0,0,1,1,100.0,0,0,0,0,0,1,2,2
Boli Bolingoli-Mbombo,BEL,DF,Standard Liège,29-129,1995,0.5,0,0,0,0,0,0,4,0.0,4,1,1,0,0,0,2,0
Christopher Bonsu Baah,GHA,"FW,MF",Genk,19-329,2004,8.5,19,14,5,11,3,5,10,50.0,5,3,0,3,5,24,6,0
Jordan Bos,AUS,DF,Westerlo,22-009,2002,3.5,3,2,1,1,1,0,2,0.0,2,8,1,7,6,9,13,0
Sofiane Boufal,MAR,MF,Union SG,31-051,1993,1.2,7,4,5,1,1,3,4,75.0,1,1,0,1,1,8,0,0
Amine Boukamir,BEL,MF,Charleroi,18-015,2006,0.1,0,0,0,0,0,0,0,,0,0,0,0,0,0,0,0
Rosen Bozhinov,BUL,DF,Antwerp,19-289,2005,0.0,0,0,0,0,0,0,0,,0,1,1,0,0,0,0,1
Bilal Brahimi,ALG,"MF,FW",Sint-Truiden,24-238,2000,5.4,1,1,0,1,0,0,5,0.0,5,2,0,2,2,3,1,1
Archie Brown,ENG,DF,Gent,22-163,2002,12.0,21,14,11,7,3,11,17,64.7,6,20,5,15,8,29,36,2
Bruninho,BRA,"MF,FW",Cercle Brugge,21-238,2003,3.5,1,0,1,0,0,1,6,16.7,5,1,0,1,1,2,2,0
Paris Brunner,GER,"MF,FW",Cercle Brugge,18-266,2006,0.8,2,0,1,1,0,1,1,100.0,0,0,0,0,0,2,0,0
Massimo Bruno,BEL,MF,Kortrijk,31-051,1993,4.7,13,6,8,3,2,6,12,50.0,6,8,1,7,1,14,7,0
Marko Bulat,CRO,"MF,FW",Standard Liège,23-042,2001,10.8,19,15,6,8,5,8,16,50.0,8,8,4,4,10,29,11,0
Christian Burgess,ENG,DF,Union SG,33-031,1991,6.0,7,3,4,3,0,6,10,60.0,4,10,6,4,4,11,28,0
Welat Cagro,BEL,MF,Beerschot,25-160,1999,5.9,13,8,4,7,2,4,8,50.0,4,10,0,10,5,18,2,0
Alexandro Calut,BEL,"DF,MF",Standard Liège,21-199,2003,1.3,2,1,1,1,0,0,2,0.0,2,0,0,0,2,4,4,0
Etienne Camara,FRA,MF,Charleroi,21-222,2003,10.6,25,12,9,15,1,9,18,50.0,9,9,2,7,9,34,10,0
Ilay Camara,BEL,DF,Standard Liège,21-294,2003,8.7,15,10,9,6,0,13,19,68.4,6,9,1,8,8,23,13,0
Alessio Castro-Montes,BEL,"DF,FW",Union SG,27-174,1997,9.2,16,8,6,6,4,7,17,41.2,10,16,2,14,8,24,8,0
Tjaronn Chery,SUR,"MF,FW",Antwerp,36-156,1988,11.3,9,6,5,3,1,3,9,33.3,6,1,0,1,0,9,3,0
Antoine Colassin,BEL,"FW,MF",Beerschot,23-255,2001,3.8,9,6,3,3,3,6,10,60.0,4,4,0,4,2,11,5,0
Kobe Cools,BEL,DF,Dender,27-105,1997,13.0,16,6,12,3,1,5,8,62.5,3,23,20,3,26,42,90,1
Colin Coosemans,BEL,GK,Anderlecht,32-096,1992,13.0,1,1,1,0,0,1,3,33.3,2,0,0,0,0,1,10,1
Jo Coppens,BEL,GK,Sint-Truiden,33-322,1990,3.0,0,0,0,0,0,0,0,,0,0,0,0,0,0,1,0
Kobe Corbanie,BEL,"MF,DF",Antwerp,19-181,2005,5.8,11,9,5,5,1,7,11,63.6,4,7,4,3,6,17,7,0
Ayrton Costa,ARG,DF,Antwerp,25-118,1999,11.1,40,26,24,12,4,24,41,58.5,17,19,5,14,28,68,33,0
Carlos Cuesta,COL,DF,Genk,25-243,1999,2.5,6,5,2,4,0,1,1,100.0,0,1,0,1,1,7,7,0
Oday Dabbagh,PLE,FW,Charleroi,25-340,1998,4.1,2,2,0,1,1,0,2,0.0,2,2,0,2,0,2,1,0
Colin Dagba,FRA,"MF,FW",Beerschot,26-059,1998,3.7,16,8,9,4,3,7,14,50.0,7,6,2,4,4,20,5,0
Jón Dagur Þorsteinsson,ISL,"MF,FW",OH Leuven,25-347,1998,1.0,1,1,0,0,1,0,1,0.0,1,0,0,0,1,2,1,0
Jesper Daland,NOR,DF,Cercle Brugge,24-306,2000,2.0,3,2,2,1,0,1,1,100.0,0,3,2,1,2,5,10,0
Tobi David,CAN,FW,Union SG,23-127,2001,2.4,1,1,0,1,0,1,2,50.0,1,0,0,0,0,1,4,0
Maxim De Cuyper,BEL,DF,Club Brugge,23-321,2000,12.1,19,13,16,3,0,9,19,47.4,10,12,3,9,8,27,31,1
Dion De Neve,BEL,"DF,MF",Kortrijk,22-148,2002,9.1,23,11,15,5,3,12,20,60.0,8,15,2,13,6,29,23,0
Kamiel Van De Perre,BEL,MF,Union SG,20-269,2004,0.4,3,2,3,0,0,1,3,33.3,2,1,0,1,0,3,3,0
Nils De Wilde,BEL,MF,Cercle Brugge,21-285,2003,0.3,0,0,0,0,0,0,3,0.0,3,1,0,1,0,0,2,0
Ortwin De Wolf,BEL,GK,Mechelen,27-198,1997,13.0,0,0,0,0,0,0,1,0.0,1,0,0,0,1,1,6,2
Max Dean,ENG,FW,Gent,20-260,2004,4.7,2,1,0,1,1,1,6,16.7,5,2,0,2,0,2,2,0
Théo Defourny,BEL,GK,Charleroi,32-196,1992,1.0,0,0,0,0,0,0,0,,0,0,0,0,0,0,0,0
Tristan Degreef,BEL,"MF,FW",Anderlecht,19-293,2005,1.1,1,1,0,1,0,1,2,50.0,1,1,0,1,1,2,2,0
Brecht Dejaegere,BEL,MF,Kortrijk,33-162,1991,5.1,15,10,4,8,3,4,10,40.0,6,13,3,10,11,26,4,0
Maxime Delanghe,BEL,GK,Cercle Brugge,23-168,2001,4.0,0,0,0,0,0,0,0,,0,0,0,0,0,0,5,0
Martin Delavallée,BEL,GK,Charleroi,20-234,2004,1.0,0,0,0,0,0,0,0,,0,0,0,0,0,0,0,0
Mathias Delorge,BEL,MF,Gent,20-099,2004,12.8,30,18,7,20,3,19,39,48.7,20,11,3,8,16,46,17,2
Isaías Delpupo,ARG,"MF,DF",Sint-Truiden,21-221,2003,0.3,2,0,0,2,0,2,2,100.0,0,2,0,2,0,2,1,0
Bas van den Eynden,BEL,DF,Mechelen,22-305,2002,5.0,8,6,6,2,0,3,6,50.0,3,14,9,5,7,15,31,0
Leander Dendoncker,BEL,"DF,MF",Anderlecht,29-206,1995,6.0,11,9,6,4,1,3,11,27.3,8,7,3,4,7,18,14,0
Kévin Denkey,TOG,FW,Cercle Brugge,23-343,2000,10.7,5,4,0,3,2,2,2,100.0,0,6,0,6,0,5,2,0
Alfie Devine,ENG,MF,Westerlo,20-098,2004,6.5,9,4,2,5,2,5,8,62.5,3,3,0,3,6,15,3,0
Julien Devriendt,BEL,GK,Dender,25-348,1998,2.0,1,0,1,0,0,1,1,100.0,0,0,0,0,0,1,2,0
Gilles Dewaele,BEL,DF,Kortrijk,28-268,1996,5.0,4,3,2,1,1,2,5,40.0,3,2,1,1,8,12,13,0
Ibrahim Diakité,GUI,"DF,MF",Cercle Brugge,21-007,2003,5.0,7,4,4,3,0,4,6,66.7,2,16,3,13,8,15,18,0
Guillaume Dietsch,FRA,GK,Dender,23-204,2001,0.5,0,0,0,0,0,0,0,,0,0,0,0,0,0,0,0
Alouis Diriken,BEL,MF,Sint-Truiden,20-308,2004,1.6,2,0,1,1,0,1,3,33.3,2,0,0,0,2,4,1,0
Kasper Dolberg,DEN,FW,Anderlecht,27-032,1997,10.5,4,4,2,1,1,2,6,33.3,4,2,0,2,0,4,6,1
Mahamadou Doumbia,MLI,MF,Antwerp,20-176,2004,10.4,19,14,8,10,1,5,13,38.5,8,9,4,5,9,28,12,1
Souleyman Doumbia,CIV,DF,Standard Liège,28-044,1996,0.1,0,0,0,0,0,0,0,,0,0,0,0,0,0,0,0
Vetle Dragsnes,NOR,DF,Charleroi,30-275,1994,11.3,17,11,10,6,1,8,21,38.1,13,12,3,9,6,23,28,0
Anders Dreyer,DEN,FW,Anderlecht,26-189,1998,9.0,6,5,2,3,1,2,5,40.0,3,4,1,3,1,7,6,0
Olivier Dumont,BEL,"MF,FW",Sint-Truiden,22-246,2002,2.3,8,6,6,1,1,4,7,57.1,3,0,0,0,1,9,3,0
Dennis Eckert,GER,FW,Standard Liège,27-303,1997,5.3,5,3,0,4,1,0,1,0.0,1,2,0,2,2,7,3,0
Dennis Eckert,GER,FW,Union SG,27-303,1997,2.2,1,0,0,0,1,0,1,0.0,1,3,1,2,0,1,0,0
Samuel Edozie,ENG,"FW,MF",Anderlecht,21-284,2003,4.9,5,4,2,1,2,2,2,100.0,0,2,0,2,1,6,0,0
Malamine Efekele,FRA,"MF,FW",Cercle Brugge,20-111,2004,1.7,1,1,0,1,0,0,0,,0,0,0,0,1,2,2,0
Jurgen Ekkelenkamp,NED,MF,Antwerp,24-216,2000,0.7,0,0,0,0,0,0,0,,0,0,0,0,0,0,1,0
Matthieu Epolo,BEL,GK,Standard Liège,20-297,2004,13.0,1,1,1,0,0,1,2,50.0,1,0,0,0,0,1,10,1
Alieu Fadera,GAM,MF,Genk,23-004,2001,2.0,11,10,7,1,3,3,7,42.9,4,4,0,4,2,13,0,1
Noah Fadiga,SEN,"DF,MF",Gent,24-340,1999,8.9,11,8,4,5,2,4,5,80.0,1,10,1,9,4,15,10,0
Omar Fayed,EGY,"DF,MF",Beerschot,21-126,2003,1.3,5,4,3,2,0,2,2,100.0,0,0,0,0,1,6,6,0
Matias Fernandez-Pardo,BEL,"MF,FW",Gent,19-278,2005,1.8,0,0,0,0,0,0,2,0.0,2,2,0,2,0,0,0,0
Andrés Ferrari,URU,FW,Sint-Truiden,21-309,2003,1.0,1,1,0,1,0,1,1,100.0,0,0,0,0,0,1,2,0
Fabio Ferraro,BEL,DF,Dender,22-065,2002,11.4,24,16,15,5,4,17,29,58.6,12,15,1,14,12,36,35,0
Nacho Ferri,ESP,FW,Kortrijk,20-033,2004,8.6,9,9,2,2,5,2,6,33.3,4,8,1,7,0,9,5,0
Karol Fila,POL,DF,Dender,26-147,1998,2.8,6,4,3,2,1,3,7,42.9,4,3,0,3,6,12,3,0
Mathias Fixelles,BEL,MF,Westerlo,28-088,1996,0.0,3,1,0,3,0,2,2,100.0,0,0,0,0,0,3,0,0
Alexis Flips,FRA,FW,Anderlecht,24-294,2000,0.0,0,0,0,0,0,0,0,,0,0,0,0,0,0,0,0
Alexis Flips,FRA,"FW,MF",Charleroi,24-294,2000,2.2,5,0,5,0,0,3,7,42.9,4,1,0,1,2,7,3,0
Thomas Foket,BEL,DF,Anderlecht,30-043,1994,1.2,2,0,1,1,0,1,1,100.0,0,1,0,1,2,4,3,0
Núrio Fortuna,ANG,"MF,DF",Gent,29-228,1995,0.1,0,0,0,0,0,0,0,,0,0,0,0,0,0,1,0
Marlon Fossey,USA,DF,Standard Liège,26-059,1998,11.1,13,9,5,6,2,4,7,57.1,3,12,3,9,14,27,40,0
Iver Fossum,NOR,MF,Kortrijk,28-115,1996,2.5,10,5,3,5,2,7,12,58.3,5,6,1,5,1,11,2,0
Daam Foulon,BEL,"DF,MF",Mechelen,25-229,1999,11.4,21,12,11,6,4,15,28,53.6,13,6,2,4,7,28,26,0
Guillaume François,BEL,"FW,DF",Union SG,34-157,1990,1.2,2,0,0,2,0,1,1,100.0,0,0,0,0,3,5,2,0
Matija Frigan,CRO,FW,Westerlo,21-270,2003,8.1,4,2,0,2,2,1,2,50.0,1,1,1,0,1,5,5,0
Haruya Fujii,JPN,DF,Kortrijk,23-317,2000,10.2,15,7,11,4,0,6,11,54.5,5,12,7,5,11,26,49,0
Joel Fujita,JPN,MF,Sint-Truiden,22-265,2002,10.7,20,11,11,8,1,5,18,27.8,13,14,2,12,14,34,18,1
Mohammed Fuseini,GHA,FW,Union SG,22-175,2002,9.4,6,5,3,2,1,1,8,12.5,7,5,0,5,6,12,1,0
Hugo Gambor,CTA,DF,Gent,21-313,2002,6.9,16,9,9,6,1,7,8,87.5,1,9,1,8,16,32,7,0
Omri Gandelman,ISR,MF,Gent,24-175,2000,7.7,17,11,5,7,5,8,14,57.1,6,8,2,6,4,21,8,1
Wouter George,BEL,DF,OH Leuven,22-249,2002,0.1,2,0,0,2,0,1,3,33.3,2,1,0,1,0,2,0,0
Pieter Gerkens,BEL,MF,Gent,29-086,1995,5.1,8,6,3,3,2,3,11,27.3,8,9,2,7,6,14,10,0
Faisal Al Ghamdi,KSA,MF,Beerschot,23-086,2001,4.7,12,9,8,3,1,6,12,50.0,6,5,2,3,6,18,9,0
Óscar Gil,ESP,DF,OH Leuven,27-195,1997,5.0,11,5,7,4,0,4,9,44.4,5,9,1,8,5,16,14,0
Bruno Godeau,BEL,DF,Sint-Truiden,32-181,1992,12.8,20,16,14,5,1,14,20,70.0,6,20,14,6,16,36,79,0
Bryan Goncalves,FRA,DF,Dender,28-111,1996,4.4,9,4,6,3,0,7,13,53.8,6,4,3,1,7,16,22,1
Parfait Guiagon,CIV,FW,Charleroi,23-259,2001,8.8,14,12,1,9,4,4,9,44.4,5,6,0,6,1,15,3,0
Muhammed Gümüskaya,TUR,FW,Westerlo,23-311,2001,0.1,0,0,0,0,0,0,0,,0,0,0,0,0,0,0,0
Patrik Gunnarsson,ISL,GK,Kortrijk,23-358,2000,10.2,0,0,0,0,0,0,0,,0,1,0,1,0,0,4,1
Andri Guðjohnsen,ISL,FW,Gent,22-283,2002,7.6,9,6,0,5,4,1,2,50.0,1,5,0,5,0,9,3,0
Anouar Ait El Hadj,BEL,MF,Union SG,22-201,2002,4.9,13,9,3,7,3,6,15,40.0,9,7,0,7,2,15,0,0
Geoffry Hairemans,BEL,"MF,FW",Mechelen,33-017,1991,2.6,4,2,0,2,2,1,5,20.0,4,6,1,5,2,6,3,0
Dogucan Haspolat,TUR,MF,Westerlo,24-270,2000,13.0,41,27,10,28,3,16,34,47.1,18,21,6,15,30,71,32,0
Ibe Hautekiet,BEL,DF,Standard Liège,22-208,2002,10.3,18,14,10,6,2,7,13,53.8,6,11,5,6,17,35,35,0
Ewan Henderson,SCO,MF,Beerschot,24-225,2000,6.2,7,5,1,3,3,4,7,57.1,3,8,3,5,3,10,8,0
Lennard Hens,BEL,MF,Dender,28-273,1996,7.4,19,12,2,12,5,9,26,34.6,17,15,3,12,12,31,7,0
Daan Heymans,BEL,MF,Charleroi,25-145,1999,12.5,22,16,3,15,4,4,9,44.4,5,10,2,8,5,27,10,0
Bryan Heynen,BEL,MF,Genk,27-275,1997,9.1,15,11,7,7,1,5,16,31.3,11,13,5,8,12,27,23,0
David Hrnčár,SVK,"DF,MF",Dender,26-333,1997,7.9,12,6,8,4,0,7,13,53.8,6,5,1,4,10,22,20,0
Patrik Hrošovský,SVK,MF,Genk,32-199,1992,9.8,10,5,1,6,3,4,9,44.4,5,8,1,7,3,13,12,0
Dean Huiberts,NED,MF,Beerschot,24-175,2000,3.0,12,5,6,5,1,7,10,70.0,3,4,2,2,5,17,4,0
Oh Hyeon-gyu,KOR,FW,Genk,23-209,2001,1.7,1,1,0,0,1,1,3,33.3,2,0,0,0,0,1,1,0
Hong Hyunseok,KOR,MF,Gent,25-144,1999,2.8,4,2,2,2,0,1,6,16.7,5,2,0,2,1,5,1,0
Mounaim El Idrissy,FRA,"DF,FW",Kortrijk,25-271,1999,3.4,7,7,6,1,0,1,4,25.0,3,3,1,2,4,11,6,0
Chukwubuikem Ikwuemesi,NGA,FW,OH Leuven,23-094,2001,5.1,2,2,0,1,1,0,1,0.0,1,4,1,3,2,4,3,0
Atsuki Ito,JPN,MF,Gent,26-088,1998,6.1,20,13,5,11,4,9,19,47.4,10,6,2,4,9,29,18,1
Ryotaro Ito,JPN,MF,Sint-Truiden,26-275,1998,8.9,9,8,5,3,1,4,10,40.0,6,5,1,4,3,12,3,0
Franjo Ivanović,CRO,FW,Union SG,21-037,2003,5.6,5,2,1,2,2,0,8,0.0,8,6,1,5,0,5,4,0
Vincent Janssen,NED,FW,Antwerp,30-145,1994,12.8,19,17,4,12,3,12,21,57.1,9,7,0,7,5,24,12,0
Wolke Janssens,BEL,DF,Sint-Truiden,29-301,1995,1.0,2,0,2,0,0,1,2,50.0,1,1,0,1,1,3,9,0
Ardon Jashari,SUI,MF,Club Brugge,22-100,2002,6.1,10,6,6,3,1,2,7,28.6,5,2,1,1,7,17,8,0
Edisson Jordanov,BUL,DF,Westerlo,31-152,1993,0.8,1,1,1,0,0,1,2,50.0,1,1,0,1,2,3,2,0
Ferran Jutglà,ESP,"FW,MF",Club Brugge,25-280,1999,3.4,6,2,1,3,2,2,2,100.0,0,2,1,1,0,6,2,0
Mathias Jørgensen,DEN,DF,Anderlecht,34-198,1990,9.0,10,5,8,2,0,7,11,63.6,4,16,13,3,8,18,35,0
Elton Kabangu,BEL,"FW,MF",Union SG,26-273,1998,1.4,1,0,0,0,1,0,1,0.0,1,0,0,0,0,1,0,0
Abdelkahar Kadri,ALG,"MF,FW",Kortrijk,24-136,2000,9.1,21,13,9,7,5,9,18,50.0,9,14,2,12,10,31,4,1
Emmanuel Kakou,CIV,DF,Cercle Brugge,19-130,2005,7.0,12,6,9,3,0,4,15,26.7,11,13,4,9,11,23,23,0
Ismaël Kandouss,MAR,MF,Gent,26-361,1997,0.0,0,0,0,0,0,0,0,,0,0,0,0,0,0,2,0
Takuro Kaneko,JPN,"MF,FW",Kortrijk,27-100,1997,8.1,15,11,6,6,3,8,14,57.1,6,12,1,11,6,21,6,0
Konstantinos Karetsas,BEL,MF,Genk,16-354,2007,5.0,8,4,2,2,4,5,9,55.6,4,7,0,7,0,8,0,0
Joris Kayembe,COD,"DF,MF",Genk,30-091,1994,12.9,26,17,16,7,3,12,19,63.2,7,7,2,5,19,45,28,1
Charly Keita,FRA,FW,Beerschot,25-144,1999,6.6,2,0,0,2,0,0,2,0.0,2,10,2,8,1,3,8,0
Check Keita,FRA,DF,Charleroi,21-219,2003,6.6,16,10,12,4,0,11,11,100.0,0,8,3,5,5,21,14,0
Mandela Keita,BEL,"MF,DF",Antwerp,22-181,2002,2.6,7,3,3,3,1,5,7,71.4,2,2,1,1,5,12,3,0
Gyrano Kerk,SUR,"FW,MF",Antwerp,28-341,1995,9.6,11,9,8,2,1,4,19,21.1,15,10,0,10,2,13,5,1
Anan Khalaili,ISR,"DF,FW",Union SG,20-065,2004,2.8,9,4,5,3,1,3,5,60.0,2,4,0,4,3,12,4,0
Bilal El Khannouss,MAR,MF,Genk,20-181,2004,0.8,2,1,1,0,1,0,0,,0,1,0,1,0,2,3,0
Leo Kokubo,JPN,GK,Sint-Truiden,23-289,2001,10.0,0,0,0,0,0,0,0,,0,0,0,0,0,0,5,1
Mory Konaté,GUI,MF,Mechelen,30-358,1993,1.0,0,0,0,0,0,0,0,,0,1,0,1,0,0,3,0
Mohamed Koné,CIV,GK,Charleroi,22-245,2002,11.0,0,0,0,0,0,0,1,0.0,1,0,0,0,0,0,4,1
Josué Kongolo,BEL,DF,Genk,18-208,2006,0.8,3,3,0,3,0,1,1,100.0,0,0,0,0,2,5,5,0
Tolis Konstantopoulos,GRE,DF,Beerschot,22-097,2002,9.7,32,22,22,8,2,18,30,60.0,12,17,7,10,16,48,49,0
Ayouba Kosiah,LBR,"FW,DF",Beerschot,23-108,2001,2.3,3,2,0,3,0,1,2,50.0,1,1,0,1,0,3,0,0
Florian Krüger,GER,"FW,MF",Beerschot,25-268,1999,1.3,1,0,0,0,1,1,3,33.3,2,2,0,2,0,1,1,0
Léandre Kuavita,BEL,MF,Standard Liège,20-160,2004,7.0,8,4,1,5,2,6,9,66.7,3,9,1,8,5,13,11,0
Sven Kums,BEL,MF,Gent,36-255,1988,4.0,9,4,3,2,4,4,12,33.3,8,6,2,4,2,11,7,0
Hasan Kuruçay,,DF,OH Leuven,27-068,1997,4.5,6,3,5,1,0,4,5,80.0,1,1,1,0,2,8,20,0
Roman Květ,CZE,"MF,FW",Dender,26-326,1997,8.9,17,8,4,6,7,8,22,36.4,14,14,1,13,7,24,7,0
Grejohn Kyei,FRA,FW,Charleroi,29-087,1995,3.7,3,1,0,3,0,2,2,100.0,0,2,1,1,0,3,3,0
Grejohn Kyei,FRA,"FW,MF",Standard Liège,29-087,1995,2.4,2,1,1,0,1,2,3,66.7,1,0,0,0,0,2,6,0
Bram Lagae,BEL,DF,Kortrijk,20-298,2004,9.0,12,8,9,3,0,8,15,53.3,7,17,8,9,9,21,45,2
Hugo Lambotte,BEL,MF,Sint-Truiden,18-140,2006,0.4,0,0,0,0,0,0,2,0.0,2,3,0,3,0,0,0,0
Senne Lammens,BEL,GK,Antwerp,22-123,2002,13.0,0,0,0,0,0,0,0,,0,0,0,0,0,0,2,0
Amando Lapage,BEL,DF,Anderlecht,19-365,2004,0.1,0,0,0,0,0,0,0,,0,0,0,0,0,0,2,0
Loïc Lapoussin,MAD,DF,Union SG,28-225,1996,1.0,0,0,0,0,0,0,2,0.0,2,4,1,3,5,5,2,0
Lion Lauberbach,GER,FW,Mechelen,26-266,1998,7.8,3,1,1,2,0,0,2,0.0,2,2,0,2,0,3,7,0
Henry Lawrence,ENG,DF,Standard Liège,23-047,2001,7.6,9,5,5,3,1,4,10,40.0,6,8,5,3,7,16,23,0
Theo Leoni,BEL,"MF,DF",Anderlecht,24-200,2000,9.2,16,13,6,7,3,10,17,58.8,7,8,0,8,17,33,18,0
Fedde Leysen,BEL,DF,Union SG,21-121,2003,7.8,12,9,8,3,1,6,8,75.0,2,8,3,5,14,26,22,0
Tobe Leysen,BEL,GK,OH Leuven,22-243,2002,13.0,0,0,0,0,0,0,0,,0,0,0,0,1,1,2,1
Jonas Lietaert,BEL,DF,Cercle Brugge,20-114,2004,0.6,3,3,1,2,0,2,6,33.3,4,1,0,1,1,4,3,0
Ridwane M'Barki,BEL,"DF,MF",Dender,30-128,1994,1.4,2,2,1,0,1,2,5,40.0,3,7,1,6,2,4,3,0
Kevin Mac Allister,ARG,DF,Union SG,27-000,1997,10.6,33,22,15,16,2,16,35,45.7,19,18,7,11,24,57,39,0
Koki Machida,JPN,DF,Union SG,27-074,1997,12.0,12,9,9,2,1,8,19,42.1,11,11,8,3,23,35,47,0
Nicolas Madsen,DEN,MF,Westerlo,24-235,2000,4.0,10,7,4,5,1,5,8,62.5,3,3,1,2,3,13,8,0
Mathieu Maertens,BEL,"FW,MF",OH Leuven,29-225,1995,8.6,6,5,2,2,2,1,7,14.3,6,10,1,9,5,11,6,0
Gary Magnée,BEL,"DF,MF",Cercle Brugge,25-026,1999,5.0,12,9,8,4,0,8,12,66.7,4,11,2,9,11,23,14,0
Mark Mampasi,UKR,DF,Kortrijk,21-240,2003,5.8,11,6,5,4,2,5,8,62.5,3,6,3,3,3,14,28,0
José Marsà,ESP,DF,Mechelen,22-248,2002,10.8,14,12,8,6,0,6,13,46.2,7,25,14,11,13,27,36,1
Ar'jany Martha,NED,"MF,DF",Beerschot,21-064,2003,4.4,20,7,13,6,1,10,22,45.5,12,10,3,7,10,30,18,1
Kéres Masangu,BEL,"MF,FW",Dender,24-245,2000,0.1,0,0,0,0,0,0,0,,0,1,0,1,0,0,1,0
Davor Matijas,CRO,GK,Beerschot,25-076,1999,7.0,2,2,2,0,0,2,2,100.0,0,0,0,0,0,2,8,0
Hervé Matthys,BEL,DF,Beerschot,28-293,1996,10.1,9,5,5,4,0,6,16,37.5,10,15,11,4,19,28,32,0
Youssef Maziz,FRA,"MF,FW",OH Leuven,26-136,1998,8.1,5,2,3,2,0,2,3,66.7,1,5,0,5,4,9,5,0
Loïc Mbe Soh,FRA,DF,Beerschot,23-147,2001,6.0,6,4,5,1,0,2,5,40.0,3,8,6,2,7,13,36,0
Isaac Mbenza,BEL,FW,Charleroi,28-244,1996,4.3,3,2,0,2,1,1,4,25.0,3,1,1,0,1,4,8,0
Mark McKenzie,USA,FW,Genk,25-256,1999,0.0,0,0,0,0,0,0,0,,0,0,0,0,0,0,0,0
Dire Mebude,SCO,FW,Westerlo,20-163,2004,6.3,4,3,1,2,1,2,8,25.0,6,5,0,5,3,7,5,0
Brandon Mechele,BEL,DF,Club Brugge,31-284,1993,13.0,21,13,14,6,1,9,16,56.3,7,16,8,8,19,40,55,0
Nayel Mehssatou,CHI,"MF,DF",Kortrijk,22-210,2002,9.6,25,13,8,12,5,11,19,57.9,8,14,2,12,11,36,19,0
Bjorn Meijer,NED,DF,Club Brugge,21-234,2003,0.1,0,0,0,0,0,0,0,,0,1,0,1,0,0,1,0
Hamza Mendyl,MAR,"DF,MF",OH Leuven,27-017,1997,4.4,12,9,6,6,0,6,9,66.7,3,8,2,6,4,16,16,0
Billel Messaoudi,ALG,"FW,MF",Kortrijk,26-322,1997,1.4,1,1,1,0,0,0,2,0.0,2,1,0,1,0,1,1,0
Senna Miangue,BEL,DF,Cercle Brugge,27-276,1997,7.3,7,6,3,4,0,7,12,58.3,5,8,3,5,11,18,44,0
Simion Michez,BEL,"DF,MF",Beerschot,22-272,2002,5.4,15,7,4,10,1,10,12,83.3,2,12,0,12,7,22,14,0
Simon Mignolet,BEL,GK,Club Brugge,36-246,1988,13.0,1,1,1,0,0,1,1,100.0,0,0,0,0,0,1,2,1
Alan Minda,ECU,"FW,MF",Cercle Brugge,21-177,2003,5.2,4,2,2,0,2,4,6,66.7,2,3,0,3,1,5,0,0
David Mindombe,BEL,DF,Sint-Truiden,23-141,2001,1.0,0,0,0,0,0,0,0,,0,0,0,0,1,1,10,0
Stefan Mitrović,SRB,FW,OH Leuven,22-084,2002,2.9,3,2,2,1,0,2,5,40.0,3,3,0,3,2,5,2,0
Stefan Mitrović,SRB,DF,Gent,34-169,1990,9.3,16,8,13,3,0,14,17,82.4,3,13,10,3,9,25,48,0
Anthony Moris,LUX,GK,Union SG,34-192,1990,13.0,0,0,0,0,0,0,0,,0,0,0,0,0,0,9,1
Kerim Mrabti,SWE,"MF,FW",Mechelen,30-171,1994,10.1,11,5,4,6,1,6,13,46.2,7,8,4,4,6,17,8,0
Suphanat Mueanta,THA,"FW,MF",OH Leuven,22-097,2002,0.7,1,1,0,1,0,0,0,,0,0,0,0,0,1,1,0
Moussa N'Diaye,SEN,DF,Anderlecht,22-142,2002,8.5,16,11,10,5,1,7,11,63.6,4,5,1,4,10,26,25,1
Ignace N'Dri,CIV,"FW,DF",OH Leuven,24-011,2000,11.0,25,14,10,10,5,6,14,42.9,8,11,2,9,4,29,6,0
Flávio Nazinho,POR,DF,Cercle Brugge,21-110,2003,8.4,25,17,12,10,3,16,25,64.0,9,13,1,12,17,42,22,2
Roman Neustädter,RUS,DF,Westerlo,36-263,1988,9.0,13,4,8,5,0,8,12,66.7,4,9,3,6,13,26,44,0
Julien Ngoy,BEL,FW,Mechelen,27-005,1997,0.8,0,0,0,0,0,0,0,,0,0,0,0,0,0,2,0
Nathan Ngoy,BEL,DF,Standard Liège,21-150,2003,2.7,8,5,6,2,0,5,7,71.4,2,6,4,2,5,13,15,0
Adam Nhaili,BEL,"FW,MF",Sint-Truiden,19-090,2005,1.9,2,1,2,0,0,0,1,0.0,1,1,0,1,1,3,0,0
Ousseynou Niang,SEN,"DF,FW",Union SG,23-026,2001,3.8,13,11,6,5,2,7,18,38.9,11,6,1,5,2,15,2,0
Casper Nielsen,DEN,MF,Club Brugge,30-192,1994,1.1,1,0,0,1,0,0,0,,0,0,0,0,1,2,3,0
Gustaf Nilsson,SWE,FW,Club Brugge,27-168,1997,8.2,5,2,1,2,2,2,3,66.7,1,6,2,4,2,7,8,0
Ken Nkuba,BEL,"MF,DF",Genk,22-291,2002,1.5,7,5,5,1,1,1,5,20.0,4,2,0,2,2,9,3,0
Petter Nosa Dahl,NOR,"MF,FW",Mechelen,21-290,2003,2.0,7,4,1,2,4,4,5,80.0,1,3,0,3,3,10,1,0
Lucas Noubi,BEL,DF,Standard Liège,19-297,2005,1.5,2,0,0,2,0,1,2,50.0,1,1,0,1,4,6,7,0
Bruny Nsimba,BEL,FW,Dender,24-216,2000,12.2,7,6,3,2,2,3,7,42.9,4,5,0,5,2,9,5,1
Erick Nunes,BRA,"DF,MF",Cercle Brugge,20-252,2004,5.2,17,10,6,7,4,9,18,50.0,9,10,1,9,6,23,12,1
Antonio Nusa,NOR,"FW,MF",Club Brugge,19-204,2005,1.8,2,1,1,0,1,2,3,66.7,1,0,0,0,0,2,1,0
Mardochee Nzita,BEL,DF,Charleroi,24-257,2000,1.8,3,2,3,0,0,1,6,16.7,5,4,0,4,0,3,6,0
Aiden O'Neill,AUS,MF,Standard Liège,26-126,1998,13.0,34,22,11,22,1,16,34,47.1,18,15,4,11,9,43,24,0
Denis Odoi,GHA,"MF,DF",Antwerp,36-164,1988,7.0,12,8,4,6,2,7,10,70.0,3,4,3,1,7,19,16,0
Ryoya Ogawa,JPN,"DF,MF",Sint-Truiden,27-349,1996,12.8,29,17,19,7,3,18,29,62.1,11,20,5,15,13,42,44,1
Kazeem Olaigbe,BEL,"MF,FW",Cercle Brugge,21-310,2003,5.5,11,8,2,4,5,7,13,53.8,6,7,0,7,0,11,3,0
Takuma Ominami,JPN,DF,OH Leuven,26-330,1997,7.3,7,6,6,1,0,3,4,75.0,1,7,1,6,1,8,23,0
Jacob Ondrejka,SWE,"FW,MF",Antwerp,22-066,2002,11.4,8,7,4,3,1,2,3,66.7,1,7,0,7,4,12,0,0
Raphael Onyedika,NGA,MF,Club Brugge,23-202,2001,8.8,18,12,6,12,0,5,13,38.5,8,11,1,10,11,29,13,3
Ragnar Oratmangoen,IDN,"MF,DF",Dender,26-291,1998,0.9,2,2,1,1,0,0,1,0.0,1,0,0,0,0,2,3,0
Joel Ordóñez,ECU,DF,Club Brugge,20-200,2004,7.9,8,4,5,3,0,3,6,50.0,3,4,2,2,13,21,26,1
Emir Ortakaya,TUR,DF,Westerlo,20-138,2004,0.5,1,0,0,1,0,0,0,,0,1,1,0,2,3,2,0
Manuel Osifo,BEL,DF,OH Leuven,21-099,2003,2.9,5,3,2,3,0,4,5,80.0,1,3,1,2,5,10,10,0
Zakaria El Ouahdi,MAR,"DF,MF",Genk,22-312,2001,9.9,21,15,16,2,3,14,28,50.0,14,21,9,12,15,36,19,0
Aziz Ouattara,CIV,MF,Mechelen,23-308,2001,10.0,17,12,8,8,1,6,15,40.0,9,14,4,10,12,29,30,0
Kader Ouattara,BFA,"MF,FW",Cercle Brugge,19-165,2005,3.1,6,4,0,2,4,1,3,33.3,2,10,2,8,1,7,0,0
Aiham Ousou,SYR,DF,Charleroi,24-303,2000,7.6,11,8,7,3,1,3,5,60.0,2,8,7,1,16,27,34,0
Louis Patris,BEL,DF,Anderlecht,23-153,2001,0.0,1,1,0,1,0,1,1,100.0,0,0,0,0,0,1,0,0
Louis Patris,BEL,"DF,MF",Sint-Truiden,23-153,2001,6.8,27,9,11,12,4,12,25,48.0,13,16,1,15,12,39,20,0
Mike Penders,BEL,GK,Genk,19-099,2005,2.0,0,0,0,0,0,0,0,,0,0,0,0,0,0,0,0
Jérémy Pétris,FRA,DF,Charleroi,26-284,1998,11.6,34,22,22,10,2,20,25,80.0,5,5,0,5,17,51,25,0
Patrick Pflücke,GER,"DF,MF",Mechelen,27-343,1996,10.3,14,10,11,2,1,12,27,44.4,15,13,2,11,2,16,20,0
Arthur Piedfort,BEL,MF,Westerlo,19-280,2005,9.3,27,12,6,15,6,10,16,62.5,6,13,3,10,8,35,10,0
Lucas Pirard,BEL,GK,Kortrijk,29-242,1995,0.8,0,0,0,0,0,0,0,,0,0,0,0,0,0,0,0
Brian Plat,NED,"DF,MF",Beerschot,24-216,2000,9.3,27,14,16,11,0,11,18,61.1,7,16,3,13,12,39,40,1
Ewoud Pletinckx,BEL,DF,OH Leuven,24-028,2000,4.5,4,2,2,2,0,1,2,50.0,1,6,6,0,3,7,31,0
Boris Popović,SRB,DF,Cercle Brugge,24-255,2000,1.8,1,1,0,1,0,0,1,0.0,1,4,2,2,3,4,2,0
Dennis Praet,BEL,"MF,FW",Antwerp,30-177,1994,1.5,3,2,0,3,0,2,2,100.0,0,0,0,0,1,4,2,0
Isaac Price,NIR,MF,Standard Liège,21-042,2003,10.7,20,10,7,13,0,10,29,34.5,19,22,4,18,7,27,21,1
Cameron Puertas,SUI,MF,Union SG,26-081,1998,2.2,2,2,0,2,0,2,5,40.0,3,2,0,2,1,3,0,0
Joedrick Pupe,BEL,DF,Dender,27-156,1997,10.2,10,7,5,4,1,6,12,50.0,6,12,5,7,20,30,45,0
Toon Raemaekers,BEL,DF,Mechelen,24-059,2000,11.5,25,10,20,4,1,14,28,50.0,14,15,7,8,16,41,51,0
Benito Raman,BEL,FW,Mechelen,30-000,1994,2.9,4,1,1,0,3,1,4,25.0,3,0,0,0,0,4,1,0
Mathias Rasmussen,NOR,MF,Union SG,26-348,1997,4.2,12,6,5,3,4,2,3,66.7,1,4,0,4,7,19,7,0
Christiaan Ravych,BEL,DF,Cercle Brugge,22-100,2002,12.6,32,14,17,14,1,18,27,66.7,9,14,8,6,18,50,40,0
Semm Renders,BEL,DF,Antwerp,16-326,2007,1.0,0,0,0,0,0,0,1,0.0,1,1,0,1,1,1,2,0
Tom Reyners,BEL,"MF,FW",Beerschot,24-201,2000,5.0,10,7,7,3,0,6,10,60.0,4,4,2,2,1,11,2,0
Bryan Reynolds,USA,DF,Westerlo,23-132,2001,11.4,24,17,16,5,3,14,20,70.0,6,13,4,9,9,33,24,0
Federico Ricca,URU,DF,OH Leuven,29-342,1994,6.4,4,3,4,0,0,2,4,50.0,2,6,4,2,10,14,28,0
Jaïro Riedewald,NED,MF,Antwerp,28-059,1996,0.4,2,0,0,1,1,0,0,,0,0,0,0,0,2,1,0
Mats Rits,BEL,MF,Anderlecht,31-112,1993,10.5,10,8,3,4,3,6,11,54.5,5,14,6,8,9,19,18,0
Nathan Rôdes,BEL,MF,Dender,26-332,1997,12.3,27,18,11,12,4,14,35,40.0,21,25,5,20,6,33,22,1
Kevin Rodríguez,ECU,FW,Union SG,24-248,2000,4.7,1,1,0,1,0,1,1,100.0,0,1,0,1,1,2,5,0
Davy Roef,BEL,GK,Gent,30-275,1994,13.0,0,0,0,0,0,0,0,,0,0,0,0,0,0,6,1
Žan Rogelj,SVN,DF,Charleroi,24-348,1999,1.4,4,3,3,1,0,2,2,100.0,0,1,1,0,1,5,6,0
Zaid Romero,ARG,DF,Club Brugge,24-328,1999,3.9,9,6,5,4,0,4,6,66.7,2,2,1,1,6,15,14,0
Tuur Rommens,BEL,DF,Westerlo,21-226,2003,10.8,20,12,11,7,2,9,17,52.9,8,19,5,14,27,47,34,2
Gilles Ruyssen,BEL,DF,Dender,30-142,1994,11.5,22,13,17,4,1,15,27,55.6,12,14,9,5,25,47,62,0
Kyriani Sabbe,BEL,DF,Club Brugge,19-291,2005,1.6,6,4,2,3,1,4,6,66.7,2,3,1,2,2,8,5,0
Mujaid Sadick,ESP,DF,Genk,24-238,2000,12.8,21,14,11,10,0,10,13,76.9,3,22,16,6,11,32,25,0
Noah Sadiki,COD,MF,Union SG,19-326,2004,11.4,14,9,4,6,4,2,6,33.3,4,17,3,14,11,25,9,0
Marwan Al Sahafi,KSA,FW,Beerschot,20-264,2004,4.7,1,2,0,0,1,0,0,,0,1,0,1,1,2,6,0
Matisse Samoise,BEL,"DF,MF",Gent,22-352,2001,3.4,15,9,9,4,2,10,13,76.9,3,8,4,4,7,22,12,0
Ryan Sanusi,BEL,MF,Beerschot,32-307,1992,11.4,21,12,15,5,1,10,21,47.6,11,23,8,15,11,32,19,0
Killian Sardella,BEL,DF,Anderlecht,22-189,2002,12.0,22,16,11,7,4,13,22,59.1,9,11,5,6,7,29,22,0
Nikolas Sattlberger,AUT,MF,Genk,20-294,2004,6.1,19,8,7,11,1,7,17,41.2,10,6,1,5,8,27,7,0
Allahyar Sayyadmanesh,IRN,"FW,MF",Westerlo,23-131,2001,11.2,20,15,7,7,6,11,19,57.9,8,11,3,8,2,22,11,0
Aurélien Scheidler,FRA,FW,Dender,26-156,1998,4.1,5,3,2,2,1,1,3,33.3,2,3,0,3,0,5,5,0
Joël Schingtienne,BEL,DF,OH Leuven,22-087,2002,4.0,10,5,7,3,0,6,6,100.0,0,9,4,5,4,14,14,0
Rob Schoofs,BEL,MF,Mechelen,30-229,1994,12.7,19,8,6,10,3,9,14,64.3,5,10,1,9,14,33,15,0
Siebe Schrijvers,BEL,MF,OH Leuven,28-112,1996,6.9,17,9,3,10,4,9,10,90.0,1,9,3,6,6,23,15,0
Christopher Scott,GER,MF,Antwerp,22-153,2002,0.9,0,0,0,0,0,0,2,0.0,2,0,0,0,0,0,1,0
Joaquin Seys,BEL,DF,Club Brugge,19-224,2005,9.7,19,12,11,4,4,8,16,50.0,8,8,1,7,15,34,23,0
Nick Shinton,BEL,GK,Beerschot,23-181,2001,6.0,1,0,1,0,0,1,3,33.3,2,0,0,0,0,1,6,0
João Silva,POR,DF,Kortrijk,25-298,1999,12.6,16,10,11,4,1,7,11,63.6,4,29,19,10,24,40,57,2
Jan-Carlo Simic,SRB,DF,Anderlecht,19-189,2005,9.9,7,3,5,2,0,1,2,50.0,1,10,9,1,13,20,38,1
Roko Simic,CRO,FW,Kortrijk,21-058,2003,1.6,0,0,0,0,0,0,3,0.0,3,2,0,2,0,0,3,0
Hugo Siquet,BEL,DF,Club Brugge,22-121,2002,2.6,5,3,4,1,0,4,10,40.0,6,2,0,2,1,6,9,0
Abdoulaye Sissako,FRA,MF,Kortrijk,26-165,1998,4.0,9,3,3,4,2,4,9,44.4,5,5,1,4,4,13,5,0
Michał Skóraś,POL,"FW,MF",Club Brugge,24-266,2000,3.5,8,4,3,2,3,6,7,85.7,1,4,0,4,2,10,3,0
Andreas Skov Olsen,DEN,FW,Club Brugge,24-314,1999,8.0,5,3,1,3,1,4,11,36.4,7,7,2,5,5,10,6,0
Matte Smets,BEL,DF,Genk,20-308,2004,11.5,16,9,11,5,0,8,11,72.7,3,17,11,6,15,31,38,2
Milan Smits,BEL,MF,Antwerp,19-360,2004,0.3,0,0,0,0,0,0,1,0.0,1,0,0,0,0,0,0,0
Jordy Soladio,BEL,FW,Dender,26-269,1998,4.1,1,1,0,1,0,0,1,0.0,1,4,1,3,0,1,3,0
Thibo Somers,BEL,"FW,MF",Cercle Brugge,25-236,1999,11.7,12,8,6,4,2,5,18,27.8,13,17,3,14,6,18,10,0
Momodou Sonko,SWE,"MF,FW",Gent,19-281,2005,1.3,9,7,5,4,0,1,1,100.0,0,0,0,0,4,13,0,0
Yira Sor,NGA,FW,Genk,24-106,2000,6.4,7,4,4,3,0,0,2,0.0,2,4,0,4,4,11,1,0
Ibrahima Sory Bangoura,GUI,MF,Genk,20-307,2004,4.1,23,14,9,8,6,9,11,81.8,2,4,0,4,9,32,2,0
Massamba Sow,FRA,DF,Charleroi,20-147,2004,1.0,1,1,1,0,0,1,2,50.0,1,2,2,0,2,3,3,0
Jorne Spileers,BEL,DF,Club Brugge,19-291,2005,1.2,3,1,0,3,0,1,2,50.0,1,3,3,0,0,3,5,0
Alexandre Stanic,BEL,FW,Antwerp,19-315,2004,0.0,0,0,0,0,0,0,0,,0,0,0,0,0,0,0,0
Lucas Stassin,BEL,FW,Westerlo,19-345,2004,4.5,4,3,1,0,3,1,3,33.3,2,0,0,0,1,5,2,0
Jarne Steuckers,BEL,FW,Genk,22-277,2002,11.8,9,4,6,2,1,6,12,50.0,6,1,0,1,4,13,4,0
Nikola Storm,BEL,"FW,MF",Mechelen,30-038,1994,8.9,7,5,2,4,1,4,8,50.0,4,7,1,6,2,9,5,0
Mario Stroeykens,BEL,"MF,FW",Anderlecht,20-039,2004,9.6,24,12,8,8,8,8,16,50.0,8,7,0,7,6,30,2,1
Nikola Štulić,SRB,MF,Charleroi,23-060,2001,0.2,0,0,0,0,0,0,0,,0,0,0,0,0,0,0,0
Franck Surdez,SUI,"MF,FW",Gent,22-186,2002,10.2,19,13,3,9,7,5,17,29.4,12,8,0,8,4,23,4,0
Bosko Sutalo,CRO,DF,Standard Liège,24-311,2000,12.3,34,25,23,9,2,21,24,87.5,3,17,12,5,32,66,59,0
Serhiy Sydorchuk,UKR,MF,Westerlo,33-189,1991,0.5,2,1,1,0,1,0,0,,0,0,0,0,1,3,0,0
Ross Sykes,ENG,DF,Union SG,25-226,1999,2.0,7,6,7,0,0,4,4,100.0,0,2,0,2,4,11,16,0
Dembo Sylla,GUI,DF,Dender,21-363,2002,1.8,4,3,4,0,0,2,3,66.7,1,0,0,0,1,5,3,0
Youssuf Sylla,BEL,FW,Charleroi,21-324,2002,4.3,2,0,0,2,0,0,1,0.0,1,1,0,1,1,3,5,0
Tomoki Takamine,JPN,MF,Kortrijk,26-314,1997,6.1,7,2,3,4,0,0,5,0.0,5,3,0,3,3,10,15,0
Chemsdine Talbi,BEL,FW,Club Brugge,19-182,2005,2.3,3,2,2,1,0,3,3,100.0,0,1,0,1,1,4,2,0
Shogo Taniguchi,JPN,DF,Sint-Truiden,33-115,1991,10.4,11,9,5,6,0,5,11,45.5,6,11,8,3,14,25,54,1
Henok Teklab,GER,DF,Union SG,25-357,1998,2.4,7,4,2,5,0,5,7,71.4,2,1,0,1,4,11,2,0
Casper Terho,FIN,"DF,FW",Union SG,21-136,2003,4.8,9,5,4,5,0,6,19,31.6,13,7,1,6,7,16,11,0
Jean Thierry Lazare,CIV,MF,Union SG,26-245,1998,3.7,13,9,5,4,4,4,7,57.1,3,5,1,4,3,16,2,0
Yassine Titraoui,ALG,MF,Charleroi,21-104,2003,1.5,5,5,2,2,1,3,8,37.5,5,1,0,1,2,7,0,0
Jordan Torunarigha,GER,DF,Gent,27-092,1997,6.6,11,6,10,1,0,7,9,77.8,2,14,9,5,9,20,42,0
Ahmed Touba,ALG,DF,Mechelen,26-240,1998,6.5,10,7,6,3,1,5,6,83.3,1,3,2,1,13,23,22,1
Mamadou Traoré,MLI,DF,Union SG,22-218,2002,0.2,0,0,0,0,0,0,1,0.0,1,1,0,1,0,0,1,0
Derrick Tshimanga,BEL,DF,Beerschot,36-001,1988,8.5,11,6,9,1,1,3,6,50.0,3,8,2,6,12,23,23,1
Antef Tsoungui,BEL,DF,OH Leuven,21-313,2002,0.5,1,1,0,1,0,0,1,0.0,1,1,0,1,1,2,2,0
Christos Tzolis,GRE,"FW,MF",Club Brugge,22-282,2002,10.5,14,8,7,3,4,5,12,41.7,7,15,0,15,4,18,8,0
Victor Udoh,NGA,"FW,DF",Antwerp,20-020,2004,1.0,1,1,0,1,0,1,1,100.0,0,1,0,1,0,1,0,0
Edgaras Utkus,LTU,"DF,MF",Cercle Brugge,24-138,2000,1.9,8,5,6,1,1,6,8,75.0,2,6,2,4,2,10,13,0
Anthony Valencia,ECU,FW,Antwerp,21-109,2003,3.6,5,6,1,0,4,2,7,28.6,5,5,0,5,3,8,3,0
Jules Van Cleemput,BEL,DF,Mechelen,27-210,1997,2.6,2,1,0,2,0,1,4,25.0,3,3,2,1,9,11,4,0
Hendrik Van Crombrugge,BEL,GK,Genk,31-191,1993,11.0,0,0,0,0,0,0,0,,0,0,0,0,0,0,6,1
Zeno Van den Bosch,BEL,DF,Antwerp,21-124,2003,13.0,15,14,11,3,1,8,13,61.5,5,24,15,9,9,24,49,0
Thomas Van den Keybus,BEL,"FW,MF",Westerlo,23-196,2001,1.5,1,0,0,1,0,1,5,20.0,4,4,1,3,0,1,1,0
Hannes Van der Bruggen,BEL,MF,Cercle Brugge,31-220,1993,9.4,21,16,6,8,7,10,31,32.3,21,8,3,5,14,35,19,0
Rein Van Helden,BEL,DF,Sint-Truiden,22-106,2002,12.8,27,16,21,4,2,13,25,52.0,12,29,19,10,22,49,73,0
Koen Van Langendonck,BEL,GK,Westerlo,35-151,1989,2.0,0,0,0,0,0,0,0,,0,0,0,0,0,0,0,1
Jasper Van Oudenhove,BEL,"MF,DF",Dender,26-004,1998,0.8,2,0,2,0,0,1,3,33.3,2,0,0,0,0,2,3,0
Hans Vanaken,BEL,MF,Club Brugge,32-075,1992,12.7,15,9,8,5,2,3,11,27.3,8,11,0,11,6,21,14,0
Zalán Vancsa,HUN,MF,Gent,20-011,2004,0.9,0,0,0,0,0,0,1,0.0,1,1,0,1,0,0,1,0
Tom Vandenberghe,BEL,GK,Kortrijk,32-082,1992,2.0,0,0,0,0,0,0,0,,0,0,0,0,0,0,0,0
Gerard Vandeplas,BEL,"FW,MF",Antwerp,18-256,2006,0.1,1,0,0,1,0,0,0,,0,1,0,1,0,1,1,0
Zinho Vanheusden,BEL,DF,Mechelen,25-101,1999,1.0,1,0,1,0,0,0,0,,0,0,0,0,2,3,6,0
Charles Vanhoutte,BEL,MF,Union SG,26-052,1998,12.2,34,25,12,19,3,17,31,54.8,14,21,4,17,16,50,27,0
Robert-Jan Vanwesemael,BEL,"DF,MF",Sint-Truiden,22-226,2002,7.4,7,5,0,4,3,4,14,28.6,10,9,3,6,9,16,14,0
Hélio Varela,CPV,"MF,DF",Gent,22-188,2002,0.8,0,0,0,0,0,0,0,,0,1,0,1,1,1,1,0
Óscar Vargas,BEL,DF,Beerschot,18-281,2006,0.1,0,0,0,0,0,0,0,,0,0,0,0,0,0,0,0
Luis Vázquez,ARG,"FW,MF",Anderlecht,23-288,2001,2.8,3,3,0,0,3,2,4,50.0,2,2,0,2,0,3,4,0
Thibaud Verlinden,BEL,"MF,FW",Beerschot,25-121,1999,9.8,14,8,5,3,6,6,20,30.0,14,7,0,7,3,17,0,0
Romeo Vermant,BEL,"FW,MF",Club Brugge,20-288,2004,3.4,5,4,1,4,0,4,7,57.1,3,1,0,1,1,6,1,0
Michael Verrips,NED,GK,Dender,27-340,1996,10.5,0,0,0,0,0,0,1,0.0,1,0,0,0,0,0,4,1
Yari Verschaeren,BEL,"MF,FW",Anderlecht,23-118,2001,9.6,18,16,9,5,4,10,19,52.6,9,5,1,4,6,24,15,1
Birger Verstraete,BEL,MF,OH Leuven,30-205,1994,10.8,31,20,17,11,3,11,20,55.0,9,9,3,6,20,51,23,0
Andreas Verstraeten,BEL,MF,Antwerp,18-302,2006,1.8,3,1,1,1,1,3,7,42.9,4,0,0,0,2,5,4,0
Jan Vertonghen,BEL,DF,Anderlecht,37-197,1987,2.0,0,0,0,0,0,0,0,,0,3,2,1,0,0,6,0
Hugo Vetlesen,NOR,MF,Club Brugge,24-252,2000,7.8,16,12,4,8,4,6,9,66.7,3,5,0,5,8,24,10,0
Malcolm Viltard,FRA,MF,Dender,22-014,2002,7.8,17,8,10,6,1,7,21,33.3,14,17,1,16,13,30,20,0
Thibault Vlietinck,BEL,DF,OH Leuven,27-080,1997,3.4,3,2,2,1,0,2,4,50.0,2,4,0,4,2,5,10,0
Luka Vušković,CRO,DF,Westerlo,17-257,2007,12.5,10,7,8,2,0,4,9,44.4,5,9,7,2,10,20,73,0
Sandy Walsh,IDN,"DF,MF",Mechelen,29-238,1995,1.4,1,1,1,0,0,1,1,100.0,0,3,2,1,2,3,6,0
Warleson,BRA,GK,Cercle Brugge,28-068,1996,9.0,1,0,1,0,0,1,3,33.3,2,0,0,0,0,1,14,2
Tsuyoshi Watanabe,JPN,DF,Gent,27-276,1997,13.0,22,11,16,5,1,11,15,73.3,4,20,16,4,11,33,65,1
Marco Weymans,BDI,"DF,MF",Beerschot,27-121,1997,5.3,15,7,5,9,1,7,11,63.6,4,6,1,5,5,20,8,0
D'Margio Wright-Phillips,ENG,"FW,MF",Beerschot,23-044,2001,1.3,2,0,0,0,2,1,4,25.0,3,0,0,0,0,2,0,0
Rihito Yamamoto,JPN,MF,Sint-Truiden,22-331,2001,6.5,11,6,5,5,1,5,11,45.5,6,10,2,8,3,14,14,0
Elton Yeboah,BEL,"MF,DF",Mechelen,19-227,2005,0.1,0,0,0,0,0,0,0,,0,0,0,0,0,0,1,0
Daisuke Yokota,JPN,MF,Gent,24-145,2000,2.6,4,1,2,2,0,2,3,66.7,1,0,0,0,0,4,2,0
Griffin Yow,USA,"FW,MF",Westerlo,22-043,2002,3.6,9,6,4,4,1,4,9,44.4,5,4,0,4,1,10,4,0
Alhassan Yusuf,NGA,"MF,DF",Antwerp,24-112,2000,0.1,0,0,0,0,0,0,1,0.0,1,0,0,0,0,0,0,0
Kahveh Zahiroleslam,USA,FW,Sint-Truiden,22-147,2002,11.1,8,6,0,7,1,1,9,11.1,8,9,1,8,2,10,13,0
Andi Zeqiri,SUI,"MF,FW",Genk,25-138,1999,0.5,0,0,0,0,0,0,0,,0,0,0,0,0,0,0,0
Andi Zeqiri,SUI,FW,Standard Liège,25-138,1999,5.7,2,1,0,1,1,0,6,0.0,6,5,1,4,2,4,8,0
Adem Zorgane,ALG,MF,Charleroi,24-306,2000,12.9,40,27,18,17,5,15,37,40.5,22,16,5,11,19,59,14,2
Viktor Đukanović,MNE,"DF,MF",Standard Liège,20-283,2004,0.5,0,0,0,0,0,0,0,,0,0,0,0,0,0,0,0
