Player,Nation,Pos,Squad,Age,Born,90s,Tackles,TacklesWon,TacklesDef3rd,TacklesMid3rd,TacklesAtt3rd,DribTkl,DribTklAtt,DribTkl%,ChallengesLost,Blocks,ShotsBlocked,PassesBlocked,Int,Tkl+Int,Clr,ErrorsLeadingToShot
Ahmed Abdullahi,NGA,MF,Gent,20-136,2004,0.0,1,0,0,1,0,0,0,,0,0,0,0,0,1,0,0
Francis Abu,GHA,MF,Cercle Brugge,23-189,2001,7.8,32,20,6,17,9,14,22,63.6,8,8,1,7,6,38,11,0
Desmond Acquah,BEL,"MF,FW",Dender,22-102,2002,1.5,4,4,0,3,1,2,11,18.2,9,4,0,4,1,5,0,0
Noah Adedeji,BEL,"FW,MF",Genk,19-136,2005,0.3,4,2,0,1,3,1,1,100.0,0,0,0,0,1,5,1,0
Lawrence Agyekum,GHA,MF,Cercle Brugge,20-345,2003,7.2,26,13,11,11,4,15,26,57.7,11,28,2,26,11,37,7,0
Takahiro Akimoto,JPN,DF,OH Leuven,26-276,1998,10.5,18,10,12,6,0,8,19,42.1,11,10,4,6,11,29,39,0
Ali Akman,TUR,"MF,DF",Dender,22-198,2002,0.4,3,2,0,1,2,2,3,66.7,1,0,0,0,0,3,0,0
Josimar Alcocer,CRC,"MF,DF",Westerlo,20-118,2004,6.8,18,15,10,7,1,7,21,33.3,14,7,1,6,9,27,10,0
Toby Alderweireld,BEL,DF,Antwerp,35-245,1989,12.0,7,4,6,1,0,5,8,62.5,3,8,5,3,12,19,43,1
Ryan Alebiosu,ENG,DF,Kortrijk,22-321,2001,4.3,10,4,7,2,1,5,6,83.3,1,1,0,1,6,16,11,0
Sotiris Alexandropoulos,GRE,"MF,FW",Standard Liège,22-342,2001,1.4,4,2,2,2,0,2,6,33.3,4,2,1,1,1,5,6,0
Arthur Alexis,BEL,MF,Sint-Truiden,18-297,2006,0.1,0,0,0,0,0,0,0,,0,0,0,0,0,0,0,0
Thierry Ambrose,GLP,FW,Kortrijk,27-219,1997,8.8,8,3,1,5,2,1,6,16.7,5,4,0,4,1,9,10,0
Francis Amuzu,BEL,FW,Anderlecht,25-071,1999,3.6,4,3,2,1,1,3,5,60.0,2,0,0,0,1,5,2,0
Frederic Ananou,TOG,"DF,MF",Sint-Truiden,27-043,1997,2.2,9,6,7,2,0,7,9,77.8,2,0,0,0,2,11,8,0
Stelios Andreou,CYP,DF,Charleroi,22-101,2002,12.0,25,15,21,3,1,12,17,70.6,5,19,14,5,22,47,46,1
Nilson Angulo,ECU,FW,Anderlecht,21-136,2003,2.6,5,2,0,3,2,0,4,0.0,4,2,0,2,1,6,2,0
Tiago Araújo,POR,"DF,FW",Gent,23-220,2001,1.3,3,2,1,1,1,1,3,33.3,2,2,1,1,0,3,5,0
Kristian Arnstad,NOR,DF,Anderlecht,21-056,2003,0.3,0,0,0,0,0,0,0,,0,0,0,0,1,1,0,0
Tolu Arokodare,NGA,FW,Genk,23-345,2000,10.8,13,7,2,6,5,4,9,44.4,5,2,0,2,2,15,15,0
Raymond Asante,GHA,FW,Charleroi,20-159,2004,0.2,0,0,0,0,0,0,0,,0,0,0,0,0,0,0,0
Majeed Ashimeru,GHA,MF,Anderlecht,27-023,1997,3.3,8,6,5,2,1,2,5,40.0,3,0,0,0,4,12,3,0
Ludwig Augustinsson,SWE,DF,Anderlecht,30-195,1994,3.9,11,9,5,5,1,4,7,57.1,3,2,2,0,4,15,11,0
Felipe Augusto,BRA,"FW,MF",Cercle Brugge,20-258,2004,4.4,4,4,1,1,2,2,2,100.0,0,4,1,3,1,5,3,0
Muhammed Badamosi,GAM,"FW,DF",Standard Liège,25-311,1998,0.7,1,0,0,1,0,0,0,,0,0,0,0,0,1,1,0
Youssouph Badji,SEN,FW,Charleroi,22-318,2001,2.3,2,1,1,0,1,1,2,50.0,1,3,0,3,0,2,3,0
Bilal Bafdili,BEL,"MF,FW",Mechelen,20-091,2004,5.1,6,4,0,5,1,2,4,50.0,2,2,1,1,0,6,0,0
Michel-Ange Balikwisha,BEL,FW,Antwerp,23-176,2001,1.0,1,1,0,1,0,0,0,,0,4,0,4,3,4,0,0
William Balikwisha,COD,"FW,MF",OH Leuven,25-174,1999,6.7,16,9,5,8,3,5,5,100.0,0,8,0,8,6,22,5,0
Sacha Banse,BFA,MF,Standard Liège,23-231,2001,0.4,2,1,1,1,0,0,0,,0,1,0,1,0,2,3,0
Ezechiel Banzuzi,NED,MF,OH Leuven,19-260,2005,9.8,21,13,8,9,4,7,12,58.3,5,11,5,6,7,28,24,0
Joselpho Barnes,GHA,"FW,MF",Sint-Truiden,22-326,2001,1.2,2,0,0,2,0,0,0,,0,2,0,2,0,2,2,0
Jelle Bataille,BEL,DF,Antwerp,25-166,1999,9.3,27,18,15,9,3,17,32,53.1,15,16,3,13,11,38,11,0
David Bates,SCO,DF,Standard Liège,28-028,1996,8.6,16,11,12,4,0,8,9,88.9,1,15,11,4,17,33,47,0
Emin Bayram,TUR,DF,Westerlo,21-214,2003,5.0,5,2,3,2,0,2,4,50.0,2,6,2,4,8,13,19,1
Zineddine Belaid,ALG,DF,Sint-Truiden,25-227,1999,0.8,0,0,0,0,0,0,0,,0,0,0,0,0,0,3,1
Rafik Belghali,ALG,"DF,MF",Mechelen,22-148,2002,3.7,12,9,7,5,0,10,11,90.9,1,6,0,6,2,14,5,0
Soufiane Benjdida,MAR,FW,Standard Liège,23-058,2001,5.9,2,1,0,2,0,2,4,50.0,2,5,0,5,2,4,5,0
Antoine Bernier,BEL,FW,Charleroi,27-053,1997,8.8,15,11,2,10,3,5,13,38.5,8,9,0,9,2,17,2,0
Adriano Bertaccini,BEL,"FW,MF",Sint-Truiden,24-081,2000,8.7,9,5,4,2,3,3,10,30.0,7,5,2,3,0,9,5,0
Mohamed Berte,BEL,FW,Dender,22-222,2002,4.7,5,3,0,2,3,1,9,11.1,8,3,0,3,0,5,0,0
Mickaël Biron,MTQ,"FW,MF",OH Leuven,27-068,1997,0.8,3,2,1,2,0,0,0,,0,1,0,1,0,3,1,0
Sinan Bolat,TUR,GK,Westerlo,36-060,1988,11.0,1,0,1,0,0,1,1,100.0,0,0,0,0,0,1,2,2
Boli Bolingoli-Mbombo,BEL,DF,Standard Liège,29-124,1995,0.5,0,0,0,0,0,0,4,0.0,4,1,1,0,0,0,2,0
Christopher Bonsu Baah,GHA,"FW,MF",Genk,19-324,2004,7.6,19,14,5,11,3,5,8,62.5,3,3,0,3,4,23,6,0
Jordan Bos,AUS,DF,Westerlo,22-004,2002,3.3,3,2,1,1,1,0,2,0.0,2,8,1,7,6,9,12,0
Sofiane Boufal,MAR,MF,Union SG,31-046,1993,1.2,7,4,5,1,1,3,4,75.0,1,1,0,1,1,8,0,0
Amine Boukamir,BEL,MF,Charleroi,18-010,2006,0.1,0,0,0,0,0,0,0,,0,0,0,0,0,0,0,0
Rosen Bozhinov,BUL,DF,Antwerp,19-284,2005,0.0,0,0,0,0,0,0,0,,0,1,1,0,0,0,0,1
Bilal Brahimi,ALG,"MF,FW",Sint-Truiden,24-233,2000,4.9,1,1,0,1,0,0,5,0.0,5,2,0,2,2,3,1,1
Archie Brown,ENG,DF,Gent,22-158,2002,11.0,18,12,10,5,3,9,15,60.0,6,18,4,14,7,25,31,2
Bruninho,BRA,"MF,FW",Cercle Brugge,21-233,2003,3.5,1,0,1,0,0,1,6,16.7,5,1,0,1,1,2,2,0
Paris Brunner,GER,"MF,FW",Cercle Brugge,18-261,2006,0.8,2,0,1,1,0,1,1,100.0,0,0,0,0,0,2,0,0
Massimo Bruno,BEL,MF,Kortrijk,31-046,1993,4.7,13,6,8,3,2,6,12,50.0,6,8,1,7,1,14,7,0
Marko Bulat,CRO,"MF,FW",Standard Liège,23-037,2001,10.6,18,14,6,7,5,8,16,50.0,8,8,4,4,10,28,9,0
Christian Burgess,ENG,DF,Union SG,33-026,1991,5.0,7,3,4,3,0,6,9,66.7,3,8,4,4,3,10,20,0
Welat Cagro,BEL,MF,Beerschot,25-155,1999,5.9,13,8,4,7,2,4,8,50.0,4,10,0,10,5,18,2,0
Alexandro Calut,BEL,"DF,MF",Standard Liège,21-194,2003,1.3,2,1,1,1,0,0,1,0.0,1,0,0,0,2,4,3,0
Etienne Camara,FRA,MF,Charleroi,21-217,2003,9.8,21,12,7,13,1,7,16,43.8,9,9,2,7,6,27,7,0
Ilay Camara,BEL,DF,Standard Liège,21-289,2003,7.7,14,10,9,5,0,12,18,66.7,6,8,1,7,5,19,10,0
Alessio Castro-Montes,BEL,"DF,FW",Union SG,27-169,1997,9.2,16,8,6,6,4,7,17,41.2,10,16,2,14,8,24,8,0
Tjaronn Chery,SUR,"MF,FW",Antwerp,36-151,1988,10.4,8,5,4,3,1,3,8,37.5,5,1,0,1,0,8,3,0
Antoine Colassin,BEL,"FW,MF",Beerschot,23-250,2001,2.9,9,6,3,3,3,6,6,100.0,0,4,0,4,1,10,5,0
Kobe Cools,BEL,DF,Dender,27-100,1997,12.0,16,6,12,3,1,5,8,62.5,3,22,19,3,23,39,87,1
Colin Coosemans,BEL,GK,Anderlecht,32-091,1992,12.0,1,1,1,0,0,1,3,33.3,2,0,0,0,0,1,10,1
Jo Coppens,BEL,GK,Sint-Truiden,33-317,1990,3.0,0,0,0,0,0,0,0,,0,0,0,0,0,0,1,0
Kobe Corbanie,BEL,"MF,DF",Antwerp,19-176,2005,4.8,10,8,5,5,0,6,8,75.0,2,7,4,3,5,15,7,0
Ayrton Costa,ARG,DF,Antwerp,25-113,1999,10.1,31,21,21,8,2,20,35,57.1,15,18,4,14,23,54,29,0
Carlos Cuesta,COL,DF,Genk,25-238,1999,2.5,6,5,2,4,0,1,1,100.0,0,1,0,1,1,7,7,0
Oday Dabbagh,PLE,FW,Charleroi,25-335,1998,3.3,2,2,0,1,1,0,1,0.0,1,1,0,1,0,2,0,0
Colin Dagba,FRA,"FW,DF",Beerschot,26-054,1998,3.0,16,8,9,4,3,7,14,50.0,7,6,2,4,3,19,5,0
Jón Dagur Þorsteinsson,ISL,"MF,FW",OH Leuven,25-342,1998,1.0,1,1,0,0,1,0,1,0.0,1,0,0,0,1,2,1,0
Jesper Daland,NOR,DF,Cercle Brugge,24-301,2000,2.0,3,2,2,1,0,1,1,100.0,0,3,2,1,2,5,10,0
Tobi David,CAN,FW,Union SG,23-122,2001,1.8,0,0,0,0,0,0,0,,0,0,0,0,0,0,3,0
Maxim De Cuyper,BEL,DF,Club Brugge,23-316,2000,11.1,18,13,15,3,0,9,17,52.9,8,12,3,9,5,23,25,1
Dion De Neve,BEL,DF,Kortrijk,22-143,2002,8.1,20,9,12,5,3,10,16,62.5,6,14,1,13,5,25,20,0
Kamiel Van De Perre,BEL,MF,Union SG,20-264,2004,0.0,0,0,0,0,0,0,0,,0,1,0,1,0,0,0,0
Nils De Wilde,BEL,MF,Cercle Brugge,21-280,2003,0.3,0,0,0,0,0,0,3,0.0,3,1,0,1,0,0,2,0
Ortwin De Wolf,BEL,GK,Mechelen,27-193,1997,12.0,0,0,0,0,0,0,1,0.0,1,0,0,0,1,1,6,2
Max Dean,ENG,FW,Gent,20-255,2004,4.5,2,1,0,1,1,1,6,16.7,5,2,0,2,0,2,2,0
Théo Defourny,BEL,GK,Charleroi,32-191,1992,1.0,0,0,0,0,0,0,0,,0,0,0,0,0,0,0,0
Tristan Degreef,BEL,"MF,FW",Anderlecht,19-288,2005,1.1,1,1,0,1,0,1,2,50.0,1,1,0,1,1,2,2,0
Brecht Dejaegere,BEL,MF,Kortrijk,33-157,1991,5.1,15,10,4,8,3,4,10,40.0,6,13,3,10,11,26,4,0
Maxime Delanghe,BEL,GK,Cercle Brugge,23-163,2001,3.0,0,0,0,0,0,0,0,,0,0,0,0,0,0,5,0
Mathias Delorge,BEL,MF,Gent,20-094,2004,11.8,29,17,7,20,2,18,36,50.0,18,11,3,8,15,44,17,1
Isaías Delpupo,ARG,"MF,FW",Sint-Truiden,21-216,2003,0.3,2,0,0,2,0,2,2,100.0,0,2,0,2,0,2,1,0
Bas van den Eynden,BEL,DF,Mechelen,22-300,2002,5.0,8,6,6,2,0,3,6,50.0,3,14,9,5,7,15,31,0
Leander Dendoncker,BEL,"DF,MF",Anderlecht,29-201,1995,6.0,11,9,6,4,1,3,11,27.3,8,7,3,4,7,18,14,0
Kévin Denkey,TOG,FW,Cercle Brugge,23-338,2000,10.4,4,3,0,2,2,1,1,100.0,0,6,0,6,0,4,2,0
Alfie Devine,ENG,MF,Westerlo,20-093,2004,5.5,8,3,2,4,2,5,8,62.5,3,2,0,2,6,14,3,0
Julien Devriendt,BEL,GK,Dender,25-343,1998,1.0,1,0,1,0,0,1,1,100.0,0,0,0,0,0,1,0,0
Gilles Dewaele,BEL,DF,Kortrijk,28-263,1996,4.9,4,3,2,1,1,2,5,40.0,3,2,1,1,5,9,12,0
Ibrahim Diakité,GUI,"DF,MF",Cercle Brugge,21-002,2003,4.0,7,4,4,3,0,4,5,80.0,1,14,2,12,7,14,17,0
Guillaume Dietsch,FRA,GK,Dender,23-199,2001,0.5,0,0,0,0,0,0,0,,0,0,0,0,0,0,0,0
Alouis Diriken,BEL,MF,Sint-Truiden,20-303,2004,1.6,2,0,1,1,0,1,3,33.3,2,0,0,0,2,4,1,0
Kasper Dolberg,DEN,FW,Anderlecht,27-027,1997,9.6,4,4,2,1,1,2,6,33.3,4,2,0,2,0,4,5,1
Mahamadou Doumbia,MLI,MF,Antwerp,20-171,2004,10.4,19,14,8,10,1,5,13,38.5,8,9,4,5,9,28,12,1
Souleyman Doumbia,CIV,DF,Standard Liège,28-039,1996,0.1,0,0,0,0,0,0,0,,0,0,0,0,0,0,0,0
Vetle Dragsnes,NOR,DF,Charleroi,30-270,1994,11.3,17,11,10,6,1,8,21,38.1,13,12,3,9,6,23,28,0
Anders Dreyer,DEN,"FW,MF",Anderlecht,26-184,1998,8.1,5,4,1,3,1,1,3,33.3,2,4,1,3,1,6,4,0
Olivier Dumont,BEL,"FW,MF",Sint-Truiden,22-241,2002,1.9,7,5,6,1,0,3,6,50.0,3,0,0,0,1,8,3,0
Dennis Eckert,GER,FW,Standard Liège,27-298,1997,4.4,4,2,0,3,1,0,1,0.0,1,2,0,2,2,6,3,0
Dennis Eckert,GER,FW,Union SG,27-298,1997,2.2,1,0,0,0,1,0,1,0.0,1,3,1,2,0,1,0,0
Samuel Edozie,ENG,"FW,MF",Anderlecht,21-279,2003,4.0,4,3,2,0,2,2,2,100.0,0,1,0,1,0,4,0,0
Malamine Efekele,FRA,"MF,FW",Cercle Brugge,20-106,2004,1.6,1,1,0,1,0,0,0,,0,0,0,0,1,2,2,0
Jurgen Ekkelenkamp,NED,MF,Antwerp,24-211,2000,0.7,0,0,0,0,0,0,0,,0,0,0,0,0,0,1,0
Matthieu Epolo,BEL,GK,Standard Liège,20-292,2004,12.0,1,1,1,0,0,1,2,50.0,1,0,0,0,0,1,8,1
Alieu Fadera,GAM,MF,Genk,22-365,2001,2.0,11,10,7,1,3,3,7,42.9,4,4,0,4,2,13,0,1
Noah Fadiga,SEN,DF,Gent,24-335,1999,8.4,9,6,4,4,1,3,4,75.0,1,10,1,9,4,13,10,0
Omar Fayed,EGY,MF,Beerschot,21-121,2003,0.3,4,3,2,2,0,2,2,100.0,0,0,0,0,0,4,2,0
Matias Fernandez-Pardo,BEL,"MF,FW",Gent,19-273,2005,1.8,0,0,0,0,0,0,2,0.0,2,2,0,2,0,0,0,0
Andrés Ferrari,URU,"FW,DF",Sint-Truiden,21-304,2003,0.6,0,0,0,0,0,0,0,,0,0,0,0,0,0,2,0
Fabio Ferraro,BEL,DF,Dender,22-060,2002,10.6,24,16,15,5,4,17,29,58.6,12,15,1,14,11,35,35,0
Nacho Ferri,ESP,FW,Kortrijk,20-028,2004,8.3,9,9,2,2,5,2,6,33.3,4,7,1,6,0,9,5,0
Karol Fila,POL,DF,Dender,26-142,1998,2.8,6,4,3,2,1,3,7,42.9,4,3,0,3,6,12,3,0
Mathias Fixelles,BEL,MF,Westerlo,28-083,1996,0.0,3,1,0,3,0,2,2,100.0,0,0,0,0,0,3,0,0
Alexis Flips,FRA,FW,Anderlecht,24-289,2000,0.0,0,0,0,0,0,0,0,,0,0,0,0,0,0,0,0
Alexis Flips,FRA,"FW,MF",Charleroi,24-289,2000,2.2,5,0,5,0,0,3,7,42.9,4,1,0,1,2,7,3,0
Thomas Foket,BEL,DF,Anderlecht,30-038,1994,1.2,2,0,1,1,0,1,1,100.0,0,1,0,1,2,4,3,0
Núrio Fortuna,ANG,"MF,DF",Gent,29-223,1995,0.1,0,0,0,0,0,0,0,,0,0,0,0,0,0,1,0
Marlon Fossey,USA,DF,Standard Liège,26-054,1998,10.1,12,8,4,6,2,4,6,66.7,2,10,3,7,12,24,32,0
Iver Fossum,NOR,MF,Kortrijk,28-110,1996,2.2,9,5,3,4,2,6,10,60.0,4,4,0,4,1,10,2,0
Daam Foulon,BEL,"DF,MF",Mechelen,25-224,1999,10.4,19,10,10,5,4,13,25,52.0,12,6,2,4,6,25,23,0
Guillaume François,BEL,"FW,DF",Union SG,34-152,1990,1.2,2,0,0,2,0,1,1,100.0,0,0,0,0,3,5,2,0
Matija Frigan,CRO,FW,Westerlo,21-265,2003,7.1,2,1,0,0,2,0,1,0.0,1,1,1,0,1,3,4,0
Haruya Fujii,JPN,DF,Kortrijk,23-312,2000,9.2,14,7,10,4,0,6,11,54.5,5,10,5,5,8,22,43,0
Joel Fujita,JPN,MF,Sint-Truiden,22-260,2002,9.7,17,9,10,6,1,4,17,23.5,13,14,2,12,14,31,17,1
Mohammed Fuseini,GHA,FW,Union SG,22-170,2002,9.0,5,4,3,1,1,1,8,12.5,7,5,0,5,5,10,1,0
Hugo Gambor,CTA,DF,Gent,21-308,2002,5.9,16,9,9,6,1,7,8,87.5,1,9,1,8,16,32,6,0
Omri Gandelman,ISR,MF,Gent,24-170,2000,7.2,16,10,5,6,5,7,13,53.8,6,7,2,5,4,20,7,1
Wouter George,BEL,DF,OH Leuven,22-244,2002,0.1,2,0,0,2,0,1,3,33.3,2,1,0,1,0,2,0,0
Pieter Gerkens,BEL,MF,Gent,29-081,1995,4.2,7,6,2,3,2,3,9,33.3,6,7,2,5,6,13,10,0
Faisal Al Ghamdi,KSA,MF,Beerschot,23-081,2001,3.7,9,7,6,2,1,4,7,57.1,3,2,1,1,2,11,7,0
Óscar Gil,ESP,DF,OH Leuven,27-190,1997,4.9,10,4,7,3,0,4,9,44.4,5,9,1,8,5,15,14,0
Bruno Godeau,BEL,DF,Sint-Truiden,32-176,1992,11.8,19,16,14,4,1,14,20,70.0,6,19,13,6,14,33,77,0
Bryan Goncalves,FRA,DF,Dender,28-106,1996,3.4,5,2,4,1,0,4,8,50.0,4,4,3,1,4,9,21,0
Parfait Guiagon,CIV,FW,Charleroi,23-254,2001,8.8,14,12,1,9,4,4,9,44.4,5,6,0,6,1,15,3,0
Muhammed Gümüskaya,TUR,FW,Westerlo,23-306,2001,0.1,0,0,0,0,0,0,0,,0,0,0,0,0,0,0,0
Patrik Gunnarsson,ISL,GK,Kortrijk,23-353,2000,10.2,0,0,0,0,0,0,0,,0,1,0,1,0,0,4,1
Andri Guðjohnsen,ISL,FW,Gent,22-278,2002,6.7,6,5,0,4,2,1,2,50.0,1,4,0,4,0,6,2,0
Anouar Ait El Hadj,BEL,MF,Union SG,22-196,2002,4.9,13,9,3,7,3,6,15,40.0,9,7,0,7,2,15,0,0
Geoffry Hairemans,BEL,"MF,FW",Mechelen,33-012,1991,2.6,4,2,0,2,2,1,5,20.0,4,6,1,5,2,6,3,0
Dogucan Haspolat,TUR,MF,Westerlo,24-265,2000,12.0,38,25,10,25,3,14,30,46.7,16,20,6,14,27,65,29,0
Ibe Hautekiet,BEL,DF,Standard Liège,22-203,2002,9.3,16,12,8,6,2,6,12,50.0,6,11,5,6,17,33,29,0
Ewan Henderson,SCO,MF,Beerschot,24-220,2000,6.1,7,5,1,3,3,4,7,57.1,3,8,3,5,3,10,8,0
Lennard Hens,BEL,MF,Dender,28-268,1996,6.8,18,11,2,11,5,8,24,33.3,16,14,2,12,11,29,5,0
Daan Heymans,BEL,MF,Charleroi,25-140,1999,11.5,20,14,3,13,4,4,9,44.4,5,8,1,7,5,25,8,0
Bryan Heynen,BEL,MF,Genk,27-270,1997,8.1,15,11,7,7,1,5,14,35.7,9,12,5,7,11,26,20,0
David Hrnčár,SVK,"DF,MF",Dender,26-328,1997,7.5,12,6,8,4,0,7,13,53.8,6,5,1,4,10,22,19,0
Patrik Hrošovský,SVK,MF,Genk,32-194,1992,8.8,8,5,0,5,3,4,9,44.4,5,7,1,6,3,11,11,0
Dean Huiberts,NED,MF,Beerschot,24-170,2000,2.2,9,2,4,4,1,5,8,62.5,3,3,2,1,2,11,3,0
Oh Hyeon-gyu,KOR,FW,Genk,23-204,2001,1.5,1,1,0,0,1,1,3,33.3,2,0,0,0,0,1,1,0
Hong Hyunseok,KOR,MF,Gent,25-139,1999,2.8,4,2,2,2,0,1,6,16.7,5,2,0,2,1,5,1,0
Mounaim El Idrissy,FRA,"DF,FW",Kortrijk,25-266,1999,3.4,7,7,6,1,0,1,3,33.3,2,3,1,2,4,11,6,0
Chukwubuikem Ikwuemesi,NGA,FW,OH Leuven,23-089,2001,4.1,1,1,0,1,0,0,0,,0,2,0,2,1,2,2,0
Atsuki Ito,JPN,MF,Gent,26-083,1998,5.6,16,11,5,9,2,6,16,37.5,10,6,2,4,9,25,16,1
Ryotaro Ito,JPN,MF,Sint-Truiden,26-270,1998,8.2,8,7,4,3,1,3,9,33.3,6,3,1,2,2,10,2,0
Franjo Ivanović,CRO,FW,Union SG,21-032,2003,4.7,4,2,1,2,1,0,7,0.0,7,6,1,5,0,4,3,0
Vincent Janssen,NED,FW,Antwerp,30-140,1994,11.8,19,17,4,12,3,12,20,60.0,8,6,0,6,5,24,12,0
Wolke Janssens,BEL,DF,Sint-Truiden,29-296,1995,1.0,2,0,2,0,0,1,2,50.0,1,1,0,1,1,3,9,0
Ardon Jashari,SUI,MF,Club Brugge,22-095,2002,5.1,9,6,6,3,0,2,6,33.3,4,1,1,0,5,14,7,0
Edisson Jordanov,BUL,DF,Westerlo,31-147,1993,0.8,1,1,1,0,0,1,2,50.0,1,1,0,1,2,3,2,0
Ferran Jutglà,ESP,"FW,MF",Club Brugge,25-275,1999,3.2,6,2,1,3,2,2,2,100.0,0,2,1,1,0,6,2,0
Mathias Jørgensen,DEN,DF,Anderlecht,34-193,1990,8.0,10,5,8,2,0,7,10,70.0,3,16,13,3,8,18,30,0
Elton Kabangu,BEL,"FW,MF",Union SG,26-268,1998,1.4,1,0,0,0,1,0,1,0.0,1,0,0,0,0,1,0,0
Abdelkahar Kadri,ALG,MF,Kortrijk,24-131,2000,8.3,21,13,9,7,5,9,16,56.3,7,13,2,11,9,30,3,1
Emmanuel Kakou,CIV,DF,Cercle Brugge,19-125,2005,6.0,9,4,6,3,0,3,10,30.0,7,9,3,6,9,18,18,0
Ismaël Kandouss,MAR,MF,Gent,26-356,1997,0.0,0,0,0,0,0,0,0,,0,0,0,0,0,0,2,0
Takuro Kaneko,JPN,"MF,FW",Kortrijk,27-095,1997,7.5,13,10,4,6,3,8,13,61.5,5,11,1,10,6,19,5,0
Konstantinos Karetsas,BEL,MF,Genk,16-349,2007,5.0,8,4,2,2,4,5,9,55.6,4,7,0,7,0,8,0,0
Joris Kayembe,COD,"DF,MF",Genk,30-086,1994,11.9,23,14,14,6,3,10,16,62.5,6,7,2,5,18,41,27,1
Charly Keita,FRA,FW,Beerschot,25-139,1999,6.4,1,0,0,1,0,0,1,0.0,1,10,2,8,1,2,8,0
Check Keita,FRA,DF,Charleroi,21-214,2003,5.6,15,9,11,4,0,11,11,100.0,0,8,3,5,4,19,9,0
Mandela Keita,BEL,"MF,DF",Antwerp,22-176,2002,2.6,7,3,3,3,1,5,7,71.4,2,2,1,1,5,12,3,0
Gyrano Kerk,SUR,"FW,MF",Antwerp,28-336,1995,9.0,11,9,8,2,1,4,18,22.2,14,10,0,10,2,13,5,0
Anan Khalaili,ISR,"DF,FW",Union SG,20-060,2004,2.8,9,4,5,3,1,3,5,60.0,2,4,0,4,3,12,4,0
Bilal El Khannouss,MAR,MF,Genk,20-176,2004,0.8,2,1,1,0,1,0,0,,0,1,0,1,0,2,3,0
Leo Kokubo,JPN,GK,Sint-Truiden,23-284,2001,9.0,0,0,0,0,0,0,0,,0,0,0,0,0,0,5,1
Mory Konaté,GUI,MF,Mechelen,30-353,1993,1.0,0,0,0,0,0,0,0,,0,1,0,1,0,0,3,0
Mohamed Koné,CIV,GK,Charleroi,22-240,2002,11.0,0,0,0,0,0,0,1,0.0,1,0,0,0,0,0,4,1
Josué Kongolo,BEL,DF,Genk,18-203,2006,0.8,3,3,0,3,0,1,1,100.0,0,0,0,0,2,5,5,0
Tolis Konstantopoulos,GRE,DF,Beerschot,22-092,2002,8.7,26,17,18,7,1,13,23,56.5,10,14,7,7,15,41,47,0
Ayouba Kosiah,LBR,"FW,DF",Beerschot,23-103,2001,2.3,3,2,0,3,0,1,2,50.0,1,1,0,1,0,3,0,0
Florian Krüger,GER,"FW,MF",Beerschot,25-263,1999,1.3,1,0,0,0,1,1,3,33.3,2,2,0,2,0,1,1,0
Léandre Kuavita,BEL,MF,Standard Liège,20-155,2004,7.0,8,4,1,5,2,6,9,66.7,3,9,1,8,5,13,11,0
Sven Kums,BEL,MF,Gent,36-250,1988,4.0,9,4,3,2,4,4,12,33.3,8,6,2,4,2,11,7,0
Hasan Kuruçay,,DF,OH Leuven,27-063,1997,3.5,5,3,4,1,0,3,4,75.0,1,1,1,0,2,7,18,0
Roman Květ,CZE,"MF,FW",Dender,26-321,1997,8.2,15,7,3,5,7,6,19,31.6,13,14,1,13,7,22,7,0
Grejohn Kyei,FRA,FW,Charleroi,29-082,1995,3.7,3,1,0,3,0,2,2,100.0,0,2,1,1,0,3,3,0
Grejohn Kyei,FRA,"FW,MF",Standard Liège,29-082,1995,2.4,2,1,1,0,1,2,3,66.7,1,0,0,0,0,2,6,0
Bram Lagae,BEL,DF,Kortrijk,20-293,2004,8.0,11,7,8,3,0,8,15,53.3,7,15,7,8,6,17,37,2
Hugo Lambotte,BEL,MF,Sint-Truiden,18-135,2006,0.4,0,0,0,0,0,0,2,0.0,2,3,0,3,0,0,0,0
Senne Lammens,BEL,GK,Antwerp,22-118,2002,12.0,0,0,0,0,0,0,0,,0,0,0,0,0,0,2,0
Lion Lauberbach,GER,FW,Mechelen,26-261,1998,7.3,3,1,1,2,0,0,2,0.0,2,2,0,2,0,3,7,0
Henry Lawrence,ENG,DF,Standard Liège,23-042,2001,6.6,8,5,5,2,1,4,10,40.0,6,8,5,3,5,13,18,0
Theo Leoni,BEL,"MF,DF",Anderlecht,24-195,2000,9.2,16,13,6,7,3,10,17,58.8,7,8,0,8,17,33,18,0
Fedde Leysen,BEL,DF,Union SG,21-116,2003,7.8,12,9,8,3,1,6,8,75.0,2,8,3,5,14,26,22,0
Tobe Leysen,BEL,GK,OH Leuven,22-238,2002,12.0,0,0,0,0,0,0,0,,0,0,0,0,0,0,2,1
Jonas Lietaert,BEL,DF,Cercle Brugge,20-109,2004,0.6,3,3,1,2,0,2,6,33.3,4,1,0,1,1,4,3,0
Ridwane M'Barki,BEL,"DF,MF",Dender,30-123,1994,1.4,2,2,1,0,1,2,5,40.0,3,7,1,6,2,4,3,0
Kevin Mac Allister,ARG,DF,Union SG,26-361,1997,10.6,33,22,15,16,2,16,35,45.7,19,18,7,11,24,57,39,0
Koki Machida,JPN,DF,Union SG,27-069,1997,11.0,11,8,8,2,1,7,17,41.2,10,11,8,3,23,34,43,0
Nicolas Madsen,DEN,MF,Westerlo,24-230,2000,4.0,10,7,4,5,1,5,8,62.5,3,3,1,2,3,13,8,0
Mathieu Maertens,BEL,"FW,MF",OH Leuven,29-220,1995,8.6,6,5,2,2,2,1,7,14.3,6,10,1,9,5,11,6,0
Gary Magnée,BEL,"MF,DF",Cercle Brugge,25-021,1999,4.3,10,7,8,2,0,6,8,75.0,2,11,2,9,9,19,13,0
Mark Mampasi,UKR,DF,Kortrijk,21-235,2003,5.8,11,6,5,4,2,5,8,62.5,3,6,3,3,3,14,28,0
José Marsà,ESP,DF,Mechelen,22-243,2002,9.8,12,10,6,6,0,4,9,44.4,5,23,12,11,11,23,34,1
Ar'jany Martha,NED,"MF,DF",Beerschot,21-059,2003,4.4,20,7,13,6,1,10,22,45.5,12,10,3,7,10,30,18,1
Kéres Masangu,BEL,"MF,FW",Dender,24-240,2000,0.1,0,0,0,0,0,0,0,,0,1,0,1,0,0,1,0
Davor Matijas,CRO,GK,Beerschot,25-071,1999,7.0,2,2,2,0,0,2,2,100.0,0,0,0,0,0,2,8,0
Hervé Matthys,BEL,DF,Beerschot,28-288,1996,10.1,9,5,5,4,0,6,16,37.5,10,15,11,4,19,28,32,0
Youssef Maziz,FRA,"MF,FW",OH Leuven,26-131,1998,7.9,5,2,3,2,0,2,3,66.7,1,4,0,4,4,9,5,0
Loïc Mbe Soh,FRA,DF,Beerschot,23-142,2001,5.0,6,4,5,1,0,2,5,40.0,3,6,5,1,5,11,27,0
Isaac Mbenza,BEL,FW,Charleroi,28-239,1996,3.5,3,2,0,2,1,1,4,25.0,3,0,0,0,1,4,7,0
Mark McKenzie,USA,FW,Genk,25-251,1999,0.0,0,0,0,0,0,0,0,,0,0,0,0,0,0,0,0
Dire Mebude,SCO,FW,Westerlo,20-158,2004,6.0,4,3,1,2,1,2,8,25.0,6,5,0,5,3,7,4,0
Brandon Mechele,BEL,DF,Club Brugge,31-279,1993,12.0,19,13,14,4,1,8,15,53.3,7,14,6,8,17,36,50,0
Nayel Mehssatou,CHI,"MF,DF",Kortrijk,22-205,2002,8.6,16,8,3,10,3,4,12,33.3,8,13,2,11,11,27,16,0
Hamza Mendyl,MAR,"DF,MF",OH Leuven,27-012,1997,4.4,12,9,6,6,0,6,9,66.7,3,8,2,6,4,16,16,0
Billel Messaoudi,ALG,"FW,MF",Kortrijk,26-317,1997,1.4,1,1,1,0,0,0,2,0.0,2,1,0,1,0,1,1,0
Senna Miangue,BEL,DF,Cercle Brugge,27-271,1997,7.3,7,6,3,4,0,7,12,58.3,5,8,3,5,11,18,44,0
Simion Michez,BEL,"DF,MF",Beerschot,22-267,2002,5.4,15,7,4,10,1,10,12,83.3,2,12,0,12,7,22,14,0
Simon Mignolet,BEL,GK,Club Brugge,36-241,1988,12.0,1,1,1,0,0,1,1,100.0,0,0,0,0,0,1,2,1
Alan Minda,ECU,"FW,MF",Cercle Brugge,21-172,2003,4.3,3,2,2,0,1,3,4,75.0,1,2,0,2,0,3,0,0
David Mindombe,BEL,DF,Sint-Truiden,23-136,2001,1.0,0,0,0,0,0,0,0,,0,0,0,0,1,1,10,0
Stefan Mitrović,SRB,FW,OH Leuven,22-079,2002,2.6,3,2,2,1,0,2,4,50.0,2,2,0,2,2,5,1,0
Stefan Mitrović,SRB,DF,Gent,34-164,1990,9.3,16,8,13,3,0,14,17,82.4,3,13,10,3,9,25,48,0
Anthony Moris,LUX,GK,Union SG,34-187,1990,12.0,0,0,0,0,0,0,0,,0,0,0,0,0,0,9,1
Kerim Mrabti,SWE,"MF,FW",Mechelen,30-166,1994,9.1,7,2,3,3,1,3,7,42.9,4,7,4,3,5,12,7,0
Suphanat Mueanta,THA,"FW,MF",OH Leuven,22-092,2002,0.7,1,1,0,1,0,0,0,,0,0,0,0,0,1,1,0
Moussa N'Diaye,SEN,DF,Anderlecht,22-137,2002,7.5,15,10,9,5,1,6,10,60.0,4,3,1,2,8,23,25,1
Ignace N'Dri,CIV,"FW,DF",OH Leuven,24-006,2000,10.3,22,12,7,10,5,6,13,46.2,7,9,2,7,3,25,4,0
Flávio Nazinho,POR,DF,Cercle Brugge,21-105,2003,7.7,23,16,10,10,3,16,25,64.0,9,11,1,10,16,39,19,2
Roman Neustädter,RUS,DF,Westerlo,36-258,1988,9.0,13,4,8,5,0,8,12,66.7,4,9,3,6,13,26,44,0
Julien Ngoy,BEL,FW,Mechelen,27-000,1997,0.8,0,0,0,0,0,0,0,,0,0,0,0,0,0,2,0
Nathan Ngoy,BEL,DF,Standard Liège,21-145,2003,2.7,8,5,6,2,0,5,7,71.4,2,6,4,2,5,13,15,0
Adam Nhaili,BEL,"FW,MF",Sint-Truiden,19-085,2005,1.9,2,1,2,0,0,0,1,0.0,1,1,0,1,1,3,0,0
Ousseynou Niang,SEN,"DF,FW",Union SG,23-021,2001,2.8,10,9,5,3,2,4,10,40.0,6,4,1,3,0,10,1,0
Casper Nielsen,DEN,MF,Club Brugge,30-187,1994,1.1,1,0,0,1,0,0,0,,0,0,0,0,1,2,3,0
Gustaf Nilsson,SWE,FW,Club Brugge,27-163,1997,8.2,5,2,1,2,2,2,3,66.7,1,6,2,4,2,7,8,0
Ken Nkuba,BEL,"MF,DF",Genk,22-286,2002,1.5,7,5,5,1,1,1,5,20.0,4,2,0,2,2,9,3,0
Petter Nosa Dahl,NOR,"MF,FW",Mechelen,21-285,2003,1.8,7,4,1,2,4,4,5,80.0,1,3,0,3,3,10,1,0
Lucas Noubi,BEL,DF,Standard Liège,19-292,2005,1.5,2,0,0,2,0,1,2,50.0,1,1,0,1,4,6,7,0
Bruny Nsimba,BEL,FW,Dender,24-211,2000,11.2,6,5,2,2,2,2,5,40.0,3,5,0,5,2,8,5,0
Erick Nunes,BRA,"MF,DF",Cercle Brugge,20-247,2004,4.9,17,10,6,7,4,9,18,50.0,9,9,1,8,6,23,11,1
Antonio Nusa,NOR,"FW,MF",Club Brugge,19-199,2005,1.8,2,1,1,0,1,2,3,66.7,1,0,0,0,0,2,1,0
Mardochee Nzita,BEL,"DF,FW",Charleroi,24-252,2000,0.8,1,0,1,0,0,1,3,33.3,2,3,0,3,0,1,1,0
Aiden O'Neill,AUS,MF,Standard Liège,26-121,1998,12.0,30,19,9,20,1,14,31,45.2,17,15,4,11,9,39,22,0
Denis Odoi,GHA,"MF,DF",Antwerp,36-159,1988,7.0,12,8,4,6,2,7,10,70.0,3,4,3,1,7,19,16,0
Ryoya Ogawa,JPN,"DF,MF",Sint-Truiden,27-344,1996,11.8,28,16,18,7,3,17,28,60.7,11,19,5,14,11,39,41,1
Kazeem Olaigbe,BEL,"MF,FW",Cercle Brugge,21-305,2003,5.5,11,8,2,4,5,7,13,53.8,6,7,0,7,0,11,3,0
Takuma Ominami,JPN,DF,OH Leuven,26-325,1997,6.3,7,6,6,1,0,3,4,75.0,1,7,1,6,0,7,22,0
Jacob Ondrejka,SWE,"FW,MF",Antwerp,22-061,2002,10.5,8,7,4,3,1,2,3,66.7,1,6,0,6,4,12,0,0
Raphael Onyedika,NGA,MF,Club Brugge,23-197,2001,7.8,17,12,6,11,0,5,13,38.5,8,9,1,8,10,27,9,3
Ragnar Oratmangoen,IDN,"MF,DF",Dender,26-286,1998,0.9,2,2,1,1,0,0,1,0.0,1,0,0,0,0,2,3,0
Joel Ordóñez,ECU,DF,Club Brugge,20-195,2004,6.9,5,3,2,3,0,2,5,40.0,3,4,2,2,12,17,21,1
Emir Ortakaya,TUR,DF,Westerlo,20-133,2004,0.5,1,0,0,1,0,0,0,,0,1,1,0,2,3,2,0
Manuel Osifo,BEL,DF,OH Leuven,21-094,2003,2.0,5,3,2,3,0,4,5,80.0,1,1,0,1,2,7,4,0
Zakaria El Ouahdi,MAR,"DF,MF",Genk,22-307,2001,8.9,19,13,14,2,3,12,25,48.0,13,18,8,10,14,33,18,0
Aziz Ouattara,CIV,MF,Mechelen,23-303,2001,9.5,17,12,8,8,1,6,15,40.0,9,14,4,10,9,26,28,0
Kader Ouattara,BFA,"MF,FW",Cercle Brugge,19-160,2005,3.1,6,4,0,2,4,1,3,33.3,2,10,2,8,1,7,0,0
Aiham Ousou,SYR,DF,Charleroi,24-298,2000,6.6,10,7,6,3,1,3,5,60.0,2,7,6,1,13,23,33,0
Louis Patris,BEL,DF,Anderlecht,23-148,2001,0.0,1,1,0,1,0,1,1,100.0,0,0,0,0,0,1,0,0
Louis Patris,BEL,"DF,MF",Sint-Truiden,23-148,2001,5.8,23,9,8,12,3,9,21,42.9,12,14,1,13,10,33,17,0
Mike Penders,BEL,GK,Genk,19-094,2005,2.0,0,0,0,0,0,0,0,,0,0,0,0,0,0,0,0
Jérémy Pétris,FRA,DF,Charleroi,26-279,1998,10.6,32,21,21,9,2,20,25,80.0,5,4,0,4,15,47,23,0
Patrick Pflücke,GER,"DF,MF",Mechelen,27-338,1996,10.3,14,10,11,2,1,12,27,44.4,15,13,2,11,1,15,20,0
Arthur Piedfort,BEL,MF,Westerlo,19-275,2005,8.5,25,10,6,13,6,8,13,61.5,5,12,3,9,7,32,10,0
Lucas Pirard,BEL,GK,Kortrijk,29-237,1995,0.8,0,0,0,0,0,0,0,,0,0,0,0,0,0,0,0
Brian Plat,NED,"DF,MF",Beerschot,24-211,2000,8.3,24,12,14,10,0,9,16,56.3,7,15,3,12,10,34,33,1
Ewoud Pletinckx,BEL,DF,OH Leuven,24-023,2000,4.5,4,2,2,2,0,1,2,50.0,1,6,6,0,3,7,31,0
Boris Popović,SRB,DF,Cercle Brugge,24-250,2000,1.8,1,1,0,1,0,0,1,0.0,1,4,2,2,3,4,2,0
Dennis Praet,BEL,"MF,FW",Antwerp,30-172,1994,0.9,2,1,0,2,0,1,1,100.0,0,0,0,0,0,2,2,0
Isaac Price,NIR,MF,Standard Liège,21-037,2003,9.7,18,10,6,12,0,9,25,36.0,16,19,3,16,5,23,16,1
Cameron Puertas,SUI,MF,Union SG,26-076,1998,2.2,2,2,0,2,0,2,5,40.0,3,2,0,2,1,3,0,0
Joedrick Pupe,BEL,DF,Dender,27-151,1997,9.2,9,6,4,4,1,5,10,50.0,5,9,4,5,19,28,43,0
Toon Raemaekers,BEL,DF,Mechelen,24-054,2000,10.5,22,10,17,4,1,13,25,52.0,12,14,7,7,13,35,47,0
Benito Raman,BEL,FW,Mechelen,29-361,1994,2.1,1,0,0,0,1,0,2,0.0,2,0,0,0,0,1,0,0
Mathias Rasmussen,NOR,MF,Union SG,26-343,1997,4.2,12,6,5,3,4,2,3,66.7,1,4,0,4,7,19,7,0
Christiaan Ravych,BEL,DF,Cercle Brugge,22-095,2002,11.6,30,13,16,13,1,17,26,65.4,9,13,8,5,17,47,37,0
Semm Renders,BEL,"DF,MF",Antwerp,16-321,2007,0.8,0,0,0,0,0,0,1,0.0,1,1,0,1,1,1,2,0
Tom Reyners,BEL,"MF,FW",Beerschot,24-196,2000,4.9,10,7,7,3,0,6,10,60.0,4,4,2,2,1,11,2,0
Bryan Reynolds,USA,DF,Westerlo,23-127,2001,10.4,24,17,16,5,3,14,20,70.0,6,10,3,7,9,33,23,0
Federico Ricca,URU,DF,OH Leuven,29-337,1994,6.4,4,3,4,0,0,2,4,50.0,2,6,4,2,10,14,28,0
Jaïro Riedewald,NED,MF,Antwerp,28-054,1996,0.4,2,0,0,1,1,0,0,,0,0,0,0,0,2,1,0
Mats Rits,BEL,MF,Anderlecht,31-107,1993,9.5,9,7,2,4,3,5,10,50.0,5,13,6,7,9,18,18,0
Nathan Rôdes,BEL,MF,Dender,26-327,1997,11.5,24,17,9,11,4,12,31,38.7,19,24,4,20,5,29,21,1
Kevin Rodríguez,ECU,FW,Union SG,24-243,2000,4.6,1,1,0,1,0,1,1,100.0,0,1,0,1,1,2,5,0
Davy Roef,BEL,GK,Gent,30-270,1994,12.0,0,0,0,0,0,0,0,,0,0,0,0,0,0,6,0
Žan Rogelj,SVN,DF,Charleroi,24-343,1999,1.4,4,3,3,1,0,2,2,100.0,0,1,1,0,1,5,6,0
Zaid Romero,ARG,DF,Club Brugge,24-323,1999,3.9,9,6,5,4,0,4,6,66.7,2,2,1,1,6,15,14,0
Tuur Rommens,BEL,DF,Westerlo,21-221,2003,9.8,17,10,10,6,1,7,15,46.7,8,17,4,13,26,43,32,1
Gilles Ruyssen,BEL,DF,Dender,30-137,1994,11.5,22,13,17,4,1,15,27,55.6,12,14,9,5,25,47,62,0
Kyriani Sabbe,BEL,DF,Club Brugge,19-286,2005,0.6,3,2,1,2,0,2,3,66.7,1,1,0,1,1,4,5,0
Mujaid Sadick,ESP,DF,Genk,24-233,2000,11.8,20,13,11,9,0,10,12,83.3,2,21,15,6,11,31,23,0
Noah Sadiki,COD,MF,Union SG,19-321,2004,10.4,14,9,4,6,4,2,6,33.3,4,15,3,12,8,22,8,0
Marwan Al Sahafi,KSA,FW,Beerschot,20-259,2004,3.7,1,2,0,0,1,0,0,,0,1,0,1,0,1,4,0
Matisse Samoise,BEL,"DF,MF",Gent,22-347,2001,3.3,14,9,8,4,2,9,12,75.0,3,7,4,3,6,20,11,0
Ryan Sanusi,BEL,MF,Beerschot,32-302,1992,11.4,21,12,15,5,1,10,21,47.6,11,23,8,15,11,32,19,0
Killian Sardella,BEL,DF,Anderlecht,22-184,2002,11.0,21,16,11,6,4,12,21,57.1,9,11,5,6,6,27,21,0
Nikolas Sattlberger,AUT,MF,Genk,20-289,2004,6.1,19,8,7,11,1,7,17,41.2,10,6,1,5,8,27,7,0
Allahyar Sayyadmanesh,IRN,"FW,MF",Westerlo,23-126,2001,10.3,20,15,7,7,6,11,17,64.7,6,9,3,6,2,22,11,0
Aurélien Scheidler,FRA,FW,Dender,26-151,1998,3.1,4,2,1,2,1,1,1,100.0,0,1,0,1,0,4,5,0
Joël Schingtienne,BEL,DF,OH Leuven,22-082,2002,4.0,10,5,7,3,0,6,6,100.0,0,9,4,5,4,14,14,0
Rob Schoofs,BEL,MF,Mechelen,30-224,1994,11.7,15,6,5,9,1,8,12,66.7,4,9,1,8,13,28,15,0
Siebe Schrijvers,BEL,MF,OH Leuven,28-107,1996,6.1,16,8,3,10,3,9,10,90.0,1,9,3,6,5,21,15,0
Christopher Scott,GER,MF,Antwerp,22-148,2002,0.6,0,0,0,0,0,0,1,0.0,1,0,0,0,0,0,0,0
Joaquin Seys,BEL,DF,Club Brugge,19-219,2005,9.7,19,12,11,4,4,8,16,50.0,8,8,1,7,15,34,23,0
Nick Shinton,BEL,GK,Beerschot,23-176,2001,5.0,1,0,1,0,0,1,3,33.3,2,0,0,0,0,1,6,0
João Silva,POR,DF,Kortrijk,25-293,1999,11.6,14,9,9,4,1,6,10,60.0,4,27,18,9,21,35,48,2
Jan-Carlo Simic,SRB,DF,Anderlecht,19-184,2005,9.0,7,3,5,2,0,1,2,50.0,1,10,9,1,11,18,35,1
Roko Simic,CRO,FW,Kortrijk,21-053,2003,1.4,0,0,0,0,0,0,3,0.0,3,2,0,2,0,0,3,0
Hugo Siquet,BEL,DF,Club Brugge,22-116,2002,2.6,5,3,4,1,0,4,10,40.0,6,2,0,2,1,6,9,0
Abdoulaye Sissako,FRA,MF,Kortrijk,26-160,1998,3.0,5,2,1,3,1,1,5,20.0,4,3,0,3,3,8,4,0
Michał Skóraś,POL,"FW,MF",Club Brugge,24-261,2000,3.5,8,4,3,2,3,6,7,85.7,1,4,0,4,2,10,3,0
Andreas Skov Olsen,DEN,FW,Club Brugge,24-309,1999,7.2,4,2,1,2,1,4,8,50.0,4,5,1,4,4,8,5,0
Matte Smets,BEL,DF,Genk,20-303,2004,10.5,15,8,10,5,0,7,10,70.0,3,17,11,6,14,29,34,2
Milan Smits,BEL,MF,Antwerp,19-355,2004,0.3,0,0,0,0,0,0,1,0.0,1,0,0,0,0,0,0,0
Jordy Soladio,BEL,FW,Dender,26-264,1998,4.1,1,1,0,1,0,0,1,0.0,1,4,1,3,0,1,3,0
Thibo Somers,BEL,"FW,DF",Cercle Brugge,25-231,1999,10.7,12,8,6,4,2,5,17,29.4,12,16,3,13,6,18,10,0
Momodou Sonko,SWE,"MF,FW",Gent,19-276,2005,0.8,5,5,4,1,0,0,0,,0,0,0,0,3,8,0,0
Yira Sor,NGA,FW,Genk,24-101,2000,6.4,7,4,4,3,0,0,2,0.0,2,4,0,4,4,11,1,0
Ibrahima Sory Bangoura,GUI,MF,Genk,20-302,2004,3.1,18,10,6,7,5,6,8,75.0,2,3,0,3,8,26,2,0
Jorne Spileers,BEL,DF,Club Brugge,19-286,2005,1.2,3,1,0,3,0,1,2,50.0,1,3,3,0,0,3,5,0
Alexandre Stanic,BEL,FW,Antwerp,19-310,2004,0.0,0,0,0,0,0,0,0,,0,0,0,0,0,0,0,0
Lucas Stassin,BEL,FW,Westerlo,19-340,2004,4.5,4,3,1,0,3,1,3,33.3,2,0,0,0,1,5,2,0
Jarne Steuckers,BEL,FW,Genk,22-272,2002,10.9,8,3,5,2,1,5,11,45.5,6,1,0,1,1,9,4,0
Nikola Storm,BEL,"FW,MF",Mechelen,30-033,1994,8.1,7,5,2,4,1,4,7,57.1,3,6,1,5,2,9,5,0
Mario Stroeykens,BEL,"MF,FW",Anderlecht,20-034,2004,8.6,20,9,7,8,5,8,15,53.3,7,7,0,7,5,25,2,1
Franck Surdez,SUI,"MF,FW",Gent,22-181,2002,9.2,16,11,3,7,6,4,15,26.7,11,8,0,8,4,20,4,0
Bosko Sutalo,CRO,DF,Standard Liège,24-306,2000,11.3,30,21,23,6,1,19,22,86.4,3,13,10,3,31,61,52,0
Serhiy Sydorchuk,UKR,MF,Westerlo,33-184,1991,0.3,1,1,0,0,1,0,0,,0,0,0,0,0,1,0,0
Ross Sykes,ENG,DF,Union SG,25-221,1999,1.0,4,4,4,0,0,2,2,100.0,0,1,0,1,3,7,8,0
Dembo Sylla,GUI,DF,Dender,21-358,2002,1.1,3,3,3,0,0,1,2,50.0,1,0,0,0,0,3,2,0
Youssuf Sylla,BEL,FW,Charleroi,21-319,2002,4.1,2,0,0,2,0,0,1,0.0,1,1,0,1,1,3,5,0
Tomoki Takamine,JPN,MF,Kortrijk,26-309,1997,5.3,6,2,3,3,0,0,4,0.0,4,3,0,3,2,8,13,0
Chemsdine Talbi,BEL,FW,Club Brugge,19-177,2005,2.1,2,1,1,1,0,2,2,100.0,0,1,0,1,0,2,1,0
Shogo Taniguchi,JPN,DF,Sint-Truiden,33-110,1991,9.4,8,7,4,4,0,3,8,37.5,5,10,7,3,13,21,51,1
Henok Teklab,GER,DF,Union SG,25-352,1998,2.4,7,4,2,5,0,5,7,71.4,2,1,0,1,4,11,2,0
Casper Terho,FIN,"DF,FW",Union SG,21-131,2003,4.8,9,5,4,5,0,6,19,31.6,13,7,1,6,7,16,11,0
Jean Thierry Lazare,CIV,"MF,FW",Union SG,26-240,1998,3.1,13,9,5,4,4,4,7,57.1,3,5,1,4,1,14,1,0
Yassine Titraoui,ALG,MF,Charleroi,21-099,2003,1.5,5,5,2,2,1,3,8,37.5,5,1,0,1,2,7,0,0
Jordan Torunarigha,GER,DF,Gent,27-087,1997,5.6,8,5,7,1,0,6,7,85.7,1,14,9,5,8,16,34,0
Ahmed Touba,ALG,DF,Mechelen,26-235,1998,5.5,10,7,6,3,1,5,5,100.0,0,3,2,1,11,21,20,1
Mamadou Traoré,MLI,DF,Union SG,22-213,2002,0.2,0,0,0,0,0,0,1,0.0,1,1,0,1,0,0,1,0
Derrick Tshimanga,BEL,DF,Beerschot,35-362,1988,8.5,11,6,9,1,1,3,6,50.0,3,8,2,6,12,23,23,1
Antef Tsoungui,BEL,DF,OH Leuven,21-308,2002,0.5,1,1,0,1,0,0,1,0.0,1,1,0,1,1,2,2,0
Christos Tzolis,GRE,"FW,MF",Club Brugge,22-277,2002,9.6,12,6,6,2,4,5,12,41.7,7,15,0,15,4,16,6,0
Victor Udoh,NGA,"FW,DF",Antwerp,20-015,2004,0.9,1,1,0,1,0,1,1,100.0,0,0,0,0,0,1,0,0
Edgaras Utkus,LTU,"DF,MF",Cercle Brugge,24-133,2000,1.7,8,5,6,1,1,6,7,85.7,1,6,2,4,2,10,11,0
Anthony Valencia,ECU,FW,Antwerp,21-104,2003,3.3,4,5,1,0,3,1,6,16.7,5,3,0,3,3,7,2,0
Jules Van Cleemput,BEL,DF,Mechelen,27-205,1997,2.6,2,1,0,2,0,1,4,25.0,3,3,2,1,9,11,4,0
Hendrik Van Crombrugge,BEL,GK,Genk,31-186,1993,10.0,0,0,0,0,0,0,0,,0,0,0,0,0,0,5,1
Zeno Van den Bosch,BEL,DF,Antwerp,21-119,2003,12.0,13,14,10,3,0,7,11,63.6,4,22,14,8,8,21,47,0
Thomas Van den Keybus,BEL,"FW,MF",Westerlo,23-191,2001,1.5,1,0,0,1,0,1,5,20.0,4,4,1,3,0,1,1,0
Hannes Van der Bruggen,BEL,MF,Cercle Brugge,31-215,1993,8.5,18,13,6,7,5,8,26,30.8,18,8,3,5,14,32,17,0
Rein Van Helden,BEL,DF,Sint-Truiden,22-101,2002,11.9,26,15,20,4,2,12,23,52.2,11,27,18,9,22,48,68,0
Koen Van Langendonck,BEL,GK,Westerlo,35-146,1989,1.0,0,0,0,0,0,0,0,,0,0,0,0,0,0,0,0
Jasper Van Oudenhove,BEL,"MF,DF",Dender,25-365,1998,0.6,2,0,2,0,0,1,3,33.3,2,0,0,0,0,2,3,0
Hans Vanaken,BEL,MF,Club Brugge,32-070,1992,11.7,13,8,7,5,1,3,10,30.0,7,11,0,11,5,18,13,0
Zalán Vancsa,HUN,MF,Gent,20-006,2004,0.9,0,0,0,0,0,0,1,0.0,1,1,0,1,0,0,1,0
Tom Vandenberghe,BEL,GK,Kortrijk,32-077,1992,1.0,0,0,0,0,0,0,0,,0,0,0,0,0,0,0,0
Gerard Vandeplas,BEL,FW,Antwerp,18-251,2006,0.1,1,0,0,1,0,0,0,,0,1,0,1,0,1,1,0
Zinho Vanheusden,BEL,DF,Mechelen,25-096,1999,1.0,1,0,1,0,0,0,0,,0,0,0,0,2,3,6,0
Charles Vanhoutte,BEL,MF,Union SG,26-047,1998,11.2,33,24,12,18,3,17,31,54.8,14,20,4,16,15,48,27,0
Robert-Jan Vanwesemael,BEL,"DF,MF",Sint-Truiden,22-221,2002,6.9,6,4,0,3,3,4,14,28.6,10,9,3,6,9,15,13,0
Hélio Varela,CPV,"MF,DF",Gent,22-183,2002,0.7,0,0,0,0,0,0,0,,0,1,0,1,1,1,1,0
Óscar Vargas,BEL,DF,Beerschot,18-276,2006,0.1,0,0,0,0,0,0,0,,0,0,0,0,0,0,0,0
Luis Vázquez,ARG,"FW,MF",Anderlecht,23-283,2001,2.7,3,3,0,0,3,2,4,50.0,2,2,0,2,0,3,3,0
Thibaud Verlinden,BEL,"MF,FW",Beerschot,25-116,1999,8.8,10,6,2,3,5,3,14,21.4,11,5,0,5,3,13,0,0
Romeo Vermant,BEL,"FW,MF",Club Brugge,20-283,2004,2.6,4,4,1,3,0,3,5,60.0,2,1,0,1,1,5,1,0
Michael Verrips,NED,GK,Dender,27-335,1996,10.5,0,0,0,0,0,0,1,0.0,1,0,0,0,0,0,4,1
Yari Verschaeren,BEL,"MF,FW",Anderlecht,23-113,2001,9.0,18,16,9,5,4,10,19,52.6,9,5,1,4,5,23,13,1
Birger Verstraete,BEL,MF,OH Leuven,30-200,1994,9.8,30,20,17,10,3,11,19,57.9,8,5,1,4,20,50,23,0
Andreas Verstraeten,BEL,MF,Antwerp,18-297,2006,1.0,3,1,1,1,1,3,4,75.0,1,0,0,0,0,3,0,0
Jan Vertonghen,BEL,DF,Anderlecht,37-192,1987,2.0,0,0,0,0,0,0,0,,0,3,2,1,0,0,6,0
Hugo Vetlesen,NOR,MF,Club Brugge,24-247,2000,7.8,16,12,4,8,4,6,9,66.7,3,5,0,5,8,24,10,0
Malcolm Viltard,FRA,MF,Dender,22-009,2002,7.5,17,8,10,6,1,7,21,33.3,14,17,1,16,13,30,20,0
Thibault Vlietinck,BEL,DF,OH Leuven,27-075,1997,3.4,3,2,2,1,0,2,3,66.7,1,4,0,4,2,5,10,0
Luka Vušković,CRO,DF,Westerlo,17-252,2007,11.5,10,7,8,2,0,4,9,44.4,5,9,7,2,9,19,67,0
Sandy Walsh,IDN,"DF,MF",Mechelen,29-233,1995,1.4,1,1,1,0,0,1,1,100.0,0,3,2,1,2,3,6,0
Warleson,BRA,GK,Cercle Brugge,28-063,1996,9.0,1,0,1,0,0,1,3,33.3,2,0,0,0,0,1,14,2
Tsuyoshi Watanabe,JPN,DF,Gent,27-271,1997,12.0,20,10,15,4,1,10,14,71.4,4,20,16,4,9,29,58,1
Marco Weymans,BDI,"DF,MF",Beerschot,27-116,1997,5.3,15,7,5,9,1,7,11,63.6,4,6,1,5,5,20,8,0
D'Margio Wright-Phillips,ENG,"FW,MF",Beerschot,23-039,2001,1.3,2,0,0,0,2,1,4,25.0,3,0,0,0,0,2,0,0
Rihito Yamamoto,JPN,MF,Sint-Truiden,22-326,2001,6.5,11,6,5,5,1,5,11,45.5,6,10,2,8,3,14,14,0
Elton Yeboah,BEL,"MF,DF",Mechelen,19-222,2005,0.1,0,0,0,0,0,0,0,,0,0,0,0,0,0,1,0
Daisuke Yokota,JPN,MF,Gent,24-140,2000,2.6,4,1,2,2,0,2,3,66.7,1,0,0,0,0,4,2,0
Griffin Yow,USA,"FW,MF",Westerlo,22-038,2002,2.9,7,4,4,2,1,4,8,50.0,4,2,0,2,1,8,4,0
Alhassan Yusuf,NGA,"MF,DF",Antwerp,24-107,2000,0.1,0,0,0,0,0,0,1,0.0,1,0,0,0,0,0,0,0
Kahveh Zahiroleslam,USA,FW,Sint-Truiden,22-142,2002,10.4,8,6,0,7,1,1,9,11.1,8,9,1,8,2,10,13,0
Andi Zeqiri,SUI,"MF,FW",Genk,25-133,1999,0.5,0,0,0,0,0,0,0,,0,0,0,0,0,0,0,0
Andi Zeqiri,SUI,FW,Standard Liège,25-133,1999,4.9,2,1,0,1,1,0,4,0.0,4,5,1,4,2,4,7,0
Adem Zorgane,ALG,MF,Charleroi,24-301,2000,11.9,40,27,18,17,5,15,34,44.1,19,15,4,11,17,57,14,2
Viktor Đukanović,MNE,"DF,MF",Standard Liège,20-278,2004,0.5,0,0,0,0,0,0,0,,0,0,0,0,0,0,0,0
