Player,Nation,Pos,Squad,Age,Born,90s,Tackles,TacklesWon,TacklesDef3rd,TacklesMid3rd,TacklesAtt3rd,DribTkl,DribTklAtt,DribTkl%,ChallengesLost,Blocks,ShotsBlocked,PassesBlocked,Int,Tkl+Int,Clr,ErrorsLeadingToShot
Rodrigo Abascal,URU,DF,Boavista,30-293,1994,7.0,10,4,7,2,1,4,9,44.4,5,8,5,3,11,21,28,1
Bilal Abdelrahman Zeeni,EGY,MF,Estrela,21-286,2003,0.1,1,1,0,0,1,0,0,,0,0,0,0,0,1,1,0
Giorgi Aburjania,GEO,MF,AVS Futebol,29-305,1995,2.8,9,6,3,5,1,5,10,50.0,5,2,0,2,3,12,4,0
Adriano,BRA,MF,Santa Clara,24-364,1999,7.3,9,7,4,4,1,3,10,30.0,7,3,0,3,2,11,10,0
Lucas Áfrico,BRA,DF,Farense,29-271,1995,6.8,7,6,3,4,0,3,4,75.0,1,11,8,3,5,12,27,0
Salvador Agra,POR,"MF,DF",Boavista,32-357,1991,9.0,7,5,1,2,4,3,9,33.3,6,4,1,3,4,11,3,0
Brandon Aguilera,CRC,"MF,FW",Rio Ave,21-127,2003,2.3,10,6,4,3,3,4,4,100.0,0,1,0,1,1,11,0,0
Jorge Aguirre,ESP,FW,Gil Vicente FC,24-302,2000,3.6,1,0,0,1,0,1,4,25.0,3,2,0,2,0,1,2,0
Babatunde Akinsola,NGA,"MF,FW",AVS Futebol,21-237,2003,2.0,3,3,2,1,0,2,2,100.0,0,3,0,3,1,4,2,0
Kerem Aktürkoğlu,TUR,"FW,MF",Benfica,26-012,1998,3.0,3,3,1,1,1,1,3,33.3,2,2,0,2,1,4,1,0
Léo Alaba,BRA,DF,AVS Futebol,25-124,1999,3.7,6,5,3,2,1,3,9,33.3,6,5,1,4,7,13,10,0
Alan,BRA,MF,Moreirense,24-239,2000,6.6,6,2,1,3,2,2,8,25.0,6,5,1,4,2,8,1,0
Gonçalo Almeida,POR,"DF,MF",Boavista,21-180,2003,2.2,5,3,2,3,0,3,9,33.3,6,3,0,3,6,11,5,0
Pedro Álvaro,POR,DF,Estoril,24-245,2000,9.0,6,3,2,4,0,1,2,50.0,1,11,6,5,11,17,51,0
Pedro Amaral,POR,DF,Estoril,27-069,1997,8.9,11,5,6,3,2,8,16,50.0,8,6,2,4,7,18,22,0
Zeki Amdouni,SUI,"MF,FW",Benfica,23-334,2000,1.1,1,1,0,1,0,0,0,,0,1,0,1,1,2,1,0
Artur Jorge Marques Amorim,POR,DF,Farense,30-080,1994,5.7,7,5,7,0,0,5,6,83.3,1,5,3,2,7,14,35,0
Andrew,BRA,GK,Gil Vicente FC,23-124,2001,9.0,1,1,1,0,0,1,1,100.0,0,0,0,0,0,1,0,2
Jeremy Antonisse,CUW,"FW,MF",Moreirense,22-218,2002,3.2,6,2,1,5,0,4,7,57.1,3,4,0,4,1,7,8,0
Arvin Appiah,ENG,"FW,MF",Nacional,23-302,2001,4.6,6,5,2,3,1,4,6,66.7,2,2,0,2,5,11,3,0
Óscar Aranda,ESP,FW,Famalicão,22-187,2002,7.9,4,3,1,2,1,3,5,60.0,2,4,0,4,1,5,4,0
Henrique Araújo,POR,FW,Arouca,22-288,2002,3.7,1,0,0,1,0,0,1,0.0,1,2,1,1,0,1,0,0
Maximiliano Araújo,URU,"MF,FW",Sporting CP,24-261,2000,2.1,4,1,0,1,3,0,1,0.0,1,1,0,1,2,6,1,0
Tomás Araújo,POR,DF,Benfica,22-170,2002,5.9,16,10,12,3,1,9,12,75.0,3,4,0,4,5,21,9,0
Telmo Arcanjo,CPV,FW,Vitória,23-134,2001,1.7,2,1,1,1,0,1,3,33.3,2,0,0,0,1,3,0,0
Bright Arrey-Mbi,GER,DF,Braga,21-221,2003,4.6,6,3,2,2,2,3,5,60.0,2,8,5,3,4,10,11,0
Gustavo Assuncao,POR,MF,AVS Futebol,24-217,2000,4.4,12,8,8,4,0,8,16,50.0,8,3,2,1,3,15,5,0
Otavio Ataide,BRA,DF,Porto,22-195,2002,5.0,5,2,3,2,0,4,7,57.1,3,2,2,0,5,10,8,1
Fredrik Aursnes,NOR,"MF,FW",Benfica,28-328,1995,5.0,9,5,1,5,3,4,12,33.3,8,5,1,4,0,9,4,0
Miguel Baeza,ESP,"MF,FW",Nacional,24-220,2000,2.3,2,2,1,1,0,1,2,50.0,1,1,0,1,0,2,1,0
Alexander Bah,DEN,DF,Benfica,26-329,1997,5.9,23,16,7,11,5,18,26,69.2,8,10,0,10,4,27,4,0
Elves Baldé,GNB,"MF,FW",Farense,25-031,1999,2.3,5,3,2,3,0,1,4,25.0,3,0,0,0,0,5,3,0
Robson Bambu,BRA,DF,Braga,26-356,1997,2.0,5,1,2,3,0,2,2,100.0,0,5,4,1,1,6,3,1
Simon Banza,COD,FW,Braga,28-081,1996,0.2,0,0,0,0,0,0,0,,0,0,0,0,0,0,0,0
Rafael Barbosa,POR,"MF,FW",Farense,28-218,1996,3.4,1,1,0,1,0,0,2,0.0,2,4,0,4,2,3,0,0
Leandro Barreiro Martins,LUX,MF,Benfica,24-304,2000,3.7,15,6,2,9,4,5,10,50.0,5,5,0,5,3,18,0,0
Gil Bastião Dias,POR,FW,Famalicão,28-035,1996,3.5,9,6,2,6,1,5,10,50.0,5,3,0,3,0,9,5,0
Gabriel Batista,BRA,GK,Santa Clara,26-152,1998,9.0,1,0,1,0,0,0,0,,0,0,0,0,0,1,4,0
Ricardo Batista,POR,GK,Casa Pia,37-349,1986,1.0,0,0,0,0,0,0,0,,0,0,0,0,0,0,2,0
Yanis Begraoui,MAR,FW,Estoril,23-121,2001,6.1,3,1,0,3,0,0,2,0.0,2,4,1,3,2,5,5,0
Gui Beleza,POR,MF,Gil Vicente FC,17-329,2006,0.0,0,0,0,0,0,0,0,,0,0,0,0,0,0,0,0
Bachir Belloumi,ALG,FW,Farense,22-154,2002,3.0,8,5,3,4,1,4,7,57.1,3,8,2,6,3,11,2,0
Fahem Benaissa Yahia,FRA,DF,Casa Pia,22-187,2002,0.0,0,0,0,0,0,0,0,,0,0,0,0,0,0,0,0
Beni,ANG,MF,Casa Pia,22-165,2002,4.2,8,6,3,5,0,3,5,60.0,2,2,0,2,5,13,6,0
Álex Bermejo,ESP,"MF,FW",Farense,25-327,1998,3.8,2,1,0,2,0,1,7,14.3,6,1,0,1,1,3,3,0
Simão Bertelli,BRA,GK,AVS Futebol,31-153,1993,4.0,0,0,0,0,0,0,0,,0,0,0,0,0,0,0,1
Jan-Niklas Beste,GER,"FW,DF",Benfica,25-303,1999,2.1,3,3,1,0,2,1,2,50.0,1,1,0,1,2,5,1,0
José Bica,POR,"MF,FW",Vitória,21-139,2003,0.0,0,0,0,0,0,0,0,,0,0,0,0,0,0,0,0
Raúl Blanco,ESP,FW,Casa Pia,23-094,2001,2.8,3,2,0,1,2,2,5,40.0,3,2,1,1,2,5,1,0
Kévin Boma,TOG,DF,Estoril,21-348,2002,5.0,9,7,8,1,0,5,8,62.5,3,6,5,1,6,15,22,0
Kiko Bondoso,POR,"MF,FW",Rio Ave,28-351,1995,5.3,9,6,5,1,3,2,5,40.0,3,2,0,2,2,11,0,0
Toni Borevkovic,CRO,DF,Vitória,27-137,1997,9.0,12,6,9,3,0,6,7,85.7,1,9,7,2,12,24,38,0
Gonçalo Borges,POR,FW,Porto,23-218,2001,1.4,1,1,0,0,1,0,1,0.0,1,2,0,2,0,1,0,0
Róbert Boženík,SVK,FW,Boavista,24-350,1999,8.9,3,2,0,1,2,1,2,50.0,1,3,0,3,2,5,11,0
Daniel Bragança,POR,MF,Sporting CP,25-159,1999,6.1,10,5,1,6,3,6,12,50.0,6,7,0,7,3,13,5,0
Bruno Brigido,BRA,GK,Estrela,33-238,1991,9.0,0,0,0,0,0,0,0,,0,0,0,0,0,0,4,1
Rafael Brito,POR,MF,Casa Pia,22-288,2002,2.6,5,3,4,1,0,2,2,100.0,0,5,3,2,3,8,7,0
Bruma,POR,"FW,MF",Braga,30-009,1994,4.0,2,2,0,1,1,1,4,25.0,3,1,0,1,1,3,1,0
Jonathan Buatu Mananga,ANG,DF,Gil Vicente FC,31-036,1993,9.0,12,7,9,3,0,8,11,72.7,3,15,11,4,11,23,35,0
Leonel Bucca,ARG,"MF,FW",Estrela,25-227,1999,4.9,15,7,5,9,1,9,14,64.3,5,9,4,5,7,22,8,0
Adrián Butzke,ESP,FW,Nacional,25-217,1999,4.3,4,2,0,4,0,2,4,50.0,2,2,0,2,3,7,4,0
Arthur Cabral,BRA,FW,Benfica,26-191,1998,0.9,2,1,0,1,1,0,0,,0,2,0,2,0,2,1,0
Jovane Cabral,CPV,FW,Estrela,26-141,1998,2.5,6,4,3,2,1,2,5,40.0,3,3,1,2,3,9,0,0
Lucas Calegari,BRA,DF,Famalicão,22-249,2002,8.5,24,12,13,11,0,10,15,66.7,5,7,4,3,4,28,17,0
Diogo Calila,POR,"MF,DF",Santa Clara,26-023,1998,4.3,10,4,5,3,2,4,4,100.0,0,6,0,6,1,11,9,0
Ibrahima Camará,GUI,MF,Boavista,25-282,1999,7.2,10,6,2,7,1,7,13,53.8,6,7,0,7,10,20,23,0
André Candeias,POR,"FW,MF",Farense,21-287,2003,0.4,0,0,0,0,0,0,0,,0,0,0,0,0,0,0,0
Zé Carlos,POR,MF,Vitória,23-003,2001,0.2,4,2,1,3,0,3,3,100.0,0,0,0,0,1,5,1,0
Zé Carlos,POR,DF,Gil Vicente FC,26-094,1998,8.6,14,9,8,4,2,11,19,57.9,8,8,5,3,23,37,35,2
Álvaro Carreras,ESP,DF,Benfica,21-224,2003,7.1,14,8,4,9,1,8,12,66.7,4,7,1,6,10,24,12,0
João Carvalho,POR,"FW,MF",Estoril,27-238,1997,3.5,2,1,1,0,1,1,4,25.0,3,2,0,2,0,2,4,0
Pedro Carvalho,POR,DF,Estoril,21-262,2003,2.2,3,2,1,2,0,0,3,0.0,3,1,0,1,4,7,7,0
Vitor Carvalho,BRA,MF,Braga,27-159,1997,8.4,18,13,5,13,0,10,16,62.5,6,9,2,7,13,31,12,0
Cassiano,BRA,FW,Casa Pia,35-139,1989,3.0,6,3,4,1,1,2,5,40.0,3,4,0,4,0,6,3,0
Jesús Castillo,PER,MF,Gil Vicente FC,23-144,2001,5.7,11,6,3,7,1,8,16,50.0,8,8,3,5,7,18,11,0
André Castro,POR,MF,Moreirense,36-214,1988,0.2,0,0,0,0,0,0,0,,0,0,0,0,0,0,0,0
Cristian Castro,COL,DF,AVS Futebol,23-282,2001,8.9,7,5,5,0,2,5,7,71.4,2,4,1,3,9,16,55,1
Geny Catamo,MOZ,"MF,DF",Sporting CP,23-281,2001,6.4,10,5,3,4,3,8,13,61.5,5,7,0,7,3,13,8,0
Cauê,BRA,FW,Gil Vicente FC,21-352,2002,5.1,4,1,1,2,1,0,1,0.0,1,6,1,5,1,5,8,0
César,BRA,GK,Boavista,32-280,1992,3.0,0,0,0,0,0,0,0,,0,0,0,0,0,0,1,0
Tidjany Chabrol,FRA,FW,Gil Vicente FC,22-110,2002,3.3,6,4,3,3,0,4,8,50.0,4,3,0,3,0,6,4,0
Till Cissokho,FRA,DF,Estrela,24-268,2000,4.0,1,0,1,0,0,0,1,0.0,1,0,0,0,2,3,12,1
Clayton,BRA,DF,AVS Futebol,24-212,2000,2.0,0,0,0,0,0,0,3,0.0,3,5,1,4,1,1,7,0
Clayton,BRA,FW,Rio Ave,25-296,1999,8.6,4,1,0,3,1,1,5,20.0,4,3,1,2,0,4,5,0
Diego Collado,ESP,"MF,FW",Gil Vicente FC,23-298,2001,0.2,0,0,0,0,0,0,0,,0,0,0,0,1,1,0,0
Fábio Conceição,POR,"DF,MF",Rio Ave,23-188,2001,2.2,7,5,3,2,2,3,8,37.5,5,2,1,1,1,8,2,0
Leo Cordeiro,BRA,MF,Estrela,29-036,1995,7.7,9,6,3,6,0,5,13,38.5,8,12,2,10,3,12,4,1
Félix Correia,POR,"FW,MF",Gil Vicente FC,23-285,2001,8.9,10,6,5,5,0,6,12,50.0,6,5,0,5,13,23,17,0
Alberto costa,POR,DF,Vitória,21-034,2003,1.3,0,0,0,0,0,0,1,0.0,1,4,0,4,1,1,7,0
Bruno Xavier Almeida Costa,POR,"MF,FW",Nacional,27-197,1997,2.1,1,0,1,0,0,1,5,20.0,4,3,1,2,0,1,0,0
Diogo Costa,POR,GK,Porto,25-044,1999,9.0,0,0,0,0,0,0,1,0.0,1,0,0,0,0,0,1,0
Gonçalo Costa,POR,DF,Estoril,24-258,2000,0.3,0,0,0,0,0,0,1,0.0,1,1,0,1,0,0,2,0
Hélder Costa,ANG,FW,Estoril,30-295,1994,2.3,2,0,1,0,1,1,5,20.0,4,1,0,1,0,2,0,0
João Costa,POR,FW,Santa Clara,24-240,2000,1.2,2,0,1,1,0,2,3,66.7,1,1,0,1,0,2,1,0
Michel Costa,BRA,MF,Estoril,22-318,2001,6.5,8,3,2,5,1,1,9,11.1,8,12,3,9,7,15,9,0
Sandro Cruz,ANG,DF,Gil Vicente FC,23-174,2001,7.8,15,7,7,5,3,9,16,56.3,7,8,2,6,8,23,22,0
Augusto Dabo,POR,DF,Boavista,20-234,2004,1.0,1,0,0,0,1,1,1,100.0,0,2,1,1,0,1,6,0
Amadou Dante,MLI,"DF,MF",Arouca,24-026,2000,4.8,13,8,10,2,1,9,17,52.9,8,6,1,5,8,21,10,1
Mathias De Amorim,FRA,MF,Famalicão,19-328,2004,0.8,0,0,0,0,0,0,2,0.0,2,0,0,0,3,3,1,0
Zeno Debast,BEL,DF,Sporting CP,21-009,2003,5.5,8,6,5,3,0,4,6,66.7,2,6,2,4,4,12,6,0
Depú,ANG,FW,Gil Vicente FC,24-299,2000,0.5,0,0,0,0,0,0,0,,0,0,0,0,0,0,0,0
Derick,BRA,"DF,MF",Farense,31-062,1993,4.3,3,0,0,2,1,0,8,0.0,8,10,1,9,3,6,11,0
Ángel Di María,ARG,FW,Benfica,36-262,1988,4.6,6,3,2,1,3,1,4,25.0,3,3,0,3,2,8,0,0
Matheus Dias,BRA,"MF,DF",Nacional,27-269,1997,7.2,28,18,15,11,2,12,24,50.0,12,14,5,9,12,40,23,2
Tiago Dias,POR,FW,Casa Pia,26-182,1998,0.3,1,0,0,1,0,0,1,0.0,1,0,0,0,0,1,0,0
Ousmane Diomande,CIV,DF,Sporting CP,20-334,2003,6.8,10,5,4,6,0,6,9,66.7,3,2,1,1,7,17,17,1
Tiago Djaló,POR,DF,Porto,24-207,2000,1.0,1,0,1,0,0,1,1,100.0,0,0,0,0,1,2,4,0
Maxime Dominguez,SUI,MF,Gil Vicente FC,28-275,1996,2.8,8,3,4,4,0,3,4,75.0,1,3,0,3,3,11,1,0
Issiar Dramé,MLI,"DF,MF",Estrela,25-260,1999,2.2,2,2,2,0,0,1,1,100.0,0,0,0,0,6,8,12,0
Marcus Edwards,ENG,"FW,MF",Sporting CP,25-335,1998,0.5,0,0,0,0,0,0,0,,0,0,0,0,0,0,1,0
Ricardo Esgaio,POR,"FW,DF",Sporting CP,31-170,1993,0.3,0,0,0,0,0,0,0,,0,0,0,0,0,0,1,0
Tiago Esgaio,POR,"DF,MF",Arouca,29-093,1995,8.9,28,17,18,9,1,15,20,75.0,5,12,5,7,12,40,33,0
Dario Essugo,POR,MF,Sporting CP,19-233,2005,0.2,0,0,0,0,0,0,0,,0,0,0,0,0,0,0,0
Luís Esteves,POR,MF,Nacional,26-207,1998,7.9,11,8,5,6,0,7,21,33.3,14,8,1,7,6,17,3,1
Stephen Eustáquio,CAN,MF,Porto,27-317,1996,3.0,8,5,2,4,2,4,7,57.1,3,7,0,7,4,12,3,0
Evanilson,BRA,FW,Porto,25-027,1999,0.1,1,0,0,1,0,0,0,,0,0,0,0,0,1,0,0
Fabiano,BRA,DF,Moreirense,24-233,2000,6.3,9,7,7,1,1,7,9,77.8,2,7,2,5,8,17,20,1
Claudio Falcão,BRA,"MF,DF",Farense,30-122,1994,9.0,39,22,18,17,4,14,24,58.3,10,15,5,10,10,49,26,0
Jorge Filipe Oliveira Fernandes,POR,DF,Vitória,27-214,1997,1.5,0,0,0,0,0,0,1,0.0,1,0,0,0,3,3,7,0
Martim Fernandes,POR,DF,Porto,18-289,2006,5.1,13,6,6,6,1,5,11,45.5,6,10,1,9,7,20,3,0
Mateus Fernandes,POR,"FW,MF",Sporting CP,20-115,2004,0.3,1,0,0,0,1,1,1,100.0,0,0,0,0,0,1,0,0
Roger Fernandes,GNB,"FW,MF",Braga,18-347,2005,5.2,9,3,2,7,0,3,6,50.0,3,4,0,4,2,11,2,0
Rúben Fernandes,POR,DF,Gil Vicente FC,38-180,1986,8.8,6,4,2,4,0,5,6,83.3,1,7,4,3,13,19,37,0
Roberto Férnandez,ESP,FW,Braga,22-122,2002,4.4,3,1,0,1,2,2,4,50.0,2,3,0,3,0,3,1,0
João Ferreira Barros,POR,"MF,FW",Boavista,18-297,2006,1.1,5,3,3,1,1,2,5,40.0,3,1,0,1,1,6,1,0
Filipe Ferreira,POR,DF,Boavista,34-036,1990,8.5,9,7,4,3,2,5,10,50.0,5,6,3,3,10,19,27,1
Fernando Ferreira Fonseca,POR,DF,AVS Futebol,27-233,1997,5.3,8,5,6,0,2,7,13,53.8,6,8,1,7,9,17,10,0
João Ferreira,POR,DF,Braga,23-225,2001,4.3,9,4,4,5,0,5,6,83.3,1,5,5,0,6,15,15,0
Marcelo dos Santos Ferreira,BRA,DF,Moreirense,35-098,1989,9.0,17,9,14,3,0,9,12,75.0,3,15,13,2,10,27,56,0
Pedro Ferreira,POR,MF,Santa Clara,26-302,1998,8.1,33,20,10,16,7,7,13,53.8,6,15,0,15,16,49,10,0
Tiago Ferreira,POR,FW,Estrela,22-229,2002,0.4,3,2,0,1,2,0,0,,0,0,0,0,1,4,0,0
Daniel Figueira,POR,GK,Estoril,26-105,1998,1.0,0,0,0,0,0,0,0,,0,0,0,0,0,0,0,0
Tiago Fonseca Morais,POR,"FW,MF",Rio Ave,21-060,2003,4.3,5,3,0,2,3,2,5,40.0,3,5,2,3,3,8,1,0
José Fontán,ESP,DF,Arouca,24-265,2000,5.9,6,3,5,1,0,3,8,37.5,5,12,9,3,3,9,24,0
José Fonte,POR,DF,Casa Pia,40-316,1983,6.0,7,5,6,0,1,1,2,50.0,1,6,4,2,7,14,26,3
Lucas França,BRA,GK,Nacional,28-288,1996,8.0,0,0,0,0,0,0,0,,0,0,0,0,0,0,4,0
André Franco,POR,"FW,MF",Porto,26-204,1998,1.1,1,1,0,1,0,0,2,0.0,2,0,0,0,3,4,1,0
Afonso freitas,POR,DF,Nacional,24-209,2000,0.2,0,0,0,0,0,0,0,,0,0,0,0,0,0,3,0
Iván Fresneda,ESP,DF,Sporting CP,20-035,2004,0.5,1,1,0,1,0,0,0,,0,0,0,0,1,2,0,0
Godfried Frimpong,NED,DF,Moreirense,25-104,1999,9.0,13,9,8,5,0,8,10,80.0,2,9,2,7,13,26,39,0
Kanya Fujimoto,JPN,"MF,FW",Gil Vicente FC,25-124,1999,8.2,3,1,2,0,1,1,5,20.0,4,6,2,4,5,8,6,0
Taichi Fukui,JPN,MF,Arouca,20-110,2004,8.8,15,10,3,10,2,7,14,50.0,7,7,5,2,12,27,16,0
Tiago Gabriel,POR,DF,Estrela,19-312,2004,4.9,9,7,7,2,0,5,7,71.4,2,5,3,2,9,18,20,2
Galeno,BRA,"DF,FW",Porto,27-011,1997,7.6,7,3,4,0,3,4,6,66.7,2,10,3,7,8,15,11,0
Nino Galović,CRO,DF,Arouca,32-119,1992,1.0,0,0,0,0,0,0,0,,0,2,2,0,1,1,2,0
García,BRA,DF,Nacional,22-303,2002,8.0,19,18,12,6,1,13,21,61.9,8,11,6,5,14,33,18,0
Fabrício Garcia,CPV,FW,Estoril,23-182,2001,5.2,7,6,3,3,1,2,7,28.6,5,2,0,2,1,8,0,0
Santiago García,ESP,MF,Gil Vicente FC,23-065,2001,3.0,8,4,5,3,0,3,6,50.0,3,4,1,3,4,12,3,0
Bruno Gaspar,ANG,DF,Vitória,31-195,1993,7.7,14,10,7,4,3,7,12,58.3,5,10,0,10,3,17,12,0
Mory Gbane,CIV,MF,Gil Vicente FC,23-313,2000,6.1,19,12,8,11,0,15,22,68.2,7,4,3,1,9,28,18,0
Geovanny,POR,MF,Farense,20-111,2004,1.5,1,1,0,1,0,0,2,0.0,2,2,1,1,0,1,1,0
André Geraldes,POR,"MF,DF",Casa Pia,33-184,1991,6.8,8,2,7,1,0,4,5,80.0,1,8,2,6,3,11,21,0
Ismaël Gharbi,ESP,"MF,FW",Braga,20-206,2004,1.6,1,0,0,0,1,1,3,33.3,2,2,0,2,0,1,0,0
José Gomes,POR,DF,Nacional,28-105,1996,7.7,15,10,6,7,2,3,8,37.5,5,10,4,6,8,23,29,0
Pedro gomes,POR,DF,Boavista,21-151,2003,8.2,24,17,15,9,0,15,20,75.0,5,13,4,9,11,35,30,1
Vítor Gomes,POR,MF,Rio Ave,36-313,1987,0.4,1,0,0,0,1,0,1,0.0,1,0,0,0,1,2,5,0
Victor Gomez,ESP,DF,Braga,24-215,2000,5.1,5,2,2,2,1,5,10,50.0,5,5,0,5,4,9,10,0
Nuno Gonçalo Moreira,POR,"FW,MF",Casa Pia,25-139,1999,6.2,13,11,5,6,2,7,16,43.8,9,6,0,6,5,18,4,0
João Gonçalves,POR,GK,Boavista,23-363,2000,4.0,0,0,0,0,0,0,0,,0,0,0,0,0,0,2,0
Pedro Gonçalves,POR,"FW,MF",Sporting CP,26-127,1998,5.4,7,1,1,2,4,3,10,30.0,7,5,1,4,2,9,0,0
Cristo González,ESP,MF,Arouca,27-009,1997,2.0,2,1,1,0,1,1,4,25.0,3,1,1,0,0,2,1,0
Mario González,ESP,FW,Famalicão,28-251,1996,3.8,2,1,0,1,1,1,3,33.3,2,1,0,1,0,2,1,0
Nicolás González,ESP,MF,Porto,22-304,2002,8.5,19,7,3,13,3,7,13,53.8,6,3,1,2,3,22,8,0
Jean Gorby,FRA,MF,Braga,22-100,2002,2.9,7,3,1,6,0,4,6,66.7,2,4,3,1,3,10,5,0
João Goulart Silva,POR,DF,Casa Pia,24-280,2000,9.0,14,11,10,3,1,11,13,84.6,2,11,9,2,12,26,47,0
Tiago Gouveia,POR,"FW,DF",Benfica,23-137,2001,0.9,2,2,1,1,0,0,0,,0,1,0,1,0,2,0,0
Pablo Gozalbez,ESP,MF,Arouca,23-186,2001,0.7,0,0,0,0,0,0,1,0.0,1,0,0,0,1,1,0,0
João Graça,POR,"MF,FW",Rio Ave,29-137,1995,2.0,7,3,3,4,0,6,10,60.0,4,8,2,6,1,8,4,0
Samuel Granada,BRA,FW,AVS Futebol,24-266,2000,2.7,1,1,1,0,0,0,0,,0,1,0,1,0,1,5,0
Jaume Grau,ESP,MF,AVS Futebol,27-181,1997,5.7,14,7,9,4,1,8,21,38.1,13,9,2,7,8,22,6,1
Marko Grujić,SRB,MF,Porto,28-203,1996,0.4,0,0,0,0,0,0,0,,0,1,1,0,0,0,2,0
Rafik Guitane,FRA,"FW,MF",Estoril,25-160,1999,1.1,0,0,0,0,0,0,0,,0,0,0,0,0,0,0,0
Rafik Guitane,FRA,FW,Braga,25-160,1999,0.0,0,0,0,0,0,0,0,,0,1,0,1,0,0,0,0
Deniz Gül,SWE,FW,Porto,20-123,2004,0.5,0,0,0,0,0,0,1,0.0,1,1,0,1,0,0,0,0
Viktor Gyökeres,SWE,FW,Sporting CP,26-151,1998,8.8,3,2,0,0,3,1,3,33.3,2,0,0,0,0,3,4,0
Justin de Haas,NED,DF,Famalicão,24-275,2000,9.0,12,7,9,3,0,9,11,81.8,2,12,9,3,13,25,35,0
Tomás Händel,POR,MF,Vitória,23-341,2000,8.5,14,10,6,6,2,10,14,71.4,4,6,2,4,14,28,11,0
Conrad Harder,DEN,"FW,MF",Sporting CP,19-209,2005,1.6,0,0,0,0,0,0,1,0.0,1,0,0,0,1,1,2,0
Thiago Helguera,URU,MF,Braga,18-221,2006,0.1,0,0,0,0,0,0,0,,0,0,0,0,0,0,1,0
Gustavo Henrique,BRA,"MF,FW",Estrela,25-184,1999,2.5,7,4,3,4,0,5,9,55.6,4,4,0,4,2,9,5,0
Morten Hjulmand,DEN,MF,Sporting CP,25-130,1999,5.6,12,9,3,8,1,6,11,54.5,5,5,3,2,5,17,4,0
Jordan Holsgrove,SCO,MF,Estoril,25-053,1999,2.6,3,2,0,2,1,1,1,100.0,0,3,2,1,1,4,5,0
Lukáš Horníček,CZE,GK,Braga,22-112,2002,1.0,0,0,0,0,0,0,0,,0,0,0,0,0,0,1,0
André Horta,POR,MF,Braga,27-361,1996,3.6,12,9,3,8,1,4,8,50.0,4,3,0,3,0,12,2,0
Ricardo Horta,POR,"MF,FW",Braga,30-048,1994,8.7,12,5,1,7,4,2,8,25.0,6,6,1,5,3,15,4,0
Igor,BRA,MF,Estrela,21-240,2003,3.4,7,5,2,5,0,4,10,40.0,6,3,1,2,5,12,3,0
André Inácio,BRA,"MF,FW",Estrela,22-253,2002,3.8,6,2,3,2,1,2,8,25.0,6,5,0,5,2,8,2,0
Gonçalo Inácio,POR,DF,Sporting CP,23-069,2001,7.1,11,7,2,6,3,7,12,58.3,5,7,2,5,11,22,10,0
Isaac,BRA,FW,Nacional,20-221,2004,1.9,3,1,2,0,1,1,2,50.0,1,3,0,3,0,3,2,0
Ismael,POR,MF,Moreirense,25-222,1999,8.0,27,16,9,16,2,9,15,60.0,6,10,4,6,16,43,16,0
Franco Israel,URU,GK,Sporting CP,24-194,2000,5.0,0,0,0,0,0,0,0,,0,0,0,0,0,0,0,0
Ivan Jaime Pajuelo,ESP,FW,Porto,24-037,2000,4.1,1,1,1,0,0,1,2,50.0,1,2,0,2,2,3,3,0
Jason,ESP,FW,Arouca,30-119,1994,6.7,2,2,1,1,0,1,9,11.1,8,6,1,5,6,8,5,0
Jhonatan,BRA,GK,Rio Ave,33-178,1991,8.0,0,0,0,0,0,0,1,0.0,1,0,0,0,0,0,2,3
Luiz Lúcio Reis Júnior,BRA,GK,Famalicão,23-293,2001,1.0,0,0,0,0,0,0,0,,0,0,0,0,0,0,1,0
Issa Kaboré,BFA,DF,Benfica,23-174,2001,0.1,0,0,0,0,0,0,0,,0,1,0,1,0,0,0,0
Kaio,BRA,FW,Vitória,20-261,2004,6.4,9,5,3,3,3,4,11,36.4,7,6,0,6,4,13,1,0
Issiaka Kamate,FRA,"FW,MF",AVS Futebol,20-092,2004,3.4,5,3,3,2,0,4,5,80.0,1,1,0,1,4,9,3,0
Kazu,BRA,DF,Gil Vicente FC,24-229,2000,1.0,1,0,0,1,0,1,1,100.0,0,2,0,2,2,3,4,0
Keliano,ANG,MF,Estrela,21-291,2003,2.8,12,7,4,6,2,9,11,81.8,2,0,0,0,5,17,6,0
Kewin,BRA,GK,Moreirense,29-008,1995,9.0,0,0,0,0,0,0,1,0.0,1,0,0,0,0,0,9,1
Kikas,POR,FW,Estrela,26-046,1998,8.4,2,1,0,1,1,1,3,33.3,2,2,0,2,0,2,6,0
Gustavo Klismahn,BRA,MF,Santa Clara,24-345,1999,1.9,5,3,1,3,1,1,3,33.3,2,1,0,1,1,6,5,0
Ruben Kluivert,NED,DF,Casa Pia,23-165,2001,3.1,5,3,4,0,1,1,1,100.0,0,4,3,1,1,6,19,0
Koka,EGY,"FW,MF",Rio Ave,31-242,1993,1.2,0,0,0,0,0,0,0,,0,1,0,1,0,0,0,0
Orkun Kökçü,TUR,"MF,FW",Benfica,23-309,2000,6.4,1,1,1,0,0,0,7,0.0,7,1,0,1,3,4,2,1
Vladen Kovačević,BIH,GK,Sporting CP,26-205,1998,4.0,0,0,0,0,0,0,0,,0,0,0,0,0,0,3,0
Andrian Kraev,BUL,MF,Casa Pia,25-262,1999,5.1,13,8,3,8,2,5,12,41.7,7,5,3,2,8,21,8,0
Chiheb Labidi,TUN,MF,Nacional,23-154,2001,0.1,0,0,0,0,0,0,0,,0,0,0,0,1,1,0,1
André Lacximicant,POR,FW,Estoril,23-167,2001,1.6,2,2,1,0,1,0,2,0.0,2,0,0,0,1,3,5,0
Chico Lamba,POR,DF,Arouca,21-237,2003,4.3,5,2,5,0,0,4,6,66.7,2,8,7,1,1,6,13,0
Larra,ESP,"MF,FW",Casa Pia,26-321,1997,3.8,5,4,1,3,1,2,3,66.7,1,6,1,5,3,8,6,0
Leonardo Lelo,POR,"MF,DF",Casa Pia,24-217,2000,8.9,17,10,7,6,4,5,12,41.7,7,5,2,3,2,19,22,1
Marcos Leonardo,BRA,MF,Benfica,21-184,2003,0.9,0,0,0,0,0,0,0,,0,0,0,0,0,0,0,0
Guilherme Liberato,BRA,MF,Moreirense,23-139,2001,0.5,1,0,0,1,0,1,1,100.0,0,0,0,0,0,1,0,0
Otso Liimatta,FIN,"MF,FW",Famalicão,20-115,2004,0.3,1,1,1,0,0,1,1,100.0,0,0,0,0,1,2,0,0
Rúben Lima,POR,DF,Estrela,35-030,1989,1.3,4,3,4,0,0,1,4,25.0,3,3,2,1,1,5,6,0
Jérémy Livolant,FRA,"MF,FW",Casa Pia,26-298,1998,0.1,0,0,0,0,0,0,0,,0,0,0,0,0,0,1,0
Danny Loader,ENG,"FW,MF",Porto,24-066,2000,5.3,3,2,1,2,0,1,5,20.0,4,4,0,4,3,6,2,0
Samuel Lobato,POR,FW,Famalicão,23-014,2001,0.5,3,2,2,1,0,2,4,50.0,2,0,0,0,0,3,1,0
Tom van de Looi,NED,MF,Famalicão,25-123,1999,2.5,9,7,3,4,2,5,7,71.4,2,0,0,0,3,12,3,0
Miguel Lopes,POR,DF,Estrela,37-319,1986,4.0,5,4,4,1,0,4,11,36.4,7,2,2,0,6,11,41,1
Vasco Lopes,CPV,"MF,FW",AVS Futebol,25-061,1999,1.8,3,2,0,1,2,2,3,66.7,1,0,0,0,1,4,1,0
Mamadou Loum,SEN,"DF,MF",Arouca,27-308,1996,1.4,2,1,1,1,0,2,3,66.7,1,2,1,1,1,3,6,0
Jonatan Lucca,BRA,MF,AVS Futebol,30-153,1994,2.8,3,2,1,2,0,1,2,50.0,1,6,2,4,2,5,7,0
Florentino Luís,POR,MF,Benfica,25-075,1999,5.9,20,12,4,12,4,9,17,52.9,8,12,1,11,11,31,4,1
Zé Luís,CPV,FW,AVS Futebol,33-283,1991,1.2,0,0,0,0,0,0,1,0.0,1,1,0,1,0,0,3,0
Luismi,EQG,FW,Moreirense,23-116,2001,7.4,6,5,2,3,1,3,4,75.0,1,8,2,6,1,7,14,0
Rúben Macedo,POR,FW,Nacional,28-238,1996,4.0,2,2,2,0,0,0,4,0.0,4,7,0,7,2,4,1,0
Tiago Machado,POR,"MF,DF",Boavista,20-214,2004,0.5,0,0,0,0,0,0,0,,0,1,0,1,0,0,0,0
Madson,BRA,FW,Moreirense,25-068,1999,6.8,10,7,3,6,1,4,9,44.4,5,7,0,7,10,20,6,0
Eliaquim Mangala,FRA,DF,Estoril,33-263,1991,4.3,7,6,5,2,0,5,8,62.5,3,6,5,1,7,14,17,0
Ricardo Mangas,POR,FW,Vitória,26-228,1998,3.8,3,3,2,0,1,3,4,75.0,1,2,0,2,0,3,8,0
Nico Mantl,GER,GK,Arouca,24-270,2000,9.0,0,0,0,0,0,0,0,,0,0,0,0,0,0,6,2
Manuel Manu,POR,MF,Vitória,23-143,2001,2.0,3,2,2,1,0,3,5,60.0,2,1,0,1,2,5,2,0
Maracás,BRA,DF,Moreirense,30-189,1994,7.2,5,2,4,1,0,2,3,66.7,1,7,6,1,3,8,42,0
Adrián Marín,ESP,DF,Braga,27-298,1997,6.9,12,3,7,5,0,5,13,38.5,8,7,1,6,13,25,23,0
João Mário,POR,"FW,MF",Benfica,31-288,1993,1.7,3,2,3,0,0,3,3,100.0,0,3,0,3,0,3,0,0
João Mário Lopes,POR,DF,Porto,24-304,2000,3.9,12,8,5,4,3,8,10,80.0,2,1,0,1,2,14,3,0
Uladzislaŭ Marozaŭ,BLR,"FW,MF",Arouca,24-021,2000,1.1,2,2,0,2,0,0,1,0.0,1,0,0,0,0,2,1,0
Alejandro Marqués,VEN,FW,Estoril,24-090,2000,7.4,2,1,1,1,0,0,2,0.0,2,8,1,7,3,5,5,0
João Marques,POR,"MF,FW",Braga,22-263,2002,0.4,2,1,1,1,0,1,1,100.0,0,4,0,4,0,2,0,0
Gabri Martínez,ESP,"FW,DF",Braga,21-285,2003,4.7,16,9,10,3,3,14,21,66.7,7,6,0,6,2,18,5,0
Toni Martínez,ESP,FW,Porto,27-125,1997,0.0,2,0,0,2,0,1,1,100.0,0,0,0,0,0,2,0,0
Bernardo Sousa Pereira Brites Martins,POR,"MF,FW",Moreirense,26-334,1997,1.9,4,3,2,2,0,1,9,11.1,8,2,0,2,3,7,0,0
Matheus,BRA,GK,Braga,32-106,1992,8.0,1,1,1,0,0,1,2,50.0,1,0,0,0,0,1,0,0
Marco Matias,POR,FW,Farense,35-176,1989,1.7,1,0,1,0,0,0,0,,0,0,0,0,0,1,0,0
Jordi Mboula,ESP,"FW,MF",Gil Vicente FC,25-231,1999,5.2,3,0,0,3,0,1,7,14.3,6,2,0,2,2,5,4,0
Tobías Medina,ARG,MF,Rio Ave,20-244,2004,0.3,0,0,0,0,0,0,0,,0,0,0,0,0,0,0,0
Yair Mena Palacios,COL,FW,AVS Futebol,24-127,2000,0.4,1,1,0,1,0,0,0,,0,0,0,0,1,2,1,0
João Mendes,POR,FW,Vitória,30-012,1994,6.3,7,6,2,2,3,6,11,54.5,5,6,0,6,0,7,4,0
João Mendes,POR,DF,Vitória,24-203,2000,6.9,20,9,10,8,2,10,14,71.4,4,9,1,8,2,22,24,1
Joe Mendes,SWE,DF,Braga,21-307,2002,2.0,2,1,0,2,0,2,2,100.0,0,2,0,2,1,3,4,0
Gustavo Mendonça,POR,MF,AVS Futebol,21-236,2003,0.2,0,0,0,0,0,0,0,,0,0,0,0,0,0,0,0
Miguel Menino,POR,MF,Farense,21-297,2003,3.3,9,5,3,5,1,1,4,25.0,3,5,1,4,3,12,6,0
John Mercado,ECU,"FW,MF",AVS Futebol,22-152,2002,7.4,9,6,3,5,1,2,7,28.6,5,8,3,5,3,12,10,2
Mehdi Merghem,FRA,MF,Farense,27-106,1997,2.6,5,4,3,1,1,1,5,20.0,4,3,0,3,1,6,1,0
Bruno Messi,POR,"MF,FW",Santa Clara,28-054,1996,0.1,0,0,0,0,0,0,0,,0,0,0,0,0,0,0,0
Enea Mihaj,ALB,DF,Famalicão,26-120,1998,8.5,17,10,12,5,0,10,14,71.4,4,14,8,6,17,34,40,1
Álex Millán,ESP,"FW,MF",Farense,24-361,1999,4.0,3,0,0,2,1,0,2,0.0,2,6,0,6,1,4,5,0
Cezary Miszta,POL,GK,Rio Ave,23-003,2001,1.0,0,0,0,0,0,0,0,,0,0,0,0,0,0,0,0
Rodrigo Mora,POR,MF,Porto,17-181,2007,0.4,1,1,0,1,0,0,0,,0,0,0,0,0,1,0,0
Morato,BRA,DF,Benfica,23-125,2001,1.0,3,2,1,2,0,1,3,33.3,2,1,0,1,3,6,1,0
Paulo Moreira,POR,MF,Estrela,24-259,2000,1.2,7,3,2,4,1,2,2,100.0,0,1,1,0,2,9,2,0
Marco Moreno,ESP,DF,Farense,23-256,2001,4.6,5,4,4,1,0,2,5,40.0,3,7,7,0,4,9,21,0
Hidemasa Morita,JPN,MF,Sporting CP,29-176,1995,6.6,14,9,5,8,1,6,11,54.5,5,6,1,5,4,18,10,1
Moura,POR,DF,Famalicão,25-078,1999,4.0,10,7,6,3,1,6,7,85.7,1,4,0,4,1,11,6,0
Moura,POR,DF,Porto,25-078,1999,4.8,4,2,1,3,0,1,4,25.0,3,3,1,2,5,9,13,0
João Moutinho,POR,MF,Braga,38-055,1986,1.3,2,1,0,2,0,1,2,50.0,1,2,0,2,1,3,0,0
MT,BRA,"MF,DF",Santa Clara,23-246,2001,9.0,21,11,15,5,1,10,17,58.8,7,8,0,8,10,31,32,0
Jonathan Mutombo,FRA,DF,Gil Vicente FC,22-067,2002,0.6,2,2,2,0,0,1,1,100.0,0,0,0,0,1,3,4,0
Nani,POR,"FW,MF",Estrela,37-351,1986,4.7,4,1,1,3,0,1,6,16.7,5,2,1,1,3,7,2,0
Fran Navarro,ESP,FW,Porto,26-273,1998,1.0,2,0,0,0,2,2,2,100.0,0,1,0,1,0,2,0,0
Christian Neiva Afonso,POR,DF,AVS Futebol,29-328,1994,8.2,19,16,10,7,2,11,15,73.3,4,15,4,11,4,23,22,1
Nenê,BRA,FW,AVS Futebol,41-097,1983,2.6,3,1,1,2,0,0,1,0.0,1,3,0,3,0,3,0,0
Neto,BRA,MF,Farense,33-061,1991,5.5,19,10,9,10,0,6,18,33.3,12,5,3,2,11,30,5,1
Martim Neto,POR,MF,Rio Ave,21-293,2003,2.5,5,2,0,4,1,1,2,50.0,1,1,0,1,2,7,1,0
Sikou Niakaté,MLI,DF,Braga,25-115,1999,6.0,4,1,2,2,0,2,4,50.0,2,0,0,0,11,15,24,0
Miguel Nóbrega,POR,DF,Rio Ave,24-199,2000,1.0,3,2,3,0,0,3,5,60.0,2,3,3,0,0,3,2,0
João Novais,POR,MF,Rio Ave,31-115,1993,5.6,7,4,4,2,1,5,11,45.5,6,6,1,5,4,11,5,0
Samuel Obeng,GHA,FW,Casa Pia,27-171,1997,3.3,0,0,0,0,0,0,1,0.0,1,2,0,2,0,0,3,0
Guillermo Ochoa,MEX,GK,AVS Futebol,39-112,1985,5.0,1,1,1,0,0,1,1,100.0,0,0,0,0,0,1,4,0
Lawrence Ofori,GHA,MF,Moreirense,26-127,1998,4.8,10,5,5,4,1,4,10,40.0,6,4,0,4,2,12,8,0
Nélson Oliveira,POR,FW,Vitória,33-086,1991,6.3,2,1,0,0,2,0,1,0.0,1,1,0,1,1,3,2,0
Paulo Oliveira,POR,DF,Braga,32-299,1992,2.9,3,2,1,2,0,1,2,50.0,1,5,4,1,2,5,11,1
Talys Oliveira,BRA,DF,Farense,25-266,1999,2.8,6,2,2,3,1,3,6,50.0,3,3,0,3,3,9,6,0
Samu Omorodion,ESP,FW,Porto,20-181,2004,4.3,0,0,0,0,0,0,0,,0,0,0,0,1,1,0,0
Bruno Onyemaechi,NGA,DF,Boavista,25-213,1999,8.4,13,5,11,2,0,8,15,53.3,7,10,5,5,4,17,31,2
Jandro Orellana,ESP,MF,Estoril,24-087,2000,5.6,9,6,4,4,1,5,7,71.4,2,2,1,1,6,15,5,0
Nicolás Otamendi,ARG,DF,Benfica,36-264,1988,6.1,10,8,5,2,3,5,7,71.4,2,5,3,2,15,25,6,1
Amine El Ouazzani,MAR,FW,Braga,23-110,2001,4.1,5,3,2,1,2,3,4,75.0,1,5,0,5,2,7,2,0
Amine Oudrhiri,MAR,MF,Rio Ave,31-364,1992,6.4,8,7,6,1,1,4,10,40.0,6,10,4,6,14,22,7,0
Renato Pantalon,CRO,DF,Rio Ave,27-006,1997,7.7,12,5,8,4,0,8,10,80.0,2,8,5,3,12,24,34,2
Jonathan Panzo,ENG,DF,Rio Ave,24-008,2000,5.3,9,6,6,3,0,5,10,50.0,5,8,1,7,7,16,30,1
David Pastor,BRA,"DF,MF",Farense,24-256,2000,6.1,13,10,9,4,0,7,13,53.8,6,5,1,4,12,25,16,0
Patrick,BRA,DF,Rio Ave,27-152,1997,4.1,4,4,4,0,0,4,7,57.1,3,5,3,2,7,11,15,0
Vangelis Pavlidis,GRE,FW,Benfica,25-347,1998,7.1,5,4,0,2,3,1,5,20.0,4,6,0,6,3,8,2,0
Zé Pedro Figueiredo,POR,DF,Porto,27-149,1997,7.3,10,7,8,2,0,5,8,62.5,3,6,5,1,11,21,30,0
Daniel Penha,BRA,"MF,FW",Nacional,26-016,1998,3.7,8,5,2,5,1,5,10,50.0,5,3,1,2,2,10,3,0
Pepê,BRA,"FW,MF",Porto,27-252,1997,7.1,6,4,1,3,2,1,4,25.0,3,8,0,8,6,12,0,0
Pereira,POR,"FW,MF",Casa Pia,22-261,2002,1.3,0,0,0,0,0,0,0,,0,0,0,0,0,0,0,0
Francisco Pereira,POR,MF,Estoril,22-270,2002,0.1,0,0,0,0,0,0,0,,0,0,0,0,0,0,1,0
Matheus Pereira,BRA,FW,Santa Clara,23-317,2000,2.1,4,3,0,3,1,2,2,100.0,0,2,1,1,2,6,3,0
Sebastián Pérez Cardona,COL,MF,Boavista,31-218,1993,6.5,14,9,8,5,1,6,11,54.5,5,8,4,4,10,24,8,0
Nehuén Pérez,ARG,DF,Porto,24-131,2000,4.7,5,2,2,3,0,2,2,100.0,0,3,3,0,6,11,14,0
Petterson,BRA,"MF,FW",Estrela,20-303,2004,0.8,1,0,0,1,0,1,2,50.0,1,0,0,0,1,2,0,0
Lucas Piazon,BRA,"MF,FW",AVS Futebol,30-287,1994,7.4,16,10,3,12,1,8,13,61.5,5,10,0,10,4,20,3,0
Wagner Pina,CPV,DF,Estoril,21-365,2002,6.6,25,17,13,10,2,10,21,47.6,11,16,5,11,12,37,17,0
Rodrigo Pinheiro,POR,DF,Famalicão,22-066,2002,3.0,4,3,4,0,0,3,5,60.0,2,2,1,1,5,9,10,0
Rodrigo Pinho,BRA,FW,Estrela,33-156,1991,4.6,7,4,3,2,2,2,3,66.7,1,1,0,1,3,10,4,0
Alexandre Pinto,POR,"DF,FW",Arouca,26-117,1998,0.1,0,0,0,0,0,0,0,,0,0,0,0,0,0,1,0
Dinis Pinto,POR,DF,Moreirense,24-070,2000,2.7,6,4,4,2,0,4,7,57.1,3,1,0,1,2,8,6,0
Jaime Pinto,POR,MF,Farense,27-035,1997,0.4,0,0,0,0,0,0,2,0.0,2,1,1,0,0,0,0,0
João Pinto,POR,MF,Gil Vicente FC,22-063,2002,0.0,0,0,0,0,0,0,0,,0,0,0,0,0,0,0,0
Ole Pohlmann,GER,"FW,MF",Rio Ave,23-211,2001,4.2,9,2,1,3,5,5,7,71.4,2,5,1,4,0,9,3,0
Carlos Ponck,CPV,DF,Moreirense,29-294,1995,2.2,2,1,1,0,1,1,2,50.0,1,2,2,0,4,6,18,0
Boris Popović,SRB,DF,Arouca,24-250,2000,4.1,3,1,3,0,0,1,1,100.0,0,7,4,3,3,6,11,1
Darío Poveda,ESP,"FW,MF",Farense,27-234,1997,3.3,1,1,0,1,0,0,3,0.0,3,0,0,0,0,1,3,0
Gianluca Prestianni,ARG,"MF,FW",Benfica,18-276,2006,3.0,3,2,1,0,2,2,7,28.6,5,5,0,5,0,3,2,0
Miguel Puche García,ESP,FW,Arouca,23-186,2001,0.2,0,0,0,0,0,0,0,,0,0,0,0,0,0,0,0
Quaresma,BRA,DF,Arouca,28-072,1996,0.7,1,0,0,1,0,0,0,,0,0,0,0,2,3,1,0
Eduardo Quaresma,POR,DF,Sporting CP,22-245,2002,4.3,10,5,4,4,2,5,5,100.0,0,0,0,0,1,11,9,0
Geovany Quenda,POR,"MF,DF",Sporting CP,17-186,2007,6.4,7,4,3,3,1,6,7,85.7,1,4,0,4,2,9,7,0
Jesús Ramírez,VEN,FW,Vitória,26-182,1998,2.7,3,3,1,0,2,0,2,0.0,2,0,0,0,0,3,2,0
Guilherme Ramos,POR,DF,Santa Clara,27-083,1997,0.3,1,0,0,0,1,1,1,100.0,0,1,1,0,0,1,1,0
João Rêgo,POR,FW,Benfica,19-135,2005,0.1,0,0,0,0,0,0,1,0.0,1,0,0,0,0,0,0,0
Francisco Reis Ferreira,POR,DF,Estrela,27-221,1997,3.0,6,4,5,1,0,4,5,80.0,1,4,2,2,5,11,14,0
Matheus Reis,BRA,"DF,MF",Sporting CP,29-258,1995,2.8,2,2,2,0,0,2,2,100.0,0,1,0,1,3,5,5,0
Tiago Reis,BRA,FW,Nacional,25-080,1999,2.3,1,0,1,0,0,0,0,,0,2,0,2,0,1,0,0
Miguel Reisinho,POR,MF,Boavista,25-207,1999,5.8,16,7,4,11,1,11,14,78.6,3,5,0,5,11,27,8,0
Marco Ribeiro,POR,MF,Boavista,19-141,2005,0.4,1,1,1,0,0,1,2,50.0,1,0,0,0,0,1,0,0
Rodrigo Ribeiro,POR,FW,Sporting CP,19-188,2005,0.0,0,0,0,0,0,0,0,,0,0,0,0,0,0,0,0
Rodrigo Ribeiro,POR,FW,AVS Futebol,19-188,2005,3.0,1,1,0,1,0,0,0,,0,1,1,0,1,2,5,0
Tomás Ribeiro,POR,DF,Vitória,25-186,1999,2.5,6,4,4,2,0,4,5,80.0,1,4,3,1,6,12,9,0
Yuri Ribeiro,POR,DF,Braga,27-283,1997,2.1,0,0,0,0,0,0,0,,0,3,1,2,1,1,6,0
Ricardinho,POR,"FW,MF",Santa Clara,26-088,1998,3.0,7,6,2,2,3,3,8,37.5,5,2,0,2,5,12,2,0
Riccieli,BRA,DF,Famalicão,26-046,1998,0.5,1,1,1,0,0,1,1,100.0,0,1,1,0,1,2,1,0
Omar Richards,ENG,"DF,MF",Rio Ave,26-261,1998,4.5,11,8,6,5,0,5,5,100.0,0,6,1,5,1,12,13,0
Rivaldo,,DF,Farense,24-045,2000,4.0,11,7,4,7,0,5,8,62.5,3,6,3,3,7,18,15,0
Pablo Roberto,BRA,"FW,MF",Casa Pia,24-354,1999,2.6,4,2,3,1,0,3,7,42.9,4,3,0,3,0,4,0,0
Joel Robles,ESP,GK,Estoril,34-138,1990,8.0,0,0,0,0,0,0,0,,0,0,0,0,0,0,6,0
Matí­as Rocha,URU,DF,Arouca,23-263,2001,2.9,4,3,3,1,0,3,3,100.0,0,2,1,1,0,4,12,0
Rochinha,POR,FW,Famalicão,29-183,1995,5.4,5,4,3,1,1,5,7,71.4,2,1,1,0,2,7,3,0
Afonso Rodrigues,POR,FW,Famalicão,22-075,2002,0.0,0,0,0,0,0,0,0,,0,1,0,1,0,0,0,0
Ivo Rodrigues,POR,"MF,FW",Arouca,29-217,1995,4.6,14,9,7,6,1,7,12,58.3,5,6,1,5,3,17,7,0
Luís Carlos Rocha Rodrigues,POR,DF,Santa Clara,38-081,1986,7.0,5,3,5,0,0,2,5,40.0,3,4,4,0,4,9,28,0
Rafael Rodrigues,POR,DF,AVS Futebol,22-249,2002,1.3,1,1,1,0,0,1,1,100.0,0,1,0,1,2,3,4,0
Ignacio Rodríguez,URU,DF,AVS Futebol,20-358,2003,0.1,0,0,0,0,0,0,0,,0,0,0,0,1,1,2,0
Benjamín Rollheiser,ARG,"MF,FW",Benfica,24-223,2000,1.2,4,4,0,3,1,2,4,50.0,2,1,0,1,0,4,0,0
Baptiste Roux,FRA,"DF,MF",AVS Futebol,24-342,1999,7.9,16,9,9,7,0,14,20,70.0,6,11,6,5,10,26,37,0
Alan Ruiz,ARG,"MF,FW",Estrela,31-075,1993,4.1,7,5,1,6,0,1,8,12.5,7,4,0,4,0,7,7,1
Gustavo sá,POR,MF,Famalicão,19-357,2004,6.1,11,8,5,4,2,1,7,14.3,6,9,2,7,3,14,3,1
Josué Sá,POR,DF,Gil Vicente FC,32-138,1992,0.4,0,0,0,0,0,0,0,,0,0,0,0,0,0,2,0
Safira,BRA,FW,Santa Clara,29-230,1995,6.2,5,3,1,1,3,2,6,33.3,4,2,0,2,2,7,6,0
Sala,ESP,FW,Estoril,21-176,2003,0.9,1,1,0,1,0,0,4,0.0,4,1,0,1,1,2,4,0
Samu,POR,MF,Vitória,28-195,1996,5.1,12,8,4,6,2,6,8,75.0,2,10,2,8,0,12,3,0
Renato Sanches,POR,MF,Benfica,27-076,1997,0.9,1,1,0,1,0,1,1,100.0,0,0,0,0,0,1,0,0
Caio Santana,BRA,"FW,MF",Estrela,20-225,2004,1.0,9,5,6,3,0,7,8,87.5,1,0,0,0,2,11,3,0
Aderlan Santos,BRA,DF,Rio Ave,35-207,1989,8.7,22,12,16,6,0,14,15,93.3,1,9,4,5,17,39,64,0
Bruno Santos,POR,FW,Farense,21-200,2003,0.2,0,0,0,0,0,0,0,,0,0,0,0,0,0,0,0
Gabriel Santos,BRA,"FW,MF",Nacional,25-231,1999,1.0,2,1,1,0,1,0,1,0.0,1,1,0,1,0,2,0,0
Léo Santos,BRA,DF,Nacional,25-329,1998,2.2,1,0,1,0,0,1,2,50.0,1,3,2,1,0,1,12,1
Nuno Santos,POR,"MF,DF",Sporting CP,29-263,1995,3.9,4,0,1,1,2,2,4,50.0,2,5,0,5,4,8,4,0
Nuno Santos,POR,"MF,FW",Vitória,25-245,1999,5.1,10,8,4,2,4,7,12,58.3,5,4,0,4,3,13,5,0
Pedro Santos,POR,"MF,FW",Arouca,24-021,2000,2.3,7,7,3,3,1,3,10,30.0,7,2,1,1,1,8,3,0
Pedro Santos,POR,"MF,FW",Moreirense,21-266,2003,2.0,3,2,1,2,0,1,5,20.0,4,1,0,1,2,5,2,0
Guilherme Schettine,BRA,FW,Moreirense,29-023,1995,2.5,2,2,0,2,0,0,1,0.0,1,4,0,4,0,2,1,0
Andreas Schjelderup,NOR,FW,Benfica,20-154,2004,0.4,1,1,0,0,1,1,2,50.0,1,0,0,0,0,1,0,0
Telasco Segovia,VEN,MF,Casa Pia,21-214,2003,3.3,7,5,2,4,1,3,10,30.0,7,1,1,0,2,9,3,0
Patrick Sequeira,CRC,GK,Casa Pia,25-246,1999,8.0,0,0,0,0,0,0,0,,0,0,0,0,0,0,10,0
Serginho,POR,"MF,FW",Santa Clara,24-337,1999,0.6,0,0,0,0,0,0,0,,0,1,0,1,1,1,1,0
Sidney,BRA,DF,Santa Clara,27-290,1997,9.0,19,13,12,4,3,11,13,84.6,2,13,7,6,17,36,35,0
Alysson Silva,BRA,DF,Santa Clara,22-037,2002,1.8,2,2,2,0,0,1,1,100.0,0,0,0,0,0,2,2,0
António Silva,POR,DF,Benfica,21-003,2003,5.0,11,5,5,4,2,6,8,75.0,2,6,4,2,5,16,13,0
Gustavo da Silva,BRA,"FW,MF",Vitória,25-154,1999,1.8,4,2,3,0,1,3,3,100.0,0,7,2,5,1,5,7,0
Joel silva,POR,"MF,FW",Boavista,21-265,2003,8.6,24,18,10,9,5,12,37,32.4,25,10,2,8,11,35,15,0
Luís Manuel Costa Silva,POR,MF,AVS Futebol,32-034,1992,1.0,1,1,1,0,0,0,0,,0,1,1,0,0,1,0,0
Raul Silva,BRA,DF,Farense,34-364,1989,3.8,5,3,2,2,1,3,5,60.0,2,4,2,2,3,8,16,0
Tiago Silva,POR,MF,Vitória,31-153,1993,7.2,12,5,4,6,2,6,8,75.0,2,5,2,3,3,15,9,0
Tomás Silva,POR,"DF,MF",Boavista,18-161,2006,0.4,0,0,0,0,0,0,0,,0,0,0,0,0,0,1,0
David Simão,POR,MF,Arouca,34-171,1990,7.8,15,10,4,7,4,6,13,46.2,7,10,2,8,7,22,3,1
Sphephelo Sithole,RSA,"FW,MF",Gil Vicente FC,25-244,1999,0.6,2,2,2,0,0,2,3,66.7,1,1,1,0,0,2,1,0
Filipe Soares,POR,MF,Farense,25-166,1999,2.3,1,1,0,1,0,0,1,0.0,1,0,0,0,2,3,1,0
Lucas Soares,BRA,MF,Santa Clara,26-182,1998,4.7,8,6,4,4,0,3,7,42.9,4,4,1,3,6,14,6,0
Rafa Soares,POR,DF,Famalicão,29-177,1995,2.5,7,3,5,2,0,5,5,100.0,0,2,0,2,2,9,10,0
Djibril Soumaré,SEN,MF,Nacional,21-300,2003,1.0,8,6,6,2,0,4,4,100.0,0,3,3,0,2,10,4,0
André Sousa,POR,"MF,DF",Nacional,34-116,1990,0.6,0,0,0,0,0,0,1,0.0,1,4,2,2,0,0,1,0
Dyego Sousa,POR,FW,Nacional,35-049,1989,0.3,0,0,0,0,0,0,0,,0,0,0,0,0,0,0,0
Miguel Sousa,POR,MF,Casa Pia,26-044,1998,4.3,6,2,0,4,2,2,4,50.0,2,8,1,7,1,7,5,0
Vasco Sousa,POR,MF,Porto,21-213,2003,3.4,12,8,6,6,0,7,10,70.0,3,2,0,2,2,14,1,1
Gabriel Airton de Souza,BRA,FW,Moreirense,28-218,1996,5.2,7,5,2,5,0,2,7,28.6,5,4,0,4,3,10,1,0
Jerry St. Juste,NED,DF,Sporting CP,28-014,1996,0.2,2,2,2,0,0,2,2,100.0,0,1,0,1,0,2,0,0
Max Svensson,ESP,"FW,MF",Casa Pia,,,4.5,5,4,2,2,1,4,10,40.0,6,3,0,3,1,6,0,0
Morlaye Sylla,GUI,FW,Arouca,26-098,1998,7.4,8,6,3,4,1,1,11,9.1,10,9,0,9,0,8,3,0
Sidnei Tavares,POR,MF,Moreirense,23-034,2001,4.3,10,5,6,4,0,2,8,25.0,6,2,1,1,4,14,6,0
Duplexe Tchamba,CMR,DF,Casa Pia,26-115,1998,3.8,9,5,5,3,1,3,5,60.0,2,5,4,1,8,17,9,0
João Teixeira,POR,MF,Gil Vicente FC,30-270,1994,0.5,3,3,0,2,1,0,1,0.0,1,1,0,1,1,4,0,0
Jorge Teixeira,POR,"DF,FW",AVS Futebol,38-067,1986,1.6,1,0,1,0,0,1,1,100.0,0,2,0,2,1,2,9,0
Nigel Thomas,NED,"FW,MF",Nacional,23-275,2001,4.6,5,2,2,2,1,3,10,30.0,7,5,0,5,1,6,5,0
Demir Tıknaz,TUR,MF,Rio Ave,20-077,2004,1.9,11,6,6,4,1,5,10,50.0,5,3,3,0,5,16,3,1
Tomané,POR,FW,Farense,32-010,1992,4.0,3,1,1,2,0,1,2,50.0,1,3,0,3,0,3,7,0
Tomé,POR,GK,Boavista,17-322,2006,2.0,0,0,0,0,0,0,0,,0,0,0,0,0,0,2,0
João Tomé,POR,"MF,DF",Rio Ave,21-264,2003,2.9,8,3,6,2,0,3,5,60.0,2,1,1,0,3,11,14,0
Mirko Topić,SRB,MF,Famalicão,23-271,2001,8.8,23,15,10,12,1,8,18,44.4,10,12,2,10,15,38,22,0
Diogo Travassos,POR,DF,Estrela,20-216,2004,3.3,3,2,1,2,0,0,2,0.0,2,5,1,4,3,6,2,0
Alfonso Trezza,URU,"FW,MF",Arouca,25-133,1999,4.9,8,6,4,3,1,2,7,28.6,5,9,1,8,1,9,8,0
Francisco Trincão,POR,"FW,MF",Sporting CP,24-309,1999,8.5,12,10,1,7,4,3,7,42.9,4,6,0,6,0,12,4,0
Anatolii Trubin,UKR,GK,Benfica,23-093,2001,8.0,0,0,0,0,0,0,0,,0,0,0,0,0,0,1,1
Ulisses,BRA,DF,Nacional,25-035,1999,5.7,8,3,6,2,0,4,5,80.0,1,6,3,3,3,11,30,1
Alan Varela,ARG,MF,Porto,23-121,2001,8.6,14,6,5,8,1,9,14,64.3,5,3,1,2,6,20,11,0
Bruno Varela,CPV,GK,Vitória,29-364,1994,9.0,0,0,0,0,0,0,0,,0,0,0,0,0,0,2,1
Nilton Varela,POR,"DF,MF",Estrela,23-161,2001,7.8,22,13,12,8,2,12,15,80.0,3,9,1,8,9,31,25,1
Danilo Veiga,POR,"DF,MF",Estrela,22-038,2002,6.4,11,7,5,5,1,6,12,50.0,6,9,3,6,5,16,29,1
Eric Veiga,LUX,"MF,FW",AVS Futebol,27-258,1997,1.6,0,0,0,0,0,0,0,,0,2,1,1,0,0,0,0
Jhon Velásquez,COL,"FW,MF",Farense,29-184,1995,0.2,0,0,0,0,0,0,0,,0,1,0,1,0,0,0,0
Ricardo Velho,POR,GK,Farense,26-074,1998,9.0,0,0,0,0,0,0,0,,0,0,0,0,0,0,6,0
Frederico Venâncio,POR,DF,Santa Clara,31-272,1993,8.7,14,6,10,2,2,4,7,57.1,3,3,1,2,13,27,37,0
Paulo Victor,BRA,"DF,MF",Farense,23-203,2001,0.8,6,4,1,3,2,4,5,80.0,1,2,0,2,2,8,3,0
Fabio Vieira,POR,"FW,MF",Porto,24-156,2000,1.2,2,2,0,2,0,0,0,,0,0,0,0,1,3,1,0
Gabriel Vieira,BRA,"FW,MF",Santa Clara,22-225,2002,8.0,9,9,4,3,2,5,10,50.0,5,9,0,9,1,10,4,0
Mikel Villanueva,VEN,DF,Vitória,31-202,1993,5.0,5,3,3,2,0,4,7,57.1,3,2,1,1,2,7,15,0
Marcos Vinicios Sorriso,BRA,FW,Famalicão,23-253,2001,5.3,14,7,6,5,3,6,13,46.2,7,7,1,6,3,17,3,0
Vinícius,BRA,"FW,MF",Santa Clara,25-179,1999,6.3,10,7,0,5,5,5,7,71.4,2,6,0,6,3,13,3,0
Bernardo Vital,POR,MF,Estoril,23-309,2000,0.3,2,1,1,0,1,0,1,0.0,1,1,1,0,0,2,0,0
Zé Vitor,BRA,DF,Nacional,23-267,2001,8.0,10,5,8,2,0,4,7,57.1,3,7,5,2,13,23,52,2
Marious Vrousai,GRE,"MF,DF",Rio Ave,26-123,1998,8.0,20,12,14,4,2,11,20,55.0,9,10,0,10,8,28,26,1
Ilija Vukotić,MNE,MF,Boavista,25-300,1999,6.4,16,10,1,11,4,7,13,53.8,6,11,4,7,6,22,8,0
Wendell,BRA,DF,Porto,31-105,1993,0.3,0,0,0,0,0,0,0,,0,0,0,0,0,0,0,0
Weverson,BRA,DF,Arouca,24-120,2000,3.1,2,2,0,2,0,1,3,33.3,2,4,1,3,2,4,5,1
Xeka,POR,MF,Estoril,29-358,1994,1.4,4,1,2,2,0,4,4,100.0,0,0,0,0,5,9,4,0
Güven Yalçın,TUR,"FW,MF",Arouca,25-289,1999,1.9,6,5,1,1,4,0,3,0.0,3,1,0,1,1,7,0,0
Zaydou Youssouf,FRA,MF,Famalicão,25-114,1999,8.5,23,18,10,12,1,12,19,63.2,7,8,2,6,7,30,4,0
Yassir Zabiri,MAR,"FW,MF",Famalicão,19-253,2005,0.5,2,1,0,2,0,1,2,50.0,1,1,0,1,0,2,0,0
Rodrigo Zalazar,URU,"MF,FW",Braga,25-082,1999,4.0,4,2,1,3,0,0,2,0.0,2,3,0,3,0,4,1,0
Vinícius Zanocelo,BRA,MF,Estoril,23-277,2001,9.0,11,3,4,7,0,8,23,34.8,15,11,4,7,10,21,18,0
Ivan Zlobin,RUS,GK,Famalicão,27-240,1997,8.0,0,0,0,0,0,0,0,,0,0,0,0,0,0,6,0
Nermin Zolotić,BIH,DF,Casa Pia,31-118,1993,5.0,11,5,9,2,0,7,8,87.5,1,5,5,0,5,16,16,1
