Player,Nation,Pos,Squad,Age,Born,90s,Tackles,TacklesWon,TacklesDef3rd,TacklesMid3rd,TacklesAtt3rd,DribTkl,DribTklAtt,DribTkl%,ChallengesLost,Blocks,ShotsBlocked,PassesBlocked,Int,Tkl+Int,Clr,ErrorsLeadingToShot
Rodrigo Abascal,URU,DF,Boavista,30-277,1994,6.0,9,3,6,2,1,4,9,44.4,5,6,5,1,11,20,26,0
Bilal Abdelrahman Zeeni,EGY,MF,Estrela,21-270,2003,0.1,1,1,0,0,1,0,0,,0,0,0,0,0,1,1,0
Giorgi Aburjania,GEO,MF,AVS Futebol,29-289,1995,2.8,9,6,3,5,1,5,10,50.0,5,2,0,2,3,12,4,0
Adriano,BRA,MF,Santa Clara,24-348,1999,6.4,9,7,4,4,1,3,10,30.0,7,3,0,3,2,11,9,0
Lucas Áfrico,BRA,DF,Farense,29-255,1995,5.8,6,5,2,4,0,3,4,75.0,1,7,4,3,4,10,23,0
Salvador Agra,POR,"MF,DF",Boavista,32-341,1991,8.0,6,5,1,1,4,2,8,25.0,6,4,1,3,3,9,3,0
Brandon Aguilera,CRC,"MF,FW",Rio Ave,21-111,2003,1.8,9,6,3,3,3,4,4,100.0,0,1,0,1,1,10,0,0
Jorge Aguirre,ESP,FW,Gil Vicente FC,24-286,2000,3.2,1,0,0,1,0,1,4,25.0,3,2,0,2,0,1,2,0
Babatunde Akinsola,NGA,"MF,FW",AVS Futebol,21-221,2003,1.5,2,2,2,0,0,1,1,100.0,0,2,0,2,1,3,1,0
Kerem Aktürkoğlu,TUR,FW,Benfica,25-362,1998,2.3,2,2,1,0,1,0,1,0.0,1,1,0,1,0,2,0,0
Léo Alaba,BRA,DF,AVS Futebol,25-108,1999,3.7,6,5,3,2,1,3,9,33.3,6,5,1,4,7,13,10,0
Alan,BRA,MF,Moreirense,24-223,2000,5.8,5,2,1,2,2,1,6,16.7,5,5,1,4,0,5,1,0
Gonçalo Almeida,POR,"DF,MF",Boavista,21-164,2003,2.2,5,3,2,3,0,3,9,33.3,6,3,0,3,6,11,5,0
Pedro Álvaro,POR,DF,Estoril,24-229,2000,8.0,5,3,2,3,0,1,2,50.0,1,10,5,5,9,14,45,0
Pedro Amaral,POR,DF,Estoril,27-053,1997,7.9,9,3,4,3,2,6,14,42.9,8,6,2,4,7,16,21,0
Zeki Amdouni,SUI,"MF,FW",Benfica,23-318,2000,0.7,1,1,0,1,0,0,0,,0,0,0,0,0,1,1,0
Artur Jorge Marques Amorim,POR,DF,Farense,30-064,1994,5.0,6,5,6,0,0,4,5,80.0,1,4,3,1,6,12,26,0
Andrew,BRA,GK,Gil Vicente FC,23-108,2001,8.0,1,1,1,0,0,1,1,100.0,0,0,0,0,0,1,0,2
Jeremy Antonisse,CUW,"FW,MF",Moreirense,22-202,2002,3.2,6,2,1,5,0,4,5,80.0,1,4,0,4,1,7,8,0
Arvin Appiah,ENG,"FW,MF",Nacional,23-286,2001,4.4,6,5,2,3,1,4,5,80.0,1,2,0,2,5,11,3,0
Óscar Aranda,ESP,FW,Famalicão,22-171,2002,6.9,4,3,1,2,1,3,5,60.0,2,3,0,3,1,5,4,0
Henrique Araújo,POR,FW,Arouca,22-272,2002,3.0,1,0,0,1,0,0,0,,0,0,0,0,0,1,0,0
Maximiliano Araújo,URU,"MF,FW",Sporting CP,24-245,2000,1.8,3,1,0,1,2,0,1,0.0,1,1,0,1,2,5,0,0
Tomás Araújo,POR,DF,Benfica,22-154,2002,4.9,16,10,12,3,1,9,12,75.0,3,3,0,3,4,20,9,0
Telmo Arcanjo,CPV,FW,Vitória,23-118,2001,1.7,2,1,1,1,0,1,3,33.3,2,0,0,0,1,3,0,0
Bright Arrey-Mbi,GER,DF,Braga,21-205,2003,4.6,6,3,2,2,2,3,5,60.0,2,8,5,3,4,10,11,0
Gustavo Assuncao,POR,MF,AVS Futebol,24-201,2000,3.9,7,6,5,2,0,4,12,33.3,8,2,2,0,3,10,5,0
Otavio Ataide,BRA,DF,Porto,22-179,2002,5.0,5,2,3,2,0,4,7,57.1,3,2,2,0,5,10,8,1
Fredrik Aursnes,NOR,"FW,MF",Benfica,28-312,1995,4.2,7,4,1,5,1,4,10,40.0,6,4,1,3,0,7,4,0
Miguel Baeza,ESP,"MF,FW",Nacional,24-204,2000,2.3,2,2,1,1,0,1,2,50.0,1,1,0,1,0,2,1,0
Alexander Bah,DEN,DF,Benfica,26-313,1997,5.0,19,13,5,10,4,15,21,71.4,6,7,0,7,4,23,3,0
Elves Baldé,GNB,"MF,FW",Farense,25-015,1999,2.0,5,3,2,3,0,1,3,33.3,2,0,0,0,0,5,3,0
Robson Bambu,BRA,DF,Braga,26-340,1997,2.0,5,1,2,3,0,2,2,100.0,0,5,4,1,1,6,3,1
Simon Banza,COD,FW,Braga,28-065,1996,0.2,0,0,0,0,0,0,0,,0,0,0,0,0,0,0,0
Rafael Barbosa,POR,"MF,FW",Farense,28-202,1996,3.4,1,1,0,1,0,0,2,0.0,2,4,0,4,2,3,0,0
Leandro Barreiro Martins,LUX,MF,Benfica,24-288,2000,3.7,15,6,2,9,4,5,10,50.0,5,5,0,5,3,18,0,0
Gil Bastião Dias,POR,FW,Famalicão,28-019,1996,2.9,9,6,2,6,1,5,10,50.0,5,3,0,3,0,9,2,0
Gabriel Batista,BRA,GK,Santa Clara,26-136,1998,8.0,1,0,1,0,0,0,0,,0,0,0,0,0,1,3,0
Ricardo Batista,POR,GK,Casa Pia,37-333,1986,1.0,0,0,0,0,0,0,0,,0,0,0,0,0,0,2,0
Yanis Begraoui,MAR,FW,Estoril,23-105,2001,5.9,3,1,0,3,0,0,2,0.0,2,4,1,3,2,5,5,0
Gui Beleza,POR,MF,Gil Vicente FC,17-313,2006,0.0,0,0,0,0,0,0,0,,0,0,0,0,0,0,0,0
Bachir Belloumi,ALG,FW,Farense,22-138,2002,3.0,8,5,3,4,1,4,7,57.1,3,8,2,6,3,11,2,0
Fahem Benaissa Yahia,FRA,DF,Casa Pia,22-171,2002,0.0,0,0,0,0,0,0,0,,0,0,0,0,0,0,0,0
Beni,ANG,MF,Casa Pia,22-149,2002,3.9,8,6,3,5,0,3,5,60.0,2,2,0,2,5,13,5,0
Álex Bermejo,ESP,"MF,FW",Farense,25-311,1998,3.1,2,1,0,2,0,1,4,25.0,3,1,0,1,1,3,3,0
Simão Bertelli,BRA,GK,AVS Futebol,31-137,1993,4.0,0,0,0,0,0,0,0,,0,0,0,0,0,0,0,1
Jan-Niklas Beste,GER,"DF,FW",Benfica,25-287,1999,1.1,1,1,1,0,0,0,1,0.0,1,0,0,0,2,3,1,0
Raúl Blanco,ESP,FW,Casa Pia,23-078,2001,2.8,3,2,0,1,2,2,5,40.0,3,2,1,1,2,5,1,0
Kévin Boma,TOG,DF,Estoril,21-332,2002,4.0,8,6,7,1,0,5,8,62.5,3,5,4,1,4,12,18,0
Kiko Bondoso,POR,"MF,FW",Rio Ave,28-335,1995,4.6,8,5,4,1,3,2,4,50.0,2,2,0,2,1,9,0,0
Toni Borevkovic,CRO,DF,Vitória,27-121,1997,8.0,11,6,9,2,0,6,7,85.7,1,8,7,1,9,20,33,0
Gonçalo Borges,POR,FW,Porto,23-202,2001,1.4,1,1,0,0,1,0,1,0.0,1,2,0,2,0,1,0,0
Róbert Boženík,SVK,FW,Boavista,24-334,1999,7.9,2,1,0,1,1,0,1,0.0,1,3,0,3,1,3,10,0
Daniel Bragança,POR,MF,Sporting CP,25-143,1999,5.1,9,5,1,6,2,6,10,60.0,4,7,0,7,2,11,5,0
Bruno Brigido,BRA,GK,Estrela,33-222,1991,8.0,0,0,0,0,0,0,0,,0,0,0,0,0,0,3,1
Rafael Brito,POR,MF,Casa Pia,22-272,2002,1.9,4,2,4,0,0,2,2,100.0,0,4,3,1,1,5,4,0
Bruma,POR,"FW,MF",Braga,29-359,1994,3.0,0,0,0,0,0,0,2,0.0,2,1,0,1,1,1,0,0
Jonathan Buatu Mananga,ANG,DF,Gil Vicente FC,31-020,1993,8.0,11,6,8,3,0,7,9,77.8,2,12,9,3,10,21,34,0
Leonel Bucca,ARG,MF,Estrela,25-211,1999,4.2,13,5,4,8,1,7,12,58.3,5,9,4,5,7,20,8,0
Adrián Butzke,ESP,FW,Nacional,25-201,1999,4.0,4,2,0,4,0,2,4,50.0,2,2,0,2,3,7,4,0
Arthur Cabral,BRA,FW,Benfica,26-175,1998,0.6,2,1,0,1,1,0,0,,0,2,0,2,0,2,1,0
Jovane Cabral,CPV,"FW,MF",Estrela,26-125,1998,1.7,5,4,3,1,1,2,4,50.0,2,2,1,1,2,7,0,0
Lucas Calegari,BRA,DF,Famalicão,22-233,2002,7.5,22,12,11,11,0,10,15,66.7,5,6,3,3,3,25,11,0
Diogo Calila,POR,MF,Santa Clara,26-007,1998,3.4,8,2,4,2,2,3,3,100.0,0,5,0,5,1,9,5,0
Ibrahima Camará,GUI,MF,Boavista,25-266,1999,6.5,10,6,2,7,1,7,12,58.3,5,6,0,6,8,18,23,0
André Candeias,POR,"FW,MF",Farense,21-271,2003,0.4,0,0,0,0,0,0,0,,0,0,0,0,0,0,0,0
Zé Carlos,POR,MF,Vitória,22-353,2001,0.2,4,2,1,3,0,3,3,100.0,0,0,0,0,1,5,1,0
Zé Carlos,POR,DF,Gil Vicente FC,26-078,1998,8.0,14,9,8,4,2,11,19,57.9,8,8,5,3,23,37,31,2
Álvaro Carreras,ESP,DF,Benfica,21-208,2003,6.1,13,7,4,8,1,7,11,63.6,4,5,0,5,5,18,11,0
João Carvalho,POR,"FW,MF",Estoril,27-222,1997,2.5,1,0,0,0,1,1,4,25.0,3,1,0,1,0,1,2,0
Pedro Carvalho,POR,DF,Estoril,21-246,2003,2.2,3,2,1,2,0,0,3,0.0,3,1,0,1,4,7,7,0
Vitor Carvalho,BRA,MF,Braga,27-143,1997,7.4,15,10,5,10,0,8,13,61.5,5,8,2,6,13,28,11,0
Cassiano,BRA,FW,Casa Pia,35-123,1989,2.0,5,3,4,1,0,1,2,50.0,1,3,0,3,0,5,1,0
Jesús Castillo,PER,MF,Gil Vicente FC,23-128,2001,5.1,11,6,3,7,1,8,15,53.3,7,8,3,5,6,17,10,0
André Castro,POR,MF,Moreirense,36-198,1988,0.2,0,0,0,0,0,0,0,,0,0,0,0,0,0,0,0
Cristian Castro,COL,DF,AVS Futebol,23-266,2001,7.9,7,5,5,0,2,5,7,71.4,2,1,1,0,8,15,49,1
Geny Catamo,MOZ,"MF,DF",Sporting CP,23-265,2001,5.9,9,5,3,4,2,7,12,58.3,5,7,0,7,2,11,7,0
Cauê,BRA,FW,Gil Vicente FC,21-336,2002,4.4,4,1,1,2,1,0,1,0.0,1,6,1,5,1,5,7,0
César,BRA,GK,Boavista,32-264,1992,2.0,0,0,0,0,0,0,0,,0,0,0,0,0,0,1,0
Tidjany Chabrol,FRA,FW,Gil Vicente FC,22-094,2002,3.2,6,4,3,3,0,4,8,50.0,4,3,0,3,0,6,4,0
Till Cissokho,FRA,DF,Estrela,24-252,2000,4.0,1,0,1,0,0,0,1,0.0,1,0,0,0,2,3,12,1
Clayton,BRA,DF,AVS Futebol,24-196,2000,2.0,0,0,0,0,0,0,3,0.0,3,5,1,4,1,1,7,0
Clayton,BRA,FW,Rio Ave,25-280,1999,7.6,4,1,0,3,1,1,4,25.0,3,2,1,1,0,4,5,0
Diego Collado,ESP,"MF,FW",Gil Vicente FC,23-282,2001,0.2,0,0,0,0,0,0,0,,0,0,0,0,1,1,0,0
Fábio Conceição,POR,"DF,MF",Rio Ave,23-172,2001,2.1,7,5,3,2,2,3,7,42.9,4,2,1,1,1,8,2,0
Leo Cordeiro,BRA,MF,Estrela,29-020,1995,6.7,7,4,3,4,0,4,11,36.4,7,9,2,7,3,10,3,1
Félix Correia,POR,"FW,MF",Gil Vicente FC,23-269,2001,7.9,10,6,5,5,0,6,11,54.5,5,5,0,5,13,23,16,0
Alberto costa,POR,DF,Vitória,21-018,2003,1.3,0,0,0,0,0,0,1,0.0,1,4,0,4,1,1,7,0
Bruno Xavier Almeida Costa,POR,"MF,FW",Nacional,27-181,1997,2.1,1,0,1,0,0,1,5,20.0,4,3,1,2,0,1,0,0
Diogo Costa,POR,GK,Porto,25-028,1999,8.0,0,0,0,0,0,0,1,0.0,1,0,0,0,0,0,1,0
Gonçalo Costa,POR,DF,Estoril,24-242,2000,0.3,0,0,0,0,0,0,1,0.0,1,1,0,1,0,0,1,0
Hélder Costa,ANG,FW,Estoril,30-279,1994,2.3,2,0,1,0,1,1,5,20.0,4,1,0,1,0,2,0,0
João Costa,POR,FW,Santa Clara,24-224,2000,0.5,2,0,1,1,0,2,3,66.7,1,1,0,1,0,2,0,0
Michel Costa,BRA,MF,Estoril,22-302,2001,6.2,6,2,2,3,1,1,9,11.1,8,11,3,8,7,13,9,0
Sandro Cruz,ANG,DF,Gil Vicente FC,23-158,2001,6.8,15,7,7,5,3,9,16,56.3,7,8,2,6,7,22,20,0
Augusto Dabo,POR,DF,Boavista,20-218,2004,1.0,1,0,0,0,1,1,1,100.0,0,2,1,1,0,1,6,0
Amadou Dante,MLI,"DF,MF",Arouca,24-010,2000,3.8,12,8,10,1,1,8,15,53.3,7,5,1,4,7,19,7,1
Mathias De Amorim,FRA,MF,Famalicão,19-312,2004,0.2,0,0,0,0,0,0,0,,0,0,0,0,0,0,1,0
Zeno Debast,BEL,DF,Sporting CP,20-359,2003,4.5,6,4,3,3,0,3,4,75.0,1,6,2,4,4,10,4,0
Depú,ANG,FW,Gil Vicente FC,24-283,2000,0.5,0,0,0,0,0,0,0,,0,0,0,0,0,0,0,0
Derick,BRA,"DF,MF",Farense,31-046,1993,3.3,2,0,0,2,0,0,7,0.0,7,6,1,5,2,4,9,0
Ángel Di María,ARG,FW,Benfica,36-246,1988,3.8,4,2,1,1,2,1,4,25.0,3,2,0,2,2,6,0,0
Matheus Dias,BRA,"MF,DF",Nacional,27-253,1997,6.2,27,17,14,11,2,11,23,47.8,12,13,5,8,11,38,19,1
Tiago Dias,POR,FW,Casa Pia,26-166,1998,0.3,1,0,0,1,0,0,1,0.0,1,0,0,0,0,1,0,0
Ousmane Diomande,CIV,DF,Sporting CP,20-318,2003,6.1,10,5,4,6,0,6,9,66.7,3,2,1,1,5,15,15,1
Maxime Dominguez,SUI,MF,Gil Vicente FC,28-259,1996,2.8,8,3,4,4,0,3,4,75.0,1,3,0,3,3,11,1,0
Issiar Dramé,MLI,"DF,MF",Estrela,25-244,1999,1.2,1,1,1,0,0,1,1,100.0,0,0,0,0,5,6,7,0
Marcus Edwards,ENG,"FW,MF",Sporting CP,25-319,1998,0.5,0,0,0,0,0,0,0,,0,0,0,0,0,0,1,0
Ricardo Esgaio,POR,"FW,DF",Sporting CP,31-154,1993,0.3,0,0,0,0,0,0,0,,0,0,0,0,0,0,1,0
Tiago Esgaio,POR,"DF,MF",Arouca,29-077,1995,7.9,25,14,17,7,1,14,18,77.8,4,12,5,7,10,35,29,0
Dario Essugo,POR,MF,Sporting CP,19-217,2005,0.2,0,0,0,0,0,0,0,,0,0,0,0,0,0,0,0
Luís Esteves,POR,MF,Nacional,26-191,1998,6.9,10,7,5,5,0,7,19,36.8,12,8,1,7,5,15,3,1
Stephen Eustáquio,CAN,MF,Porto,27-301,1996,2.9,8,5,2,4,2,4,7,57.1,3,7,0,7,3,11,3,0
Evanilson,BRA,FW,Porto,25-011,1999,0.1,1,0,0,1,0,0,0,,0,0,0,0,0,1,0,0
Fabiano,BRA,DF,Moreirense,24-217,2000,6.3,9,7,7,1,1,7,9,77.8,2,7,2,5,8,17,20,1
Claudio Falcão,BRA,"MF,DF",Farense,30-106,1994,8.0,37,21,16,17,4,13,18,72.2,5,12,5,7,10,47,23,0
Jorge Filipe Oliveira Fernandes,POR,DF,Vitória,27-198,1997,1.5,0,0,0,0,0,0,1,0.0,1,0,0,0,3,3,7,0
Martim Fernandes,POR,DF,Porto,18-273,2006,4.2,11,5,5,5,1,3,9,33.3,6,8,1,7,7,18,3,0
Mateus Fernandes,POR,"FW,MF",Sporting CP,20-099,2004,0.3,1,0,0,0,1,1,1,100.0,0,0,0,0,0,1,0,0
Roger Fernandes,GNB,"FW,MF",Braga,18-331,2005,4.7,9,3,2,7,0,3,6,50.0,3,4,0,4,1,10,2,0
Rúben Fernandes,POR,DF,Gil Vicente FC,38-164,1986,7.8,6,4,2,4,0,5,6,83.3,1,6,3,3,12,18,34,0
Roberto Férnandez,ESP,FW,Braga,22-106,2002,4.4,3,1,0,1,2,2,4,50.0,2,3,0,3,0,3,1,0
João Ferreira Barros,POR,"MF,FW",Boavista,18-281,2006,1.1,5,3,3,1,1,2,5,40.0,3,1,0,1,1,6,1,0
Filipe Ferreira,POR,DF,Boavista,34-020,1990,7.6,8,6,4,3,1,5,9,55.6,4,6,3,3,9,17,23,0
Fernando Ferreira Fonseca,POR,DF,AVS Futebol,27-217,1997,4.3,7,4,4,1,2,7,10,70.0,3,6,1,5,7,14,10,0
João Ferreira,POR,DF,Braga,23-209,2001,3.3,6,3,3,3,0,2,3,66.7,1,4,4,0,4,10,11,0
Marcelo dos Santos Ferreira,BRA,DF,Moreirense,35-082,1989,8.0,17,9,14,3,0,9,12,75.0,3,15,13,2,10,27,46,0
Pedro Ferreira,POR,MF,Santa Clara,26-286,1998,7.1,33,20,10,16,7,7,12,58.3,5,13,0,13,14,47,8,0
Tiago Ferreira,POR,FW,Estrela,22-213,2002,0.4,3,2,0,1,2,0,0,,0,0,0,0,1,4,0,0
Daniel Figueira,POR,GK,Estoril,26-089,1998,1.0,0,0,0,0,0,0,0,,0,0,0,0,0,0,0,0
Tiago Fonseca Morais,POR,"FW,MF",Rio Ave,21-044,2003,4.3,5,3,0,2,3,2,5,40.0,3,5,2,3,3,8,1,0
José Fontán,ESP,DF,Arouca,24-249,2000,4.9,4,1,4,0,0,2,7,28.6,5,10,8,2,2,6,23,0
José Fonte,POR,DF,Casa Pia,40-300,1983,6.0,7,5,6,0,1,1,2,50.0,1,6,4,2,7,14,26,3
Lucas França,BRA,GK,Nacional,28-272,1996,7.0,0,0,0,0,0,0,0,,0,0,0,0,0,0,4,0
André Franco,POR,"MF,FW",Porto,26-188,1998,0.8,0,0,0,0,0,0,1,0.0,1,0,0,0,3,3,0,0
Afonso freitas,POR,DF,Nacional,24-193,2000,0.2,0,0,0,0,0,0,0,,0,0,0,0,0,0,3,0
Iván Fresneda,ESP,DF,Sporting CP,20-019,2004,0.5,1,1,0,1,0,0,0,,0,0,0,0,1,2,0,0
Godfried Frimpong,NED,DF,Moreirense,25-088,1999,8.0,9,6,7,2,0,5,7,71.4,2,6,2,4,13,22,31,0
Kanya Fujimoto,JPN,"MF,FW",Gil Vicente FC,25-108,1999,7.2,2,1,1,0,1,0,4,0.0,4,4,1,3,5,7,6,0
Taichi Fukui,JPN,MF,Arouca,20-094,2004,8.0,10,6,1,8,1,4,10,40.0,6,6,5,1,11,21,16,0
Tiago Gabriel,POR,DF,Estrela,19-296,2004,4.9,9,7,7,2,0,5,7,71.4,2,5,3,2,9,18,20,2
Galeno,BRA,"DF,FW",Porto,26-361,1997,7.6,7,3,4,0,3,4,6,66.7,2,10,3,7,8,15,11,0
Nino Galović,CRO,DF,Arouca,32-103,1992,1.0,0,0,0,0,0,0,0,,0,2,2,0,1,1,2,0
García,BRA,DF,Nacional,22-287,2002,7.0,17,17,11,5,1,11,18,61.1,7,11,6,5,13,30,15,0
Fabrício Garcia,CPV,FW,Estoril,23-166,2001,4.4,6,5,3,2,1,2,6,33.3,4,2,0,2,1,7,0,0
Santiago García,ESP,MF,Gil Vicente FC,23-049,2001,2.0,8,4,5,3,0,3,5,60.0,2,4,1,3,3,11,3,0
Bruno Gaspar,ANG,DF,Vitória,31-179,1993,6.7,11,8,6,2,3,6,10,60.0,4,9,0,9,3,14,11,0
Mory Gbane,CIV,MF,Gil Vicente FC,23-297,2000,5.7,18,11,8,10,0,15,22,68.2,7,4,3,1,9,27,18,0
Geovanny,POR,MF,Farense,20-095,2004,1.2,1,1,0,1,0,0,2,0.0,2,1,0,1,0,1,1,0
André Geraldes,POR,"MF,DF",Casa Pia,33-168,1991,5.8,8,2,7,1,0,4,5,80.0,1,6,2,4,2,10,19,0
Ismaël Gharbi,ESP,"MF,FW",Braga,20-190,2004,1.1,1,0,0,0,1,1,2,50.0,1,2,0,2,0,1,0,0
José Gomes,POR,DF,Nacional,28-089,1996,6.7,14,9,5,7,2,3,8,37.5,5,9,4,5,8,22,24,0
Pedro gomes,POR,DF,Boavista,21-135,2003,7.2,21,15,15,6,0,14,19,73.7,5,13,4,9,8,29,30,1
Vítor Gomes,POR,MF,Rio Ave,36-297,1987,0.4,1,0,0,0,1,0,1,0.0,1,0,0,0,1,2,5,0
Victor Gomez,ESP,DF,Braga,24-199,2000,5.0,4,1,1,2,1,4,9,44.4,5,5,0,5,4,8,10,0
Nuno Gonçalo Moreira,POR,FW,Casa Pia,25-123,1999,5.2,13,11,5,6,2,7,16,43.8,9,6,0,6,3,16,2,0
João Gonçalves,POR,GK,Boavista,23-347,2000,4.0,0,0,0,0,0,0,0,,0,0,0,0,0,0,2,0
Pedro Gonçalves,POR,"FW,MF",Sporting CP,26-111,1998,4.7,6,1,1,2,3,3,10,30.0,7,5,1,4,2,8,0,0
Cristo González,ESP,MF,Arouca,26-359,1997,2.0,2,1,1,0,1,1,4,25.0,3,1,1,0,0,2,1,0
Mario González,ESP,FW,Famalicão,28-235,1996,3.6,2,1,0,1,1,1,1,100.0,0,1,0,1,0,2,1,0
Nicolás González,ESP,MF,Porto,22-288,2002,7.5,18,6,3,12,3,7,13,53.8,6,3,1,2,2,20,6,0
Jean Gorby,FRA,MF,Braga,22-084,2002,2.9,7,3,1,6,0,4,6,66.7,2,4,3,1,3,10,5,0
João Goulart Silva,POR,DF,Casa Pia,24-264,2000,8.0,13,11,9,3,1,10,12,83.3,2,11,9,2,12,25,38,0
Tiago Gouveia,POR,"FW,DF",Benfica,23-121,2001,0.9,2,2,1,1,0,0,0,,0,1,0,1,0,2,0,0
Pablo Gozalbez,ESP,MF,Arouca,23-170,2001,0.7,0,0,0,0,0,0,1,0.0,1,0,0,0,1,1,0,0
João Graça,POR,"MF,FW",Rio Ave,29-121,1995,1.5,3,2,2,1,0,3,6,50.0,3,7,1,6,0,3,4,0
Samuel Granada,BRA,FW,AVS Futebol,24-250,2000,2.7,1,1,1,0,0,0,0,,0,1,0,1,0,1,5,0
Jaume Grau,ESP,MF,AVS Futebol,27-165,1997,4.7,13,7,9,3,1,7,19,36.8,12,9,2,7,6,19,5,1
Marko Grujić,SRB,MF,Porto,28-187,1996,0.4,0,0,0,0,0,0,0,,0,1,1,0,0,0,2,0
Rafik Guitane,FRA,"FW,MF",Estoril,25-144,1999,1.1,0,0,0,0,0,0,0,,0,0,0,0,0,0,0,0
Rafik Guitane,FRA,FW,Braga,25-144,1999,0.0,0,0,0,0,0,0,0,,0,1,0,1,0,0,0,0
Deniz Gül,SWE,FW,Porto,20-107,2004,0.5,0,0,0,0,0,0,1,0.0,1,1,0,1,0,0,0,0
Viktor Gyökeres,SWE,FW,Sporting CP,26-135,1998,7.8,2,2,0,0,2,1,3,33.3,2,0,0,0,0,2,3,0
Justin de Haas,NED,DF,Famalicão,24-259,2000,8.0,10,6,8,2,0,8,10,80.0,2,10,7,3,11,21,30,0
Tomás Händel,POR,MF,Vitória,23-325,2000,7.7,14,10,6,6,2,10,13,76.9,3,5,2,3,13,27,9,0
Conrad Harder,DEN,"FW,MF",Sporting CP,19-193,2005,1.5,0,0,0,0,0,0,1,0.0,1,0,0,0,1,1,2,0
Thiago Helguera,URU,MF,Braga,18-205,2006,0.1,0,0,0,0,0,0,0,,0,0,0,0,0,0,1,0
Gustavo Henrique,BRA,"MF,FW",Estrela,25-168,1999,2.5,7,4,3,4,0,5,9,55.6,4,4,0,4,2,9,5,0
Morten Hjulmand,DEN,MF,Sporting CP,25-114,1999,5.3,10,8,2,7,1,6,10,60.0,4,5,3,2,5,15,4,0
Jordan Holsgrove,SCO,MF,Estoril,25-037,1999,1.6,1,1,0,1,0,1,1,100.0,0,2,2,0,1,2,4,0
Lukáš Horníček,CZE,GK,Braga,22-096,2002,1.0,0,0,0,0,0,0,0,,0,0,0,0,0,0,1,0
André Horta,POR,MF,Braga,27-345,1996,2.9,11,8,3,7,1,4,5,80.0,1,1,0,1,0,11,2,0
Ricardo Horta,POR,"MF,FW",Braga,30-032,1994,7.9,11,4,1,6,4,2,8,25.0,6,5,1,4,3,14,4,0
Igor,BRA,MF,Estrela,21-224,2003,3.2,5,3,1,4,0,3,9,33.3,6,3,1,2,5,10,3,0
André Inácio,BRA,MF,Estrela,22-237,2002,3.5,6,2,3,2,1,2,7,28.6,5,5,0,5,2,8,2,0
Gonçalo Inácio,POR,DF,Sporting CP,23-053,2001,6.1,9,5,2,5,2,5,9,55.6,4,6,2,4,10,19,7,0
Isaac,BRA,FW,Nacional,20-205,2004,1.2,3,1,2,0,1,1,2,50.0,1,3,0,3,0,3,2,0
Ismael,POR,MF,Moreirense,25-206,1999,7.2,25,16,9,14,2,8,13,61.5,5,9,4,5,16,41,15,0
Franco Israel,URU,GK,Sporting CP,24-178,2000,4.0,0,0,0,0,0,0,0,,0,0,0,0,0,0,0,0
Ivan Jaime Pajuelo,ESP,FW,Porto,24-021,2000,4.1,1,1,1,0,0,1,2,50.0,1,2,0,2,2,3,3,0
Jason,ESP,FW,Arouca,30-103,1994,5.8,1,1,1,0,0,0,6,0.0,6,6,1,5,6,7,5,0
Jhonatan,BRA,GK,Rio Ave,33-162,1991,8.0,0,0,0,0,0,0,1,0.0,1,0,0,0,0,0,2,3
Luiz Lúcio Reis Júnior,BRA,GK,Famalicão,23-277,2001,1.0,0,0,0,0,0,0,0,,0,0,0,0,0,0,1,0
Issa Kaboré,BFA,DF,Benfica,23-158,2001,0.0,0,0,0,0,0,0,0,,0,0,0,0,0,0,0,0
Kaio,BRA,FW,Vitória,20-245,2004,5.6,7,4,3,3,1,4,11,36.4,7,5,0,5,3,10,1,0
Issiaka Kamate,FRA,"FW,DF",AVS Futebol,20-076,2004,2.9,5,3,3,2,0,4,5,80.0,1,1,0,1,4,9,2,0
Kazu,BRA,DF,Gil Vicente FC,24-213,2000,1.0,1,0,0,1,0,1,1,100.0,0,2,0,2,2,3,4,0
Keliano,ANG,MF,Estrela,21-275,2003,2.8,11,6,4,6,1,8,10,80.0,2,0,0,0,5,16,6,0
Kewin,BRA,GK,Moreirense,28-358,1995,8.0,0,0,0,0,0,0,1,0.0,1,0,0,0,0,0,8,1
Kikas,POR,FW,Estrela,26-030,1998,7.4,1,0,0,0,1,0,2,0.0,2,2,0,2,0,1,5,0
Gustavo Klismahn,BRA,MF,Santa Clara,24-329,1999,1.7,4,2,1,2,1,1,2,50.0,1,1,0,1,1,5,3,0
Ruben Kluivert,NED,DF,Casa Pia,23-149,2001,2.1,5,3,4,0,1,1,1,100.0,0,4,3,1,1,6,15,0
Koka,EGY,"FW,MF",Rio Ave,31-226,1993,1.2,0,0,0,0,0,0,0,,0,1,0,1,0,0,0,0
Orkun Kökçü,TUR,"MF,FW",Benfica,23-293,2000,5.4,1,1,1,0,0,0,6,0.0,6,1,0,1,2,3,1,1
Vladen Kovačević,BIH,GK,Sporting CP,26-189,1998,4.0,0,0,0,0,0,0,0,,0,0,0,0,0,0,3,0
Andrian Kraev,BUL,MF,Casa Pia,25-246,1999,4.1,11,6,3,6,2,4,11,36.4,7,5,3,2,6,17,6,0
André Lacximicant,POR,FW,Estoril,23-151,2001,1.6,2,2,1,0,1,0,2,0.0,2,0,0,0,1,3,5,0
Chico Lamba,POR,DF,Arouca,21-221,2003,4.3,5,2,5,0,0,4,6,66.7,2,8,7,1,1,6,13,0
Larra,ESP,"MF,FW",Casa Pia,26-305,1997,3.7,5,4,1,3,1,2,3,66.7,1,6,1,5,2,7,6,0
Leonardo Lelo,POR,"MF,DF",Casa Pia,24-201,2000,7.9,15,9,6,5,4,5,12,41.7,7,5,2,3,2,17,17,1
Marcos Leonardo,BRA,MF,Benfica,21-168,2003,0.9,0,0,0,0,0,0,0,,0,0,0,0,0,0,0,0
Guilherme Liberato,BRA,MF,Moreirense,23-123,2001,0.5,1,0,0,1,0,1,1,100.0,0,0,0,0,0,1,0,0
Otso Liimatta,FIN,FW,Famalicão,20-099,2004,0.1,1,1,1,0,0,1,1,100.0,0,0,0,0,0,1,0,0
Rúben Lima,POR,DF,Estrela,35-014,1989,0.3,2,2,2,0,0,0,2,0.0,2,0,0,0,0,2,2,0
Jérémy Livolant,FRA,FW,Casa Pia,26-282,1998,0.0,0,0,0,0,0,0,0,,0,0,0,0,0,0,0,0
Danny Loader,ENG,FW,Porto,24-050,2000,4.6,2,1,1,1,0,0,4,0.0,4,3,0,3,3,5,2,0
Samuel Lobato,POR,FW,Famalicão,22-364,2001,0.1,3,2,2,1,0,2,2,100.0,0,0,0,0,0,3,0,0
Tom van de Looi,NED,MF,Famalicão,25-107,1999,2.5,9,7,3,4,2,5,7,71.4,2,0,0,0,3,12,3,0
Miguel Lopes,POR,DF,Estrela,37-303,1986,4.0,5,4,4,1,0,4,11,36.4,7,2,2,0,6,11,41,1
Vasco Lopes,CPV,"MF,FW",AVS Futebol,25-045,1999,1.3,2,1,0,0,2,1,2,50.0,1,0,0,0,1,3,1,0
Mamadou Loum,SEN,"DF,MF",Arouca,27-292,1996,1.2,1,1,0,1,0,1,2,50.0,1,2,1,1,0,1,5,0
Jonatan Lucca,BRA,MF,AVS Futebol,30-137,1994,2.3,3,2,1,2,0,1,2,50.0,1,4,2,2,1,4,7,0
Florentino Luís,POR,MF,Benfica,25-059,1999,5.9,20,12,4,12,4,9,17,52.9,8,12,1,11,11,31,4,1
Zé Luís,CPV,FW,AVS Futebol,33-267,1991,0.4,0,0,0,0,0,0,0,,0,0,0,0,0,0,1,0
Luismi,EQG,FW,Moreirense,23-100,2001,7.0,5,4,1,3,1,2,3,66.7,1,8,2,6,0,5,11,0
Rúben Macedo,POR,"FW,MF",Nacional,28-222,1996,3.2,2,2,2,0,0,0,4,0.0,4,6,0,6,2,4,1,0
Tiago Machado,POR,"MF,DF",Boavista,20-198,2004,0.4,0,0,0,0,0,0,0,,0,1,0,1,0,0,0,0
Madson,BRA,FW,Moreirense,25-052,1999,6.1,7,6,2,4,1,2,7,28.6,5,7,0,7,8,15,4,0
Eliaquim Mangala,FRA,DF,Estoril,33-247,1991,4.3,7,6,5,2,0,5,8,62.5,3,6,5,1,7,14,17,0
Ricardo Mangas,POR,FW,Vitória,26-212,1998,3.8,3,3,2,0,1,3,4,75.0,1,2,0,2,0,3,8,0
Nico Mantl,GER,GK,Arouca,24-254,2000,8.0,0,0,0,0,0,0,0,,0,0,0,0,0,0,5,2
Manuel Manu,POR,MF,Vitória,23-127,2001,1.8,2,1,2,0,0,2,3,66.7,1,1,0,1,2,4,2,0
Maracás,BRA,DF,Moreirense,30-173,1994,7.0,5,2,4,1,0,2,3,66.7,1,5,4,1,2,7,41,0
Adrián Marín,ESP,DF,Braga,27-282,1997,6.9,12,3,7,5,0,5,13,38.5,8,7,1,6,13,25,23,0
João Mário,POR,"FW,MF",Benfica,31-272,1993,1.7,3,2,3,0,0,3,3,100.0,0,3,0,3,0,3,0,0
João Mário Lopes,POR,DF,Porto,24-288,2000,3.8,11,7,5,4,2,7,9,77.8,2,1,0,1,2,13,3,0
Uladzislaŭ Marozaŭ,BLR,"FW,MF",Arouca,24-005,2000,1.1,2,2,0,2,0,0,1,0.0,1,0,0,0,0,2,1,0
Alejandro Marqués,VEN,FW,Estoril,24-074,2000,6.4,2,1,1,1,0,0,2,0.0,2,7,1,6,3,5,4,0
João Marques,POR,"MF,FW",Braga,22-247,2002,0.4,2,1,1,1,0,1,1,100.0,0,4,0,4,0,2,0,0
Gabri Martínez,ESP,FW,Braga,21-269,2003,4.2,15,8,10,2,3,13,19,68.4,6,6,0,6,2,17,4,0
Toni Martínez,ESP,FW,Porto,27-109,1997,0.0,2,0,0,2,0,1,1,100.0,0,0,0,0,0,2,0,0
Bernardo Sousa Pereira Brites Martins,POR,"MF,FW",Moreirense,26-318,1997,1.2,4,3,2,2,0,1,7,14.3,6,0,0,0,2,6,0,0
Matheus,BRA,GK,Braga,32-090,1992,7.0,1,1,1,0,0,1,2,50.0,1,0,0,0,0,1,0,0
Marco Matias,POR,FW,Farense,35-160,1989,1.7,1,0,1,0,0,0,0,,0,0,0,0,0,1,0,0
Jordi Mboula,ESP,"FW,MF",Gil Vicente FC,25-215,1999,4.4,3,0,0,3,0,1,7,14.3,6,2,0,2,2,5,2,0
Yair Mena Palacios,COL,FW,AVS Futebol,24-111,2000,0.4,1,1,0,1,0,0,0,,0,0,0,0,1,2,1,0
João Mendes,POR,FW,Vitória,29-362,1994,6.1,7,6,2,2,3,6,9,66.7,3,4,0,4,0,7,4,0
João Mendes,POR,DF,Vitória,24-187,2000,5.9,17,8,9,7,1,8,11,72.7,3,7,1,6,2,19,22,1
Joe Mendes,SWE,DF,Braga,21-291,2002,2.0,2,1,0,2,0,2,2,100.0,0,2,0,2,1,3,4,0
Gustavo Mendonça,POR,MF,AVS Futebol,21-220,2003,0.2,0,0,0,0,0,0,0,,0,0,0,0,0,0,0,0
Miguel Menino,POR,MF,Farense,21-281,2003,2.5,8,4,2,5,1,0,3,0.0,3,5,1,4,1,9,6,0
John Mercado,ECU,"FW,MF",AVS Futebol,22-136,2002,6.9,8,6,3,4,1,1,5,20.0,4,8,3,5,3,11,9,2
Mehdi Merghem,FRA,MF,Farense,27-090,1997,2.4,4,4,3,0,1,1,4,25.0,3,3,0,3,1,5,1,0
Bruno Messi,POR,"MF,FW",Santa Clara,28-038,1996,0.1,0,0,0,0,0,0,0,,0,0,0,0,0,0,0,0
Enea Mihaj,ALB,DF,Famalicão,26-104,1998,7.5,12,7,7,5,0,8,10,80.0,2,9,5,4,17,29,32,1
Álex Millán,ESP,"FW,MF",Farense,24-345,1999,3.4,3,0,0,2,1,0,2,0.0,2,4,0,4,1,4,4,0
Rodrigo Mora,POR,MF,Porto,17-165,2007,0.1,0,0,0,0,0,0,0,,0,0,0,0,0,0,0,0
Morato,BRA,DF,Benfica,23-109,2001,1.0,3,2,1,2,0,1,3,33.3,2,1,0,1,3,6,1,0
Paulo Moreira,POR,MF,Estrela,24-243,2000,0.4,3,0,1,1,1,1,1,100.0,0,0,0,0,0,3,1,0
Marco Moreno,ESP,DF,Farense,23-240,2001,4.5,5,4,4,1,0,2,5,40.0,3,7,7,0,4,9,21,0
Hidemasa Morita,JPN,MF,Sporting CP,29-160,1995,5.7,12,7,4,7,1,5,9,55.6,4,5,1,4,2,14,8,1
Moura,POR,DF,Famalicão,25-062,1999,4.0,10,7,6,3,1,6,7,85.7,1,4,0,4,1,11,6,0
Moura,POR,DF,Porto,25-062,1999,3.8,3,1,1,2,0,0,3,0.0,3,1,0,1,5,8,12,0
João Moutinho,POR,MF,Braga,38-039,1986,1.0,2,1,0,2,0,1,2,50.0,1,2,0,2,1,3,0,0
MT,BRA,MF,Santa Clara,23-230,2001,8.0,16,8,11,4,1,7,14,50.0,7,7,0,7,9,25,27,0
Jonathan Mutombo Mawesi,FRA,"DF,FW",Gil Vicente FC,22-051,2002,0.2,1,1,1,0,0,0,0,,0,0,0,0,0,1,2,0
Nani,POR,"FW,MF",Estrela,37-335,1986,4.7,4,1,1,3,0,1,6,16.7,5,2,1,1,3,7,2,0
Fran Navarro,ESP,FW,Porto,26-257,1998,1.0,2,0,0,0,2,2,2,100.0,0,1,0,1,0,2,0,0
Christian Neiva Afonso,POR,DF,AVS Futebol,29-312,1994,7.2,14,11,7,6,1,9,13,69.2,4,14,3,11,4,18,19,1
Nenê,BRA,FW,AVS Futebol,41-081,1983,2.6,3,1,1,2,0,0,1,0.0,1,3,0,3,0,3,0,0
Neto,BRA,MF,Farense,33-045,1991,4.7,15,9,7,8,0,4,14,28.6,10,4,3,1,8,23,5,1
Martim Neto,POR,MF,Rio Ave,21-277,2003,2.5,5,2,0,4,1,1,2,50.0,1,1,0,1,2,7,1,0
Sikou Niakaté,MLI,DF,Braga,25-099,1999,5.0,4,1,2,2,0,2,4,50.0,2,0,0,0,8,12,21,0
Miguel Nóbrega,POR,DF,Rio Ave,24-183,2000,1.0,3,2,3,0,0,3,5,60.0,2,3,3,0,0,3,2,0
João Novais,POR,MF,Rio Ave,31-099,1993,5.1,7,4,4,2,1,5,11,45.5,6,5,1,4,2,9,5,0
Samuel Obeng,GHA,FW,Casa Pia,27-155,1997,3.3,0,0,0,0,0,0,1,0.0,1,2,0,2,0,0,3,0
Guillermo Ochoa,MEX,GK,AVS Futebol,39-096,1985,4.0,0,0,0,0,0,0,0,,0,0,0,0,0,0,4,0
Lawrence Ofori,GHA,MF,Moreirense,26-111,1998,3.8,8,4,5,3,0,4,9,44.4,5,3,0,3,2,10,7,0
Nélson Oliveira,POR,FW,Vitória,33-070,1991,5.3,2,1,0,0,2,0,0,,0,1,0,1,1,3,1,0
Paulo Oliveira,POR,DF,Braga,32-283,1992,2.0,3,2,1,2,0,1,2,50.0,1,4,4,0,2,5,10,1
Talys Oliveira,BRA,DF,Farense,25-250,1999,2.8,6,2,2,3,1,3,6,50.0,3,3,0,3,3,9,6,0
Samu Omorodion,ESP,FW,Porto,20-165,2004,3.3,0,0,0,0,0,0,0,,0,0,0,0,0,0,0,0
Bruno Onyemaechi,NGA,DF,Boavista,25-197,1999,7.4,12,5,11,1,0,8,15,53.3,7,10,5,5,4,16,31,2
Jandro Orellana,ESP,MF,Estoril,24-071,2000,4.9,9,6,4,4,1,5,7,71.4,2,2,1,1,6,15,5,0
Nicolás Otamendi,ARG,DF,Benfica,36-248,1988,5.1,8,6,5,2,1,4,6,66.7,2,5,3,2,12,20,5,1
Amine El Ouazzani,MAR,FW,Braga,23-094,2001,3.6,4,2,2,1,1,2,3,66.7,1,5,0,5,1,5,2,0
Amine Oudrhiri,MAR,MF,Rio Ave,31-348,1992,6.4,8,7,6,1,1,4,10,40.0,6,12,5,7,13,21,6,0
Renato Pantalon,CRO,DF,Rio Ave,26-356,1997,7.0,10,5,7,3,0,7,9,77.8,2,7,4,3,12,22,27,2
Jonathan Panzo,ENG,DF,Rio Ave,23-358,2000,5.0,9,6,6,3,0,5,8,62.5,3,8,1,7,7,16,28,1
David Pastor,BRA,"DF,MF",Farense,24-240,2000,5.1,11,8,8,3,0,5,10,50.0,5,4,1,3,10,21,12,0
Patrick,BRA,DF,Rio Ave,27-136,1997,3.1,4,4,4,0,0,4,7,57.1,3,4,2,2,5,9,10,0
Vangelis Pavlidis,GRE,FW,Benfica,25-331,1998,6.4,4,3,0,1,3,1,4,25.0,3,5,0,5,3,7,1,0
Zé Pedro Figueiredo,POR,DF,Porto,27-133,1997,7.0,9,6,7,2,0,4,6,66.7,2,6,5,1,11,20,30,0
Daniel Penha,BRA,"MF,FW",Nacional,26-000,1998,2.8,7,4,2,5,0,5,9,55.6,4,2,0,2,1,8,2,0
Pepê,BRA,"FW,MF",Porto,27-236,1997,6.1,5,4,1,2,2,1,4,25.0,3,5,0,5,6,11,0,0
Pereira,POR,"FW,MF",Casa Pia,22-245,2002,1.3,0,0,0,0,0,0,0,,0,0,0,0,0,0,0,0
Francisco Pereira,POR,MF,Estoril,22-254,2002,0.1,0,0,0,0,0,0,0,,0,0,0,0,0,0,1,0
Matheus Pereira,BRA,FW,Santa Clara,23-301,2000,2.1,4,3,0,3,1,2,2,100.0,0,2,1,1,2,6,3,0
Sebastián Pérez Cardona,COL,MF,Boavista,31-202,1993,5.5,11,8,7,3,1,4,8,50.0,4,5,2,3,9,20,8,0
Nehuén Pérez,ARG,DF,Porto,24-115,2000,4.0,3,1,0,3,0,1,1,100.0,0,2,2,0,5,8,13,0
Petterson,BRA,"MF,FW",Estrela,20-287,2004,0.8,1,0,0,1,0,1,2,50.0,1,0,0,0,1,2,0,0
Lucas Piazon,BRA,"MF,FW",AVS Futebol,30-271,1994,6.4,14,9,3,10,1,7,12,58.3,5,9,0,9,4,18,3,0
Wagner Pina,CPV,DF,Estoril,21-349,2002,5.6,22,14,11,9,2,10,21,47.6,11,14,5,9,12,34,14,0
Rodrigo Pinheiro,POR,DF,Famalicão,22-050,2002,3.0,4,3,4,0,0,3,5,60.0,2,2,1,1,5,9,10,0
Rodrigo Pinho,BRA,FW,Estrela,33-140,1991,4.4,6,3,3,2,1,2,3,66.7,1,0,0,0,3,9,4,0
Alexandre Pinto,POR,"DF,FW",Arouca,26-101,1998,0.1,0,0,0,0,0,0,0,,0,0,0,0,0,0,1,0
Dinis Pinto,POR,DF,Moreirense,24-054,2000,1.7,6,4,4,2,0,4,6,66.7,2,0,0,0,2,8,3,0
Jaime Pinto,POR,MF,Farense,27-019,1997,0.4,0,0,0,0,0,0,2,0.0,2,1,1,0,0,0,0,0
João Pinto,POR,MF,Gil Vicente FC,22-047,2002,0.0,0,0,0,0,0,0,0,,0,0,0,0,0,0,0,0
Ole Pohlmann,GER,"FW,MF",Rio Ave,23-195,2001,3.7,9,3,1,3,5,5,7,71.4,2,4,1,3,0,9,2,0
Carlos Ponck,CPV,"DF,MF",Moreirense,29-278,1995,1.2,2,1,1,0,1,1,2,50.0,1,2,2,0,3,5,11,0
Boris Popović,SRB,DF,Arouca,24-234,2000,3.1,2,0,2,0,0,0,0,,0,6,4,2,2,4,10,1
Darío Poveda,ESP,"FW,MF",Farense,27-218,1997,2.9,1,1,0,1,0,0,3,0.0,3,0,0,0,0,1,2,0
Gianluca Prestianni,ARG,"MF,FW",Benfica,18-260,2006,3.0,3,2,1,0,2,2,7,28.6,5,5,0,5,0,3,2,0
Miguel Puche García,ESP,FW,Arouca,23-170,2001,0.1,0,0,0,0,0,0,0,,0,0,0,0,0,0,0,0
Quaresma,BRA,DF,Arouca,28-056,1996,0.7,1,0,0,1,0,0,0,,0,0,0,0,2,3,1,0
Eduardo Quaresma,POR,DF,Sporting CP,22-229,2002,4.3,10,5,4,4,2,5,5,100.0,0,0,0,0,1,11,9,0
Geovany Quenda,POR,"MF,DF",Sporting CP,17-170,2007,5.6,6,3,3,2,1,6,7,85.7,1,4,0,4,2,8,6,0
Jesús Ramírez,VEN,FW,Vitória,26-166,1998,2.7,3,3,1,0,2,0,2,0.0,2,0,0,0,0,3,2,0
João Rêgo,POR,FW,Benfica,19-119,2005,0.1,0,0,0,0,0,0,1,0.0,1,0,0,0,0,0,0,0
Francisco Reis Ferreira,POR,DF,Estrela,27-205,1997,2.0,2,1,2,0,0,2,3,66.7,1,4,2,2,3,5,13,0
Matheus Reis,BRA,"DF,MF",Sporting CP,29-242,1995,2.8,2,2,2,0,0,2,2,100.0,0,1,0,1,3,5,5,0
Tiago Reis,BRA,FW,Nacional,25-064,1999,2.2,1,0,1,0,0,0,0,,0,2,0,2,0,1,0,0
Miguel Reisinho,POR,MF,Boavista,25-191,1999,4.8,14,6,4,9,1,10,13,76.9,3,5,0,5,10,24,8,0
Marco Ribeiro,POR,MF,Boavista,19-125,2005,0.4,1,1,1,0,0,1,2,50.0,1,0,0,0,0,1,0,0
Rodrigo Ribeiro,POR,FW,Sporting CP,19-172,2005,0.0,0,0,0,0,0,0,0,,0,0,0,0,0,0,0,0
Rodrigo Ribeiro,POR,FW,AVS Futebol,19-172,2005,2.8,1,1,0,1,0,0,0,,0,1,1,0,1,2,5,0
Tomás Ribeiro,POR,DF,Vitória,25-170,1999,2.5,6,4,4,2,0,4,5,80.0,1,4,3,1,6,12,9,0
Yuri Ribeiro,POR,DF,Braga,27-267,1997,1.1,0,0,0,0,0,0,0,,0,2,1,1,0,0,4,0
Ricardinho,POR,FW,Santa Clara,26-072,1998,2.7,6,5,2,2,2,2,7,28.6,5,2,0,2,5,11,2,0
Riccieli,BRA,DF,Famalicão,26-030,1998,0.5,1,1,1,0,0,1,1,100.0,0,1,1,0,1,2,1,0
Omar Richards,ENG,"MF,DF",Rio Ave,26-245,1998,3.5,9,9,5,4,0,5,5,100.0,0,5,0,5,0,9,8,0
Rivaldo,,DF,Farense,24-029,2000,4.0,11,7,4,7,0,5,8,62.5,3,6,3,3,7,18,15,0
Pablo Roberto,BRA,"FW,MF",Casa Pia,24-338,1999,2.6,4,2,3,1,0,3,7,42.9,4,3,0,3,0,4,0,0
Joel Robles,ESP,GK,Estoril,34-122,1990,7.0,0,0,0,0,0,0,0,,0,0,0,0,0,0,4,0
Matí­as Rocha,URU,DF,Arouca,23-247,2001,2.9,4,3,3,1,0,3,3,100.0,0,2,1,1,0,4,12,0
Rochinha,POR,FW,Famalicão,29-167,1995,4.7,5,4,3,1,1,5,7,71.4,2,0,0,0,2,7,3,0
Afonso Rodrigues,POR,FW,Famalicão,22-059,2002,0.0,0,0,0,0,0,0,0,,0,1,0,1,0,0,0,0
Ivo Rodrigues,POR,"FW,MF",Arouca,29-201,1995,3.6,11,8,6,4,1,5,9,55.6,4,4,1,3,2,13,7,0
Luís Carlos Rocha Rodrigues,POR,DF,Santa Clara,38-065,1986,6.0,5,3,5,0,0,2,5,40.0,3,3,3,0,3,8,23,0
Rafael Rodrigues,POR,DF,AVS Futebol,22-233,2002,1.3,1,1,1,0,0,1,1,100.0,0,1,0,1,2,3,4,0
Ignacio Rodríguez,URU,DF,AVS Futebol,20-342,2003,0.1,0,0,0,0,0,0,0,,0,0,0,0,1,1,2,0
Benjamín Rollheiser,ARG,"MF,FW",Benfica,24-207,2000,1.2,4,4,0,3,1,2,4,50.0,2,1,0,1,0,4,0,0
Baptiste Roux,FRA,"DF,MF",AVS Futebol,24-326,1999,6.9,14,7,8,6,0,13,19,68.4,6,10,6,4,9,23,37,0
Alan Ruiz,ARG,"MF,FW",Estrela,31-059,1993,4.1,7,5,1,6,0,1,8,12.5,7,4,0,4,0,7,7,1
Gustavo sá,POR,MF,Famalicão,19-341,2004,5.7,9,7,5,3,1,1,6,16.7,5,6,0,6,3,12,3,1
Josué Sá,POR,DF,Gil Vicente FC,32-122,1992,0.4,0,0,0,0,0,0,0,,0,0,0,0,0,0,2,0
Safira,BRA,FW,Santa Clara,29-214,1995,6.1,5,3,1,1,3,2,6,33.3,4,2,0,2,2,7,6,0
Sala,ESP,FW,Estoril,21-160,2003,0.9,0,0,0,0,0,0,3,0.0,3,1,0,1,1,1,4,0
Samu,POR,MF,Vitória,28-179,1996,4.1,9,6,4,4,1,4,6,66.7,2,8,2,6,0,9,3,0
Renato Sanches,POR,MF,Benfica,27-060,1997,0.7,1,1,0,1,0,1,1,100.0,0,0,0,0,0,1,0,0
Caio Santana,BRA,"FW,MF",Estrela,20-209,2004,1.0,9,5,6,3,0,7,8,87.5,1,0,0,0,2,11,3,0
Aderlan Santos,BRA,DF,Rio Ave,35-191,1989,7.7,18,11,12,6,0,11,12,91.7,1,7,3,4,17,35,53,0
Bruno Santos,POR,FW,Farense,21-184,2003,0.2,0,0,0,0,0,0,0,,0,0,0,0,0,0,0,0
Gabriel Santos,BRA,"FW,MF",Nacional,25-215,1999,1.0,2,1,1,0,1,0,1,0.0,1,1,0,1,0,2,0,0
Léo Santos,BRA,DF,Nacional,25-313,1998,2.2,1,0,1,0,0,1,2,50.0,1,3,2,1,0,1,12,1
Nuno Santos,POR,"MF,DF",Sporting CP,29-247,1995,3.4,3,0,0,1,2,2,3,66.7,1,4,0,4,4,7,4,0
Nuno Santos,POR,"MF,FW",Vitória,25-229,1999,4.1,9,7,3,2,4,7,9,77.8,2,2,0,2,3,12,4,0
Pedro Santos,POR,"MF,FW",Arouca,24-005,2000,2.1,7,7,3,3,1,3,10,30.0,7,2,1,1,0,7,3,0
Pedro Santos,POR,"MF,FW",Moreirense,21-250,2003,2.0,3,2,1,2,0,1,5,20.0,4,1,0,1,2,5,2,0
Guilherme Schettine,BRA,FW,Moreirense,29-007,1995,1.6,2,2,0,2,0,0,1,0.0,1,3,0,3,0,2,0,0
Andreas Schjelderup,NOR,FW,Benfica,20-138,2004,0.2,0,0,0,0,0,0,1,0.0,1,0,0,0,0,0,0,0
Telasco Segovia,VEN,MF,Casa Pia,21-198,2003,3.3,7,5,2,4,1,3,10,30.0,7,1,1,0,2,9,3,0
Patrick Sequeira,CRC,GK,Casa Pia,25-230,1999,7.0,0,0,0,0,0,0,0,,0,0,0,0,0,0,6,0
Serginho,POR,"MF,FW",Santa Clara,24-321,1999,0.6,0,0,0,0,0,0,0,,0,1,0,1,1,1,1,0
Sidney,BRA,DF,Santa Clara,27-274,1997,8.0,18,13,12,3,3,10,12,83.3,2,11,6,5,13,31,31,0
Alysson Silva,BRA,DF,Santa Clara,22-021,2002,1.8,2,2,2,0,0,1,1,100.0,0,0,0,0,0,2,2,0
António Silva,POR,DF,Benfica,20-353,2003,5.0,11,5,5,4,2,6,8,75.0,2,6,4,2,5,16,13,0
Gustavo da Silva,BRA,"FW,MF",Vitória,25-138,1999,1.8,4,2,3,0,1,3,3,100.0,0,7,2,5,1,5,7,0
Joel silva,POR,"MF,DF",Boavista,21-249,2003,7.6,19,15,9,6,4,11,33,33.3,22,9,2,7,11,30,15,0
Luís Manuel Costa Silva,POR,MF,AVS Futebol,32-018,1992,1.0,1,1,1,0,0,0,0,,0,1,1,0,0,1,0,0
Raul Silva,BRA,DF,Farense,34-348,1989,2.8,4,2,1,2,1,3,4,75.0,1,4,2,2,2,6,12,0
Tiago Silva,POR,MF,Vitória,31-137,1993,6.2,10,3,4,4,2,5,6,83.3,1,5,2,3,3,13,9,0
Tomás Silva,POR,"DF,MF",Boavista,18-145,2006,0.4,0,0,0,0,0,0,0,,0,0,0,0,0,0,1,0
David Simão,POR,MF,Arouca,34-155,1990,7.0,12,8,3,6,3,5,10,50.0,5,10,2,8,6,18,3,0
Sphephelo Sithole,RSA,"FW,MF",Gil Vicente FC,25-228,1999,0.6,2,2,2,0,0,2,3,66.7,1,1,1,0,0,2,1,0
Filipe Soares,POR,MF,Farense,25-150,1999,2.3,1,1,0,1,0,0,1,0.0,1,0,0,0,2,3,1,0
Lucas Soares,BRA,MF,Santa Clara,26-166,1998,4.6,8,6,4,4,0,3,6,50.0,3,3,1,2,6,14,6,0
Rafa Soares,POR,DF,Famalicão,29-161,1995,1.5,5,3,4,1,0,4,4,100.0,0,1,0,1,0,5,3,0
Djibril Soumaré,SEN,MF,Nacional,21-284,2003,1.0,8,6,6,2,0,4,4,100.0,0,3,3,0,2,10,4,0
André Sousa,POR,"MF,DF",Nacional,34-100,1990,0.6,0,0,0,0,0,0,1,0.0,1,4,2,2,0,0,1,0
Dyego Sousa,POR,FW,Nacional,35-033,1989,0.3,0,0,0,0,0,0,0,,0,0,0,0,0,0,0,0
Miguel Sousa,POR,MF,Casa Pia,26-028,1998,4.3,6,2,0,4,2,2,4,50.0,2,8,1,7,1,7,5,0
Vasco Sousa,POR,MF,Porto,21-197,2003,3.4,12,8,6,6,0,7,10,70.0,3,2,0,2,2,14,1,1
Gabriel Airton de Souza,BRA,FW,Moreirense,28-202,1996,4.8,6,4,2,4,0,2,7,28.6,5,4,0,4,2,8,1,0
Max Svensson,ESP,FW,Casa Pia,,,3.6,3,2,1,1,1,3,9,33.3,6,2,0,2,1,4,0,0
Morlaye Sylla,GUI,FW,Arouca,26-082,1998,6.6,8,6,3,4,1,1,10,10.0,9,9,0,9,0,8,3,0
Sidnei Tavares,POR,MF,Moreirense,23-018,2001,4.1,10,5,6,4,0,2,8,25.0,6,2,1,1,3,13,6,0
Duplexe Tchamba,CMR,DF,Casa Pia,26-099,1998,3.8,9,5,5,3,1,3,5,60.0,2,5,4,1,8,17,9,0
João Teixeira,POR,MF,Gil Vicente FC,30-254,1994,0.5,3,3,0,2,1,0,1,0.0,1,1,0,1,1,4,0,0
Jorge Teixeira,POR,"DF,FW",AVS Futebol,38-051,1986,1.6,1,0,1,0,0,1,1,100.0,0,2,0,2,1,2,9,0
Nigel Thomas,NED,"FW,MF",Nacional,23-259,2001,3.6,3,2,2,1,0,1,7,14.3,6,4,0,4,1,4,4,0
Demir Tıknaz,TUR,MF,Rio Ave,20-061,2004,0.9,4,2,2,1,1,2,4,50.0,2,1,1,0,0,4,0,0
Tomané,POR,FW,Farense,31-360,1992,4.0,3,1,1,2,0,1,2,50.0,1,3,0,3,0,3,7,0
Tomé,POR,GK,Boavista,17-306,2006,2.0,0,0,0,0,0,0,0,,0,0,0,0,0,0,2,0
João Tomé,POR,"MF,DF",Rio Ave,21-248,2003,2.1,5,2,5,0,0,1,3,33.3,2,1,1,0,1,6,11,0
Mirko Topić,SRB,MF,Famalicão,23-255,2001,7.8,20,13,8,11,1,5,11,45.5,6,11,2,9,13,33,18,0
Diogo Travassos,POR,DF,Estrela,20-200,2004,3.3,3,2,1,2,0,0,2,0.0,2,5,1,4,3,6,2,0
Alfonso Trezza,URU,"FW,MF",Arouca,25-117,1999,4.7,8,6,4,3,1,2,7,28.6,5,7,1,6,1,9,8,0
Francisco Trincão,POR,"FW,MF",Sporting CP,24-293,1999,7.5,12,10,1,7,4,3,7,42.9,4,6,0,6,0,12,3,0
Anatolii Trubin,UKR,GK,Benfica,23-077,2001,7.0,0,0,0,0,0,0,0,,0,0,0,0,0,0,1,1
Ulisses,BRA,DF,Nacional,25-019,1999,4.7,6,2,5,1,0,3,4,75.0,1,5,3,2,3,9,21,0
Alan Varela,ARG,MF,Porto,23-105,2001,7.7,13,6,4,8,1,8,10,80.0,2,3,1,2,5,18,11,0
Bruno Varela,CPV,GK,Vitória,29-348,1994,8.0,0,0,0,0,0,0,0,,0,0,0,0,0,0,2,1
Nilton Varela,POR,DF,Estrela,23-145,2001,6.8,20,13,10,8,2,10,13,76.9,3,6,1,5,6,26,21,1
Danilo Veiga,POR,DF,Estrela,22-022,2002,5.4,11,7,5,5,1,6,11,54.5,5,9,3,6,5,16,24,1
Eric Veiga,LUX,"MF,FW",AVS Futebol,27-242,1997,1.6,0,0,0,0,0,0,0,,0,2,1,1,0,0,0,0
Jhon Velásquez,COL,"FW,MF",Farense,29-168,1995,0.2,0,0,0,0,0,0,0,,0,1,0,1,0,0,0,0
Ricardo Velho,POR,GK,Farense,26-058,1998,8.0,0,0,0,0,0,0,0,,0,0,0,0,0,0,6,0
Frederico Venâncio,POR,DF,Santa Clara,31-256,1993,8.0,13,6,9,2,2,3,6,50.0,3,3,1,2,13,26,35,0
Paulo Victor,BRA,"DF,MF",Farense,23-187,2001,0.8,6,4,1,3,2,4,5,80.0,1,2,0,2,2,8,3,0
Fabio Vieira,POR,"FW,MF",Porto,24-140,2000,0.5,0,0,0,0,0,0,0,,0,0,0,0,1,1,0,0
Gabriel Vieira,BRA,FW,Santa Clara,22-209,2002,7.0,6,6,3,2,1,3,8,37.5,5,6,0,6,1,7,2,0
Mikel Villanueva,VEN,DF,Vitória,31-186,1993,4.0,5,3,3,2,0,4,7,57.1,3,2,1,1,0,5,13,0
Marcos Vinicios Sorriso,BRA,FW,Famalicão,23-237,2001,5.3,14,7,6,5,3,6,13,46.2,7,7,1,6,3,17,3,0
Vinícius,BRA,FW,Santa Clara,25-163,1999,5.4,10,7,0,5,5,5,7,71.4,2,5,0,5,3,13,3,0
Bernardo Vital,POR,MF,Estoril,23-293,2000,0.3,2,1,1,0,1,0,1,0.0,1,1,1,0,0,2,0,0
Zé Vitor,BRA,DF,Nacional,23-251,2001,7.0,7,3,5,2,0,3,5,60.0,2,6,4,2,11,18,47,2
Marious Vrousai,GRE,"MF,DF",Rio Ave,26-107,1998,8.0,20,12,14,4,2,11,20,55.0,9,10,0,10,8,28,26,1
Ilija Vukotić,MNE,MF,Boavista,25-284,1999,6.0,15,10,1,10,4,6,11,54.5,5,11,4,7,6,21,8,0
Wendell,BRA,DF,Porto,31-089,1993,0.3,0,0,0,0,0,0,0,,0,0,0,0,0,0,0,0
Weverson,BRA,DF,Arouca,24-104,2000,3.1,2,2,0,2,0,1,3,33.3,2,4,1,3,2,4,5,1
Xeka,POR,MF,Estoril,29-342,1994,1.4,4,1,2,2,0,4,4,100.0,0,0,0,0,5,9,4,0
Güven Yalçın,TUR,"FW,MF",Arouca,25-273,1999,1.6,4,3,1,1,2,0,3,0.0,3,1,0,1,1,5,0,0
Zaydou Youssouf,FRA,MF,Famalicão,25-098,1999,7.8,20,15,7,12,1,11,16,68.8,5,6,1,5,7,27,3,0
Yassir Zabiri,MAR,"FW,MF",Famalicão,19-237,2005,0.5,2,1,0,2,0,1,2,50.0,1,1,0,1,0,2,0,0
Rodrigo Zalazar,URU,"MF,FW",Braga,25-066,1999,3.7,4,2,1,3,0,0,2,0.0,2,2,0,2,0,4,1,0
Vinícius Zanocelo,BRA,MF,Estoril,23-261,2001,8.0,11,3,4,7,0,8,22,36.4,14,11,4,7,8,19,16,0
Ivan Zlobin,RUS,GK,Famalicão,27-224,1997,7.0,0,0,0,0,0,0,0,,0,0,0,0,0,0,5,0
Nermin Zolotić,BIH,DF,Casa Pia,31-102,1993,4.0,10,4,8,2,0,6,7,85.7,1,5,5,0,4,14,11,1
