Player,Nation,Pos,Squad,Age,Born,90s,Tackles,TacklesWon,TacklesDef3rd,TacklesMid3rd,TacklesAtt3rd,DribTkl,DribTklAtt,DribTkl%,ChallengesLost,Blocks,ShotsBlocked,PassesBlocked,Int,Tkl+Int,Clr,ErrorsLeadingToShot
Rodrigo Abascal,URU,DF,Boavista,30-298,1994,8.0,11,4,8,2,1,5,10,50.0,5,9,6,3,12,23,43,1
Bilal Abdelrahman Zeeni,EGY,MF,Estrela,21-291,2003,0.1,1,1,0,0,1,0,0,,0,0,0,0,0,1,1,0
Giorgi Aburjania,GEO,MF,AVS Futebol,29-310,1995,3.2,10,6,3,6,1,6,11,54.5,5,2,0,2,3,13,4,0
Adriano,BRA,MF,Santa Clara,25-003,1999,8.0,9,7,4,4,1,3,10,30.0,7,4,0,4,2,11,10,0
Lucas Áfrico,BRA,DF,Farense,29-276,1995,7.8,9,7,4,4,1,5,8,62.5,3,12,9,3,6,15,35,0
Salvador Agra,POR,"MF,DF",Boavista,32-362,1991,10.0,7,5,1,2,4,3,9,33.3,6,4,1,3,4,11,4,0
Brandon Aguilera,CRC,"MF,FW",Rio Ave,21-132,2003,2.3,10,6,4,3,3,4,4,100.0,0,1,0,1,1,11,0,0
Jorge Aguirre,ESP,FW,Gil Vicente FC,24-307,2000,4.3,1,0,0,1,0,1,4,25.0,3,2,0,2,0,1,3,0
Babatunde Akinsola,NGA,"FW,MF",AVS Futebol,21-242,2003,2.7,3,3,2,1,0,2,3,66.7,1,3,0,3,2,5,2,0
Kerem Aktürkoğlu,TUR,"FW,MF",Benfica,26-017,1998,3.8,3,3,1,1,1,1,3,33.3,2,2,0,2,1,4,1,0
Léo Alaba,BRA,DF,AVS Futebol,25-129,1999,3.7,6,5,3,2,1,3,9,33.3,6,5,1,4,7,13,10,0
Alan,BRA,MF,Moreirense,24-244,2000,7.6,7,2,1,4,2,3,9,33.3,6,5,1,4,2,9,1,0
Gonçalo Almeida,POR,"DF,MF",Boavista,21-185,2003,2.2,6,4,2,3,1,4,10,40.0,6,3,0,3,6,12,5,0
Pedro Álvaro,POR,DF,Estoril,24-250,2000,10.0,7,3,3,4,0,2,4,50.0,2,13,8,5,13,20,57,0
Pedro Amaral,POR,DF,Estoril,27-074,1997,9.1,11,5,6,3,2,8,16,50.0,8,6,2,4,7,18,23,0
Zeki Amdouni,SUI,"MF,FW",Benfica,23-339,2000,1.2,1,1,0,1,0,0,0,,0,1,0,1,1,2,1,0
Artur Jorge Marques Amorim,POR,DF,Farense,30-085,1994,6.5,7,5,7,0,0,5,6,83.3,1,6,4,2,8,15,42,1
Andrew,BRA,GK,Gil Vicente FC,23-129,2001,10.0,1,1,1,0,0,1,2,50.0,1,0,0,0,0,1,0,2
Jeremy Antonisse,CUW,"FW,MF",Moreirense,22-223,2002,3.2,6,2,1,5,0,4,7,57.1,3,4,0,4,1,7,8,0
Arvin Appiah,ENG,"FW,MF",Nacional,23-307,2001,4.6,6,5,2,3,1,4,6,66.7,2,2,0,2,5,11,3,0
Óscar Aranda,ESP,FW,Famalicão,22-192,2002,8.9,5,4,1,3,1,3,5,60.0,2,4,0,4,1,6,5,0
Henrique Araújo,POR,FW,Arouca,22-293,2002,3.9,1,0,0,1,0,0,1,0.0,1,2,1,1,0,1,0,0
Maximiliano Araújo,URU,"MF,DF",Sporting CP,24-266,2000,3.1,6,2,1,1,4,1,3,33.3,2,2,0,2,2,8,2,0
Tomás Araújo,POR,DF,Benfica,22-175,2002,6.9,17,11,13,3,1,9,13,69.2,4,5,1,4,8,25,11,0
Telmo Arcanjo,CPV,FW,Vitória,23-139,2001,2.0,2,1,1,1,0,1,3,33.3,2,0,0,0,1,3,0,0
Bright Arrey-Mbi,GER,DF,Braga,21-226,2003,4.6,6,3,2,2,2,3,5,60.0,2,8,5,3,4,10,11,0
Gustavo Assuncao,POR,MF,AVS Futebol,24-222,2000,5.2,14,10,9,5,0,9,19,47.4,10,3,2,1,3,17,6,0
Otavio Ataide,BRA,DF,Porto,22-200,2002,5.0,5,2,3,2,0,4,7,57.1,3,2,2,0,5,10,8,1
João Aurélio,POR,DF,Nacional,36-082,1988,0.0,0,0,0,0,0,0,0,,0,0,0,0,0,0,0,0
Fredrik Aursnes,NOR,"MF,FW",Benfica,28-333,1995,6.0,11,7,1,6,4,5,13,38.5,8,6,1,5,1,12,4,0
Miguel Baeza,ESP,"MF,FW",Nacional,24-225,2000,2.3,2,2,1,1,0,1,2,50.0,1,1,0,1,0,2,1,0
Alexander Bah,DEN,DF,Benfica,26-334,1997,6.4,26,18,9,11,6,20,29,69.0,9,11,1,10,5,31,4,0
Elves Baldé,GNB,"MF,FW",Farense,25-036,1999,3.0,5,3,2,3,0,1,4,25.0,3,0,0,0,0,5,4,0
Robson Bambu,BRA,DF,Braga,26-361,1997,2.0,5,1,2,3,0,2,2,100.0,0,5,4,1,1,6,3,1
Simon Banza,COD,FW,Braga,28-086,1996,0.2,0,0,0,0,0,0,0,,0,0,0,0,0,0,0,0
Rafael Barbosa,POR,"MF,FW",Farense,28-223,1996,3.7,1,1,0,1,0,0,2,0.0,2,4,0,4,2,3,0,0
Leandro Barreiro Martins,LUX,MF,Benfica,24-309,2000,3.7,15,6,2,9,4,5,10,50.0,5,5,0,5,3,18,0,0
Gil Bastião Dias,POR,FW,Famalicão,28-040,1996,4.5,11,7,3,6,2,5,12,41.7,7,4,0,4,2,13,8,0
Gabriel Batista,BRA,GK,Santa Clara,26-157,1998,10.0,1,0,1,0,0,0,0,,0,0,0,0,0,1,5,0
Ricardo Batista,POR,GK,Casa Pia,37-354,1986,1.0,0,0,0,0,0,0,0,,0,0,0,0,0,0,2,0
Yanis Begraoui,MAR,FW,Estoril,23-126,2001,6.3,3,1,0,3,0,0,2,0.0,2,4,1,3,3,6,5,0
Gui Beleza,POR,MF,Gil Vicente FC,17-334,2006,0.0,0,0,0,0,0,0,0,,0,0,0,0,0,0,0,0
Bachir Belloumi,ALG,FW,Farense,22-159,2002,3.0,8,5,3,4,1,4,7,57.1,3,8,2,6,3,11,2,0
Fahem Benaissa Yahia,FRA,DF,Casa Pia,22-192,2002,0.0,0,0,0,0,0,0,0,,0,0,0,0,0,0,0,0
Beni,ANG,MF,Casa Pia,22-170,2002,4.2,8,6,3,5,0,3,5,60.0,2,2,0,2,5,13,6,0
Álex Bermejo,ESP,"MF,FW",Farense,25-332,1998,4.1,3,2,0,2,1,2,9,22.2,7,1,0,1,1,4,4,0
Simão Bertelli,BRA,GK,AVS Futebol,31-158,1993,4.0,0,0,0,0,0,0,0,,0,0,0,0,0,0,0,1
Jan-Niklas Beste,GER,"FW,DF",Benfica,25-308,1999,2.6,5,5,1,1,3,2,4,50.0,2,2,0,2,2,7,2,0
José Bica,POR,"MF,FW",Vitória,21-144,2003,0.0,0,0,0,0,0,0,0,,0,0,0,0,0,0,0,0
Raúl Blanco,ESP,FW,Casa Pia,23-099,2001,2.8,3,2,0,1,2,2,5,40.0,3,2,1,1,2,5,1,0
Kévin Boma,TOG,DF,Estoril,21-353,2002,6.0,9,7,8,1,0,5,9,55.6,4,7,5,2,8,17,28,1
Kiko Bondoso,POR,"FW,MF",Rio Ave,28-356,1995,6.2,9,6,5,1,3,2,5,40.0,3,3,0,3,4,13,0,0
Toni Borevkovic,CRO,DF,Vitória,27-142,1997,9.0,12,6,9,3,0,6,7,85.7,1,9,7,2,12,24,38,0
Gonçalo Borges,POR,FW,Porto,23-223,2001,1.5,1,1,0,0,1,0,1,0.0,1,2,0,2,0,1,0,0
Róbert Boženík,SVK,FW,Boavista,24-355,1999,9.9,3,2,0,1,2,1,2,50.0,1,5,0,5,2,5,12,0
Daniel Bragança,POR,MF,Sporting CP,25-164,1999,7.1,14,7,4,6,4,9,15,60.0,6,8,0,8,3,17,6,0
Bruno Brigido,BRA,GK,Estrela,33-243,1991,10.0,0,0,0,0,0,0,0,,0,0,0,0,0,0,7,1
Rafael Brito,POR,MF,Casa Pia,22-293,2002,2.8,7,4,5,1,1,4,4,100.0,0,5,3,2,3,10,7,0
Bruma,POR,"FW,MF",Braga,30-014,1994,4.8,2,2,0,1,1,1,4,25.0,3,3,0,3,1,3,1,0
Jonathan Buatu Mananga,ANG,DF,Gil Vicente FC,31-041,1993,10.0,14,8,9,5,0,9,12,75.0,3,15,11,4,11,25,42,1
Leonel Bucca,ARG,"MF,FW",Estrela,25-232,1999,5.4,15,7,5,9,1,9,14,64.3,5,9,4,5,7,22,8,0
Adrián Butzke,ESP,FW,Nacional,25-222,1999,4.5,4,2,0,4,0,2,4,50.0,2,2,0,2,3,7,5,0
Arthur Cabral,BRA,FW,Benfica,26-196,1998,1.0,2,1,0,1,1,0,0,,0,2,0,2,0,2,1,0
Jovane Cabral,CPV,"FW,MF",Estrela,26-146,1998,3.5,8,6,3,3,2,3,8,37.5,5,4,1,3,3,11,1,0
Lucas Calegari,BRA,DF,Famalicão,22-254,2002,9.5,26,14,15,11,0,11,16,68.8,5,9,4,5,4,30,20,0
Diogo Calila,POR,"MF,DF",Santa Clara,26-028,1998,5.3,11,5,6,3,2,5,6,83.3,1,6,0,6,1,12,12,0
Ibrahima Camará,GUI,MF,Boavista,25-287,1999,7.4,10,6,2,7,1,7,13,53.8,6,8,0,8,11,21,23,0
André Candeias,POR,"FW,MF",Farense,21-292,2003,0.4,0,0,0,0,0,0,0,,0,0,0,0,0,0,0,0
Zé Carlos,POR,MF,Vitória,23-008,2001,0.2,4,2,1,3,0,3,3,100.0,0,0,0,0,1,5,1,0
Zé Carlos,POR,DF,Gil Vicente FC,26-099,1998,8.6,14,9,8,4,2,11,19,57.9,8,8,5,3,23,37,35,2
Álvaro Carreras,ESP,DF,Benfica,21-229,2003,8.1,18,11,7,9,2,10,15,66.7,5,7,1,6,11,29,18,0
João Carvalho,POR,"FW,MF",Estoril,27-243,1997,4.3,2,1,1,0,1,1,4,25.0,3,2,0,2,0,2,4,0
Pedro Carvalho,POR,DF,Estoril,21-267,2003,2.9,4,2,1,3,0,1,5,20.0,4,1,0,1,5,9,11,0
Vitor Carvalho,BRA,MF,Braga,27-164,1997,9.4,20,15,5,14,1,11,19,57.9,8,9,2,7,14,34,17,0
Cassiano,BRA,FW,Casa Pia,35-144,1989,3.9,7,3,4,2,1,2,5,40.0,3,4,0,4,1,8,4,0
Jesús Castillo,PER,MF,Gil Vicente FC,23-149,2001,5.8,11,6,3,7,1,8,16,50.0,8,8,3,5,7,18,11,0
André Castro,POR,MF,Moreirense,36-219,1988,0.2,0,0,0,0,0,0,0,,0,0,0,0,0,0,0,0
Cristian Castro,COL,DF,AVS Futebol,23-287,2001,9.9,7,5,5,0,2,5,9,55.6,4,5,2,3,9,16,58,2
Geny Catamo,MOZ,"MF,DF",Sporting CP,23-286,2001,6.4,10,5,3,4,3,8,13,61.5,5,7,0,7,3,13,8,0
Cauê,BRA,FW,Gil Vicente FC,21-357,2002,5.3,4,1,1,2,1,0,1,0.0,1,6,1,5,2,6,8,0
César,BRA,GK,Boavista,32-285,1992,4.0,0,0,0,0,0,0,0,,0,0,0,0,0,0,1,0
Tidjany Chabrol,FRA,FW,Gil Vicente FC,22-115,2002,3.7,6,4,3,3,0,4,8,50.0,4,3,0,3,0,6,5,0
Till Cissokho,FRA,DF,Estrela,24-273,2000,4.0,1,0,1,0,0,0,1,0.0,1,0,0,0,2,3,12,1
Clayton,BRA,DF,AVS Futebol,24-217,2000,2.0,0,0,0,0,0,0,3,0.0,3,5,1,4,1,1,7,0
Clayton,BRA,FW,Rio Ave,25-301,1999,9.6,4,1,0,3,1,1,6,16.7,5,3,1,2,1,5,7,0
Diego Collado,ESP,"MF,FW",Gil Vicente FC,23-303,2001,0.2,0,0,0,0,0,0,0,,0,0,0,0,1,1,0,0
Fábio Conceição,POR,"DF,MF",Rio Ave,23-193,2001,3.2,7,5,3,2,2,3,8,37.5,5,3,1,2,2,9,4,0
Leo Cordeiro,BRA,MF,Estrela,29-041,1995,8.5,11,7,3,7,1,6,15,40.0,9,16,3,13,3,14,4,1
Félix Correia,POR,"FW,MF",Gil Vicente FC,23-290,2001,9.9,11,7,6,5,0,7,14,50.0,7,6,0,6,14,25,17,0
Alberto costa,POR,DF,Vitória,21-039,2003,1.5,0,0,0,0,0,0,1,0.0,1,4,0,4,1,1,9,0
Bruno Xavier Almeida Costa,POR,"MF,FW",Nacional,27-202,1997,2.1,1,0,1,0,0,1,5,20.0,4,3,1,2,0,1,0,0
Diogo Costa,POR,GK,Porto,25-049,1999,10.0,0,0,0,0,0,0,1,0.0,1,0,0,0,0,0,1,0
Gonçalo Costa,POR,DF,Estoril,24-263,2000,0.3,0,0,0,0,0,0,1,0.0,1,1,0,1,0,0,2,0
Hélder Costa,ANG,FW,Estoril,30-300,1994,2.3,2,0,1,0,1,1,5,20.0,4,1,0,1,0,2,0,0
João Costa,POR,FW,Santa Clara,24-245,2000,1.4,3,1,1,1,1,2,3,66.7,1,1,0,1,0,3,1,0
Michel Costa,BRA,MF,Estoril,22-323,2001,6.6,8,3,2,5,1,1,9,11.1,8,12,3,9,7,15,9,0
Sandro Cruz,ANG,DF,Gil Vicente FC,23-179,2001,7.8,15,7,7,5,3,9,16,56.3,7,8,2,6,8,23,22,0
Augusto Dabo,POR,DF,Boavista,20-239,2004,1.0,1,0,0,0,1,1,2,50.0,1,2,1,1,0,1,6,0
Amadou Dante,MLI,"DF,MF",Arouca,24-031,2000,5.6,14,9,11,2,1,9,18,50.0,9,7,1,6,8,22,11,1
Mathias De Amorim,FRA,MF,Famalicão,19-333,2004,1.0,1,1,0,0,1,0,2,0.0,2,0,0,0,3,4,1,0
Zeno Debast,BEL,DF,Sporting CP,21-014,2003,6.3,10,8,5,5,0,5,7,71.4,2,6,2,4,5,15,7,0
Depú,ANG,FW,Gil Vicente FC,24-304,2000,0.5,0,0,0,0,0,0,0,,0,0,0,0,0,0,0,0
Derick,BRA,"DF,MF",Farense,31-067,1993,4.3,3,0,0,2,1,0,8,0.0,8,10,1,9,2,5,12,0
Ángel Di María,ARG,FW,Benfica,36-267,1988,5.6,7,3,2,1,4,2,7,28.6,5,4,0,4,2,9,0,0
Matheus Dias,BRA,MF,Nacional,27-274,1997,8.2,31,19,18,11,2,14,27,51.9,13,16,6,10,13,44,27,3
Tiago Dias,POR,FW,Casa Pia,26-187,1998,0.3,1,0,0,1,0,0,1,0.0,1,0,0,0,0,1,0,0
Ousmane Diomande,CIV,DF,Sporting CP,20-339,2003,7.8,11,6,5,6,0,6,9,66.7,3,2,1,1,8,19,17,1
Tiago Djaló,POR,DF,Porto,24-212,2000,2.0,3,1,2,1,0,1,1,100.0,0,1,1,0,1,4,5,1
Maxime Dominguez,SUI,MF,Gil Vicente FC,28-280,1996,2.8,8,3,4,4,0,3,4,75.0,1,3,0,3,3,11,1,0
Issiar Dramé,MLI,DF,Estrela,25-265,1999,2.8,4,3,4,0,0,2,3,66.7,1,1,0,1,8,12,14,1
Dudu,BRA,"FW,MF",Nacional,25-089,1999,0.3,1,0,1,0,0,1,1,100.0,0,0,0,0,0,1,0,0
Marcus Edwards,ENG,"FW,MF",Sporting CP,25-340,1998,0.7,0,0,0,0,0,0,0,,0,0,0,0,0,0,1,0
Ricardo Esgaio,POR,"FW,DF",Sporting CP,31-175,1993,0.3,0,0,0,0,0,0,0,,0,0,0,0,0,0,1,0
Tiago Esgaio,POR,"DF,MF",Arouca,29-098,1995,9.9,30,17,19,9,2,16,22,72.7,6,15,5,10,14,44,40,0
Dario Essugo,POR,MF,Sporting CP,19-238,2005,0.2,0,0,0,0,0,0,0,,0,0,0,0,0,0,0,0
Luís Esteves,POR,MF,Nacional,26-212,1998,8.9,11,8,5,6,0,7,21,33.3,14,9,2,7,6,17,4,1
Stephen Eustáquio,CAN,MF,Porto,27-322,1996,3.5,10,5,2,6,2,4,7,57.1,3,9,0,9,4,14,3,0
Evanilson,BRA,FW,Porto,25-032,1999,0.1,1,0,0,1,0,0,0,,0,0,0,0,0,1,0,0
Fabiano,BRA,DF,Moreirense,24-238,2000,6.3,9,7,7,1,1,7,9,77.8,2,7,2,5,8,17,20,1
Claudio Falcão,BRA,"MF,DF",Farense,30-127,1994,9.7,41,23,18,19,4,16,26,61.5,10,14,5,9,13,54,26,1
Jorge Filipe Oliveira Fernandes,POR,DF,Vitória,27-219,1997,1.5,0,0,0,0,0,0,1,0.0,1,0,0,0,3,3,7,0
Martim Fernandes,POR,DF,Porto,18-294,2006,6.1,13,6,6,6,1,5,12,41.7,7,11,1,10,7,20,4,0
Mateus Fernandes,POR,"FW,MF",Sporting CP,20-120,2004,0.3,1,0,0,0,1,1,1,100.0,0,0,0,0,0,1,0,0
Roger Fernandes,GNB,"FW,MF",Braga,18-352,2005,6.0,10,3,3,7,0,3,7,42.9,4,4,0,4,2,12,4,0
Rúben Fernandes,POR,DF,Gil Vicente FC,38-185,1986,9.8,6,4,2,4,0,5,7,71.4,2,8,5,3,14,20,40,0
Roberto Férnandez,ESP,FW,Braga,22-127,2002,4.4,3,1,0,1,2,2,4,50.0,2,3,0,3,0,3,1,0
João Ferreira Barros,POR,"MF,FW",Boavista,18-302,2006,1.1,5,3,3,1,1,2,5,40.0,3,1,0,1,1,6,1,0
Filipe Ferreira,POR,DF,Boavista,34-041,1990,9.5,10,8,4,4,2,5,10,50.0,5,7,4,3,11,21,31,1
Fernando Ferreira Fonseca,POR,DF,AVS Futebol,27-238,1997,6.3,13,8,8,1,4,11,17,64.7,6,11,2,9,12,25,12,0
João Ferreira,POR,DF,Braga,23-230,2001,5.3,12,8,5,7,0,6,7,85.7,1,7,6,1,7,19,18,0
Marcelo dos Santos Ferreira,BRA,DF,Moreirense,35-103,1989,10.0,19,11,15,4,0,9,12,75.0,3,16,13,3,10,29,61,0
Pedro Ferreira,POR,MF,Santa Clara,26-307,1998,8.6,35,21,11,16,8,8,14,57.1,6,15,0,15,16,51,10,0
Tiago Ferreira,POR,FW,Estrela,22-234,2002,0.4,3,2,0,1,2,0,0,,0,0,0,0,1,4,0,0
Daniel Figueira,POR,GK,Estoril,26-110,1998,1.0,0,0,0,0,0,0,0,,0,0,0,0,0,0,0,0
Tiago Fonseca Morais,POR,"FW,MF",Rio Ave,21-065,2003,5.3,6,4,1,2,3,2,6,33.3,4,7,2,5,3,9,1,0
José Fontán,ESP,DF,Arouca,24-270,2000,6.9,6,3,5,1,0,3,9,33.3,6,13,10,3,4,10,25,0
José Fonte,POR,DF,Casa Pia,40-321,1983,6.0,7,5,6,0,1,1,2,50.0,1,6,4,2,7,14,26,3
Lucas França,BRA,GK,Nacional,28-293,1996,9.0,0,0,0,0,0,0,0,,0,0,0,0,0,0,5,0
André Franco,POR,"FW,MF",Porto,26-209,1998,1.1,1,1,0,1,0,0,2,0.0,2,0,0,0,3,4,1,0
Afonso freitas,POR,DF,Nacional,24-214,2000,0.2,0,0,0,0,0,0,0,,0,0,0,0,0,0,3,0
Iván Fresneda,ESP,DF,Sporting CP,20-040,2004,0.5,1,1,0,1,0,0,0,,0,0,0,0,1,2,0,0
Godfried Frimpong,NED,DF,Moreirense,25-109,1999,10.0,14,10,8,6,0,9,11,81.8,2,9,2,7,13,27,46,0
Kanya Fujimoto,JPN,"MF,FW",Gil Vicente FC,25-129,1999,9.0,3,1,2,0,1,1,6,16.7,5,6,2,4,5,8,7,0
Taichi Fukui,JPN,MF,Arouca,20-115,2004,9.4,15,10,3,10,2,7,15,46.7,8,9,6,3,12,27,17,0
Tiago Gabriel,POR,DF,Estrela,19-317,2004,4.9,9,7,7,2,0,5,7,71.4,2,5,3,2,9,18,20,2
Galeno,BRA,"DF,FW",Porto,27-016,1997,7.9,7,3,4,0,3,4,7,57.1,3,10,3,7,8,15,11,0
Nino Galović,CRO,DF,Arouca,32-124,1992,1.0,0,0,0,0,0,0,0,,0,2,2,0,1,1,2,0
García,BRA,DF,Nacional,22-308,2002,9.0,22,19,14,7,1,15,23,65.2,8,11,6,5,15,37,21,0
Fabrício Garcia,CPV,FW,Estoril,23-187,2001,6.0,8,7,3,3,2,2,7,28.6,5,3,0,3,1,9,0,0
Santiago García,ESP,MF,Gil Vicente FC,23-070,2001,3.9,11,6,6,4,1,3,7,42.9,4,5,1,4,4,15,7,0
Bruno Gaspar,ANG,DF,Vitória,31-200,1993,8.5,15,11,7,5,3,7,12,58.3,5,11,0,11,3,18,13,0
Mory Gbane,CIV,MF,Gil Vicente FC,23-318,2000,7.1,21,12,8,13,0,16,23,69.6,7,4,3,1,12,33,20,0
Geovanny,POR,MF,Farense,20-116,2004,1.8,3,2,1,2,0,2,5,40.0,3,3,2,1,0,3,1,0
André Geraldes,POR,"MF,DF",Casa Pia,33-189,1991,6.8,9,3,8,1,0,5,6,83.3,1,9,3,6,3,12,22,0
Ismaël Gharbi,ESP,"MF,FW",Braga,20-211,2004,1.8,2,0,0,1,1,1,4,25.0,3,2,0,2,0,2,0,0
José Gomes,POR,DF,Nacional,28-110,1996,8.7,15,10,6,7,2,3,8,37.5,5,12,6,6,9,24,30,0
Pedro gomes,POR,DF,Boavista,21-156,2003,9.1,28,19,17,10,1,16,23,69.6,7,14,4,10,12,40,32,1
Vítor Gomes,POR,MF,Rio Ave,36-318,1987,0.4,1,0,0,0,1,0,1,0.0,1,0,0,0,1,2,5,0
Victor Gomez,ESP,DF,Braga,24-220,2000,5.1,5,2,2,2,1,5,10,50.0,5,5,0,5,4,9,10,0
Nuno Gonçalo Moreira,POR,"FW,MF",Casa Pia,25-144,1999,7.2,17,13,6,8,3,9,18,50.0,9,8,0,8,5,22,6,0
João Gonçalves,POR,GK,Boavista,24-002,2000,4.0,0,0,0,0,0,0,0,,0,0,0,0,0,0,2,0
Pedro Gonçalves,POR,"FW,MF",Sporting CP,26-132,1998,6.2,8,2,1,3,4,3,10,30.0,7,5,1,4,2,10,0,0
Cristo González,ESP,MF,Arouca,27-014,1997,2.0,2,1,1,0,1,1,4,25.0,3,1,1,0,0,2,1,0
Mario González,ESP,FW,Famalicão,28-256,1996,3.8,2,1,0,1,1,1,3,33.3,2,1,0,1,0,2,1,0
Nicolás González,ESP,MF,Porto,22-309,2002,9.4,20,7,4,13,3,7,13,53.8,6,3,1,2,3,23,8,0
Jean Gorby,FRA,MF,Braga,22-105,2002,3.3,8,3,2,6,0,4,6,66.7,2,5,3,2,3,11,5,0
João Goulart Silva,POR,DF,Casa Pia,24-285,2000,10.0,15,11,11,3,1,12,14,85.7,2,13,9,4,12,27,50,0
Tiago Gouveia,POR,"FW,DF",Benfica,23-142,2001,0.9,2,2,1,1,0,0,0,,0,1,0,1,0,2,0,0
Pablo Gozalbez,ESP,"MF,DF",Arouca,23-191,2001,0.8,0,0,0,0,0,0,1,0.0,1,0,0,0,1,1,0,0
João Graça,POR,"MF,FW",Rio Ave,29-142,1995,2.0,7,3,3,4,0,6,10,60.0,4,8,2,6,1,8,4,0
Samuel Granada,BRA,FW,AVS Futebol,24-271,2000,2.7,1,1,1,0,0,0,0,,0,1,0,1,0,1,5,0
Jaume Grau,ESP,MF,AVS Futebol,27-186,1997,6.4,17,10,9,7,1,11,26,42.3,15,11,2,9,8,25,7,1
Marko Grujić,SRB,MF,Porto,28-208,1996,0.4,0,0,0,0,0,0,0,,0,1,1,0,0,0,2,0
Rafik Guitane,FRA,"FW,MF",Estoril,25-165,1999,1.1,0,0,0,0,0,0,0,,0,0,0,0,0,0,0,0
Rafik Guitane,FRA,FW,Braga,25-165,1999,0.0,0,0,0,0,0,0,0,,0,1,0,1,0,0,0,0
Deniz Gül,SWE,FW,Porto,20-128,2004,0.5,0,0,0,0,0,0,1,0.0,1,1,0,1,0,0,0,0
Viktor Gyökeres,SWE,FW,Sporting CP,26-156,1998,9.8,3,2,0,0,3,1,3,33.3,2,0,0,0,0,3,6,0
Justin de Haas,NED,DF,Famalicão,24-280,2000,9.0,12,7,9,3,0,9,11,81.8,2,12,9,3,13,25,35,0
Tomás Händel,POR,MF,Vitória,23-346,2000,9.5,17,11,8,7,2,12,17,70.6,5,7,2,5,15,32,12,0
Conrad Harder,DEN,"FW,MF",Sporting CP,19-214,2005,1.7,0,0,0,0,0,0,1,0.0,1,2,0,2,1,1,2,0
Thiago Helguera,URU,MF,Braga,18-226,2006,0.1,0,0,0,0,0,0,0,,0,0,0,0,0,0,1,0
Gustavo Henrique,BRA,"MF,FW",Estrela,25-189,1999,2.5,7,4,3,4,0,5,9,55.6,4,4,0,4,2,9,5,0
Morten Hjulmand,DEN,MF,Sporting CP,25-135,1999,6.3,12,9,3,8,1,6,14,42.9,8,5,3,2,7,19,4,0
Jordan Holsgrove,SCO,MF,Estoril,25-058,1999,3.6,5,3,1,2,2,2,4,50.0,2,3,2,1,1,6,5,0
Lukáš Horníček,CZE,GK,Braga,22-117,2002,1.0,0,0,0,0,0,0,0,,0,0,0,0,0,0,1,0
André Horta,POR,MF,Braga,28-000,1996,4.3,14,10,3,9,2,6,11,54.5,5,3,0,3,0,14,3,0
Ricardo Horta,POR,"MF,FW",Braga,30-053,1994,9.0,12,5,1,7,4,2,8,25.0,6,6,1,5,3,15,4,0
Igor,BRA,MF,Estrela,21-245,2003,3.9,9,7,3,6,0,5,11,45.5,6,5,2,3,5,14,4,0
André Inácio,BRA,MF,Estrela,22-258,2002,4.3,6,2,3,2,1,2,8,25.0,6,5,0,5,2,8,2,0
Gonçalo Inácio,POR,DF,Sporting CP,23-074,2001,7.6,12,7,2,6,4,7,12,58.3,5,7,2,5,12,24,11,0
Isaac,BRA,FW,Nacional,20-226,2004,2.7,4,2,2,1,1,1,2,50.0,1,3,0,3,0,4,3,0
Ismael,POR,MF,Moreirense,25-227,1999,8.8,29,18,9,18,2,10,16,62.5,6,11,5,6,16,45,19,0
Franco Israel,URU,GK,Sporting CP,24-199,2000,6.0,0,0,0,0,0,0,0,,0,0,0,0,0,0,0,0
Ivan Jaime Pajuelo,ESP,FW,Porto,24-042,2000,4.1,1,1,1,0,0,1,2,50.0,1,2,0,2,2,3,3,0
Jason,ESP,FW,Arouca,30-124,1994,7.7,3,2,1,1,1,2,10,20.0,8,7,1,6,6,9,6,0
Jhonatan,BRA,GK,Rio Ave,33-183,1991,8.0,0,0,0,0,0,0,1,0.0,1,0,0,0,0,0,2,3
Luiz Lúcio Reis Júnior,BRA,GK,Famalicão,23-298,2001,1.0,0,0,0,0,0,0,0,,0,0,0,0,0,0,1,0
Issa Kaboré,BFA,DF,Benfica,23-179,2001,0.1,0,0,0,0,0,0,0,,0,1,0,1,0,0,0,0
Kaio,BRA,FW,Vitória,20-266,2004,7.2,12,7,4,4,4,6,14,42.9,8,8,1,7,5,17,1,0
Issiaka Kamate,FRA,"FW,MF",AVS Futebol,20-097,2004,3.7,7,5,5,2,0,4,5,80.0,1,1,0,1,5,12,3,0
Kazu,BRA,DF,Gil Vicente FC,24-234,2000,2.0,3,1,1,1,1,3,4,75.0,1,2,0,2,2,5,5,0
Keliano,ANG,MF,Estrela,21-296,2003,2.8,12,7,4,6,2,9,11,81.8,2,0,0,0,5,17,6,0
Kewin,BRA,GK,Moreirense,29-013,1995,10.0,0,0,0,0,0,0,1,0.0,1,0,0,0,0,0,10,1
Kikas,POR,FW,Estrela,26-051,1998,8.6,3,2,0,2,1,1,3,33.3,2,5,1,4,0,3,6,0
Gustavo Klismahn,BRA,MF,Santa Clara,24-350,1999,2.4,5,3,1,3,1,1,3,33.3,2,2,0,2,1,6,6,0
Ruben Kluivert,NED,DF,Casa Pia,23-170,2001,4.1,7,4,6,0,1,3,3,100.0,0,6,4,2,4,11,25,0
Koka,EGY,"FW,MF",Rio Ave,31-247,1993,1.2,0,0,0,0,0,0,0,,0,1,0,1,0,0,0,0
Orkun Kökçü,TUR,"MF,FW",Benfica,23-314,2000,7.4,1,1,1,0,0,0,8,0.0,8,2,0,2,3,4,2,1
Vladen Kovačević,BIH,GK,Sporting CP,26-210,1998,4.0,0,0,0,0,0,0,0,,0,0,0,0,0,0,3,0
Andrian Kraev,BUL,MF,Casa Pia,25-267,1999,6.1,14,8,4,8,2,6,17,35.3,11,5,3,2,9,23,11,1
Chiheb Labidi,TUN,MF,Nacional,23-159,2001,0.1,0,0,0,0,0,0,0,,0,0,0,0,1,1,0,1
André Lacximicant,POR,FW,Estoril,23-172,2001,1.6,2,2,1,0,1,0,2,0.0,2,0,0,0,1,3,5,0
Chico Lamba,POR,DF,Arouca,21-242,2003,4.3,5,2,5,0,0,4,6,66.7,2,8,7,1,1,6,13,0
Larra,ESP,"MF,FW",Casa Pia,26-326,1997,4.8,8,6,2,5,1,4,6,66.7,2,6,1,5,4,12,9,0
Leonardo Lelo,POR,"MF,DF",Casa Pia,24-222,2000,9.9,19,12,8,7,4,6,15,40.0,9,5,2,3,4,23,24,1
Marcos Leonardo,BRA,MF,Benfica,21-189,2003,0.9,0,0,0,0,0,0,0,,0,0,0,0,0,0,0,0
Guilherme Liberato,BRA,MF,Moreirense,23-144,2001,0.5,1,0,0,1,0,1,1,100.0,0,0,0,0,0,1,0,0
Otso Liimatta,FIN,"FW,MF",Famalicão,20-120,2004,0.6,2,2,1,1,0,2,2,100.0,0,1,0,1,1,3,0,0
Rúben Lima,POR,DF,Estrela,35-035,1989,2.3,6,5,4,2,0,2,7,28.6,5,3,2,1,2,8,13,0
Jérémy Livolant,FRA,"FW,MF",Casa Pia,26-303,1998,0.4,1,1,0,0,1,1,1,100.0,0,0,0,0,0,1,1,0
Danny Loader,ENG,"FW,MF",Porto,24-071,2000,6.3,5,3,1,2,2,2,7,28.6,5,4,0,4,4,9,3,0
Samuel Lobato,POR,FW,Famalicão,23-019,2001,0.5,3,2,2,1,0,2,4,50.0,2,0,0,0,0,3,1,0
Tom van de Looi,NED,MF,Famalicão,25-128,1999,2.6,9,7,3,4,2,5,7,71.4,2,0,0,0,3,12,3,0
Miguel Lopes,POR,DF,Estrela,37-324,1986,4.0,5,4,4,1,0,4,11,36.4,7,2,2,0,6,11,41,1
Vasco Lopes,CPV,"MF,FW",AVS Futebol,25-066,1999,2.7,3,2,0,1,2,2,3,66.7,1,2,0,2,1,4,1,0
Mamadou Loum,SEN,"DF,MF",Arouca,27-313,1996,1.4,2,1,1,1,0,2,3,66.7,1,2,1,1,1,3,6,0
Jonatan Lucca,BRA,MF,AVS Futebol,30-158,1994,3.0,3,2,1,2,0,1,3,33.3,2,6,2,4,2,5,8,1
Florentino Luís,POR,MF,Benfica,25-080,1999,6.9,22,14,4,12,6,11,22,50.0,11,12,1,11,13,35,6,1
Zé Luís,CPV,FW,AVS Futebol,33-288,1991,1.4,0,0,0,0,0,0,1,0.0,1,1,0,1,0,0,3,0
Luismi,EQG,FW,Moreirense,23-121,2001,7.7,8,5,2,5,1,5,6,83.3,1,8,2,6,1,9,14,0
Rúben Macedo,POR,FW,Nacional,28-243,1996,5.0,2,2,2,0,0,0,5,0.0,5,8,0,8,2,4,4,0
Tiago Machado,POR,"MF,DF",Boavista,20-219,2004,0.5,0,0,0,0,0,0,0,,0,1,0,1,0,0,0,0
Madson,BRA,FW,Moreirense,25-073,1999,7.7,10,7,3,6,1,4,9,44.4,5,9,0,9,10,20,9,0
Eliaquim Mangala,FRA,DF,Estoril,33-268,1991,4.3,7,6,5,2,0,5,8,62.5,3,6,5,1,7,14,17,0
Ricardo Mangas,POR,FW,Vitória,26-233,1998,3.8,3,3,2,0,1,3,4,75.0,1,2,0,2,0,3,8,0
Nico Mantl,GER,GK,Arouca,24-275,2000,10.0,0,0,0,0,0,0,0,,0,0,0,0,1,1,7,2
Manuel Manu,POR,MF,Vitória,23-148,2001,2.0,3,2,2,1,0,3,5,60.0,2,1,0,1,2,5,2,0
Maracás,BRA,DF,Moreirense,30-194,1994,7.5,5,2,4,1,0,2,3,66.7,1,8,6,2,3,8,42,0
Adrián Marín,ESP,DF,Braga,27-303,1997,6.9,12,3,7,5,0,5,13,38.5,8,7,1,6,13,25,23,0
João Mário,POR,"FW,MF",Benfica,31-293,1993,1.7,3,2,3,0,0,3,3,100.0,0,3,0,3,0,3,0,0
João Mário Lopes,POR,DF,Porto,24-309,2000,4.0,12,8,5,4,3,8,10,80.0,2,1,0,1,2,14,3,0
Uladzislaŭ Marozaŭ,BLR,"FW,MF",Arouca,24-026,2000,1.1,2,2,0,2,0,0,1,0.0,1,0,0,0,0,2,1,0
Alejandro Marqués,VEN,FW,Estoril,24-095,2000,8.4,2,1,1,1,0,0,2,0.0,2,9,1,8,3,5,6,0
João Marques,POR,"MF,FW",Braga,22-268,2002,0.4,2,1,1,1,0,1,1,100.0,0,4,0,4,0,2,0,0
Gabri Martínez,ESP,FW,Braga,21-290,2003,4.9,16,9,10,3,3,14,21,66.7,7,6,0,6,2,18,5,0
Toni Martínez,ESP,FW,Porto,27-130,1997,0.0,2,0,0,2,0,1,1,100.0,0,0,0,0,0,2,0,0
Bernardo Sousa Pereira Brites Martins,POR,"FW,MF",Moreirense,26-339,1997,2.7,7,4,2,5,0,2,10,20.0,8,2,0,2,3,10,1,0
Matheus,BRA,GK,Braga,32-111,1992,9.0,1,1,1,0,0,1,2,50.0,1,1,0,1,0,1,1,0
Marco Matias,POR,FW,Farense,35-181,1989,1.7,1,0,1,0,0,0,0,,0,0,0,0,0,1,0,0
Jordi Mboula,ESP,"FW,MF",Gil Vicente FC,25-236,1999,5.8,4,0,0,3,1,1,7,14.3,6,3,0,3,4,8,5,0
Tobías Medina,ARG,MF,Rio Ave,20-249,2004,0.3,0,0,0,0,0,0,0,,0,0,0,0,0,0,0,0
Yair Mena Palacios,COL,FW,AVS Futebol,24-132,2000,0.4,1,1,0,1,0,0,0,,0,0,0,0,1,2,1,0
João Mendes,POR,"FW,MF",Vitória,30-017,1994,6.6,7,6,2,2,3,6,11,54.5,5,6,0,6,0,7,6,0
João Mendes,POR,DF,Vitória,24-208,2000,7.9,23,10,12,9,2,12,16,75.0,4,10,2,8,2,25,28,1
Joe Mendes,SWE,DF,Braga,21-312,2002,2.0,2,1,0,2,0,2,2,100.0,0,2,0,2,1,3,4,0
Gustavo Mendonça,POR,MF,AVS Futebol,21-241,2003,0.2,0,0,0,0,0,0,0,,0,0,0,0,0,0,0,0
Miguel Menino,POR,MF,Farense,21-302,2003,4.0,11,6,5,5,1,3,8,37.5,5,6,1,5,4,15,7,0
John Mercado,ECU,"FW,MF",AVS Futebol,22-157,2002,7.4,9,6,3,5,1,2,7,28.6,5,8,3,5,3,12,10,2
Mehdi Merghem,FRA,MF,Farense,27-111,1997,2.6,5,4,3,1,1,1,5,20.0,4,3,0,3,1,6,1,0
Bruno Messi,POR,"MF,FW",Santa Clara,28-059,1996,0.6,0,0,0,0,0,0,1,0.0,1,1,1,0,0,0,0,0
Enea Mihaj,ALB,DF,Famalicão,26-125,1998,9.5,19,11,13,6,0,10,15,66.7,5,16,8,8,19,38,40,1
Álex Millán,ESP,"FW,MF",Farense,25-000,1999,4.2,3,0,0,2,1,0,2,0.0,2,7,0,7,1,4,7,0
Cezary Miszta,POL,GK,Rio Ave,23-008,2001,2.0,0,0,0,0,0,0,0,,0,0,0,0,0,0,2,0
Rodrigo Mora,POR,MF,Porto,17-186,2007,0.5,4,2,0,1,3,3,4,75.0,1,0,0,0,0,4,0,0
Morato,BRA,DF,Benfica,23-130,2001,1.0,3,2,1,2,0,1,3,33.3,2,1,0,1,3,6,1,0
Paulo Moreira,POR,MF,Estrela,24-264,2000,1.7,11,7,4,5,2,4,5,80.0,1,2,1,1,3,14,2,0
Marco Moreno,ESP,DF,Farense,23-261,2001,5.6,5,4,4,1,0,2,6,33.3,4,7,7,0,4,9,24,0
Hidemasa Morita,JPN,MF,Sporting CP,29-181,1995,6.9,15,10,5,9,1,6,11,54.5,5,7,1,6,4,19,10,1
Moura,POR,DF,Famalicão,25-083,1999,4.0,10,7,6,3,1,6,7,85.7,1,4,0,4,1,11,6,0
Moura,POR,DF,Porto,25-083,1999,5.7,4,2,1,3,0,1,5,20.0,4,3,1,2,5,9,15,0
João Moutinho,POR,"MF,FW",Braga,38-060,1986,1.3,2,1,0,2,0,1,2,50.0,1,2,0,2,1,3,0,0
MT,BRA,"MF,DF",Santa Clara,23-251,2001,10.0,23,11,16,6,1,11,19,57.9,8,8,0,8,11,34,34,0
Jonathan Mutombo,FRA,DF,Gil Vicente FC,22-072,2002,1.6,7,5,6,1,0,3,3,100.0,0,0,0,0,3,10,6,0
Nani,POR,"FW,MF",Estrela,37-356,1986,5.2,4,1,1,3,0,1,6,16.7,5,3,2,1,3,7,2,0
Fran Navarro,ESP,FW,Porto,26-278,1998,1.0,2,0,0,0,2,2,2,100.0,0,1,0,1,0,2,0,0
Christian Neiva Afonso,POR,DF,AVS Futebol,29-333,1994,8.9,21,17,12,7,2,13,17,76.5,4,16,4,12,5,26,23,2
Nenê,BRA,FW,AVS Futebol,41-102,1983,2.6,3,1,1,2,0,0,1,0.0,1,3,0,3,0,3,0,0
Neto,BRA,MF,Farense,33-066,1991,6.5,17,9,8,9,0,5,18,27.8,13,9,5,4,12,29,8,1
Martim Neto,POR,MF,Rio Ave,21-298,2003,3.4,7,3,0,6,1,1,5,20.0,4,3,1,2,2,9,1,0
Sikou Niakaté,MLI,DF,Braga,25-120,1999,7.0,4,1,2,2,0,2,4,50.0,2,1,1,0,14,18,35,0
Miguel Nóbrega,POR,DF,Rio Ave,24-204,2000,1.0,3,2,3,0,0,3,5,60.0,2,3,3,0,0,3,2,0
João Novais,POR,MF,Rio Ave,31-120,1993,5.6,7,4,4,2,1,5,11,45.5,6,6,1,5,4,11,5,0
Samuel Obeng,GHA,FW,Casa Pia,27-176,1997,3.3,0,0,0,0,0,0,1,0.0,1,2,0,2,0,0,3,0
Guillermo Ochoa,MEX,GK,AVS Futebol,39-117,1985,6.0,1,1,1,0,0,1,1,100.0,0,0,0,0,0,1,4,1
Lawrence Ofori,GHA,MF,Moreirense,26-132,1998,5.8,12,6,7,4,1,6,12,50.0,6,6,0,6,4,16,9,1
Nélson Oliveira,POR,FW,Vitória,33-091,1991,7.2,2,1,0,0,2,0,2,0.0,2,1,0,1,1,3,3,0
Paulo Oliveira,POR,DF,Braga,32-304,1992,3.9,5,2,3,2,0,1,2,50.0,1,7,6,1,4,9,25,1
Talys Oliveira,BRA,DF,Farense,25-271,1999,2.8,6,2,2,3,1,3,6,50.0,3,3,0,3,3,9,6,0
Samu Omorodion,ESP,FW,Porto,20-186,2004,5.3,0,0,0,0,0,0,0,,0,0,0,0,2,2,1,0
Bruno Onyemaechi,NGA,DF,Boavista,25-218,1999,9.4,14,6,11,3,0,8,16,50.0,8,13,5,8,5,19,37,2
Jandro Orellana,ESP,MF,Estoril,24-092,2000,6.5,10,7,4,5,1,6,9,66.7,3,2,1,1,8,18,5,0
Nicolás Otamendi,ARG,DF,Benfica,36-269,1988,7.1,11,9,5,3,3,6,9,66.7,3,6,3,3,17,28,9,2
Amine El Ouazzani,MAR,FW,Braga,23-115,2001,5.1,7,5,3,1,3,3,6,50.0,3,6,1,5,3,10,3,0
Amine Oudrhiri,MAR,MF,Rio Ave,32-003,1992,6.8,8,7,6,1,1,4,12,33.3,8,10,4,6,16,24,7,0
Pablo,BRA,MF,Gil Vicente FC,20-310,2004,0.2,0,0,0,0,0,0,0,,0,1,0,1,0,0,0,0
Renato Pantalon,CRO,DF,Rio Ave,27-011,1997,7.7,12,5,8,4,0,8,10,80.0,2,8,5,3,12,24,34,2
Jonathan Panzo,ENG,DF,Rio Ave,24-013,2000,5.3,9,6,6,3,0,5,10,50.0,5,8,1,7,7,16,30,1
David Pastor,BRA,"DF,MF",Farense,24-261,2000,7.1,15,12,11,4,0,9,15,60.0,6,7,1,6,13,28,19,1
Patrick,BRA,DF,Rio Ave,27-157,1997,5.1,5,5,4,1,0,4,8,50.0,4,6,4,2,7,12,18,1
Vangelis Pavlidis,GRE,FW,Benfica,25-352,1998,8.0,6,5,1,2,3,2,6,33.3,4,6,0,6,3,9,2,0
Zé Pedro Figueiredo,POR,DF,Porto,27-154,1997,7.3,10,7,8,2,0,5,8,62.5,3,6,5,1,11,21,30,0
Daniel Penha,BRA,"MF,FW",Nacional,26-021,1998,4.5,9,6,3,5,1,5,10,50.0,5,5,1,4,2,11,4,0
Pepê,BRA,"FW,MF",Porto,27-257,1997,8.0,8,6,1,3,4,3,6,50.0,3,9,0,9,6,14,0,0
Pereira,POR,"FW,MF",Casa Pia,22-266,2002,1.5,0,0,0,0,0,0,0,,0,0,0,0,0,0,0,0
Francisco Pereira,POR,MF,Estoril,22-275,2002,0.1,0,0,0,0,0,0,0,,0,0,0,0,0,0,1,0
Matheus Pereira,BRA,FW,Santa Clara,23-322,2000,2.1,4,3,0,3,1,2,2,100.0,0,2,1,1,2,6,3,0
Sebastián Pérez Cardona,COL,MF,Boavista,31-223,1993,7.3,16,9,10,5,1,8,14,57.1,6,8,4,4,12,28,10,0
Nehuén Pérez,ARG,DF,Porto,24-136,2000,5.7,9,3,4,4,1,4,4,100.0,0,5,5,0,6,15,14,0
Petterson,BRA,"MF,FW",Estrela,20-308,2004,0.8,1,0,0,1,0,1,2,50.0,1,0,0,0,1,2,0,0
Lucas Piazon,BRA,"MF,FW",AVS Futebol,30-292,1994,8.4,20,12,4,12,4,10,16,62.5,6,10,0,10,4,24,3,0
Wagner Pina,CPV,DF,Estoril,22-004,2002,7.6,29,19,15,12,2,12,24,50.0,12,18,5,13,14,43,22,0
Rodrigo Pinheiro,POR,DF,Famalicão,22-071,2002,3.1,4,3,4,0,0,3,5,60.0,2,2,1,1,5,9,10,0
Rodrigo Pinho,BRA,FW,Estrela,33-161,1991,5.3,7,4,3,2,2,2,3,66.7,1,1,0,1,3,10,7,0
Alexandre Pinto,POR,"DF,FW",Arouca,26-122,1998,0.1,0,0,0,0,0,0,0,,0,0,0,0,0,0,1,0
Dinis Pinto,POR,DF,Moreirense,24-075,2000,3.7,7,5,5,2,0,4,7,57.1,3,3,0,3,2,9,9,0
Jaime Pinto,POR,MF,Farense,27-040,1997,0.4,0,0,0,0,0,0,2,0.0,2,1,1,0,0,0,0,0
João Pinto,POR,MF,Gil Vicente FC,22-068,2002,0.0,0,0,0,0,0,0,0,,0,0,0,0,0,0,0,0
Ole Pohlmann,GER,"FW,MF",Rio Ave,23-216,2001,4.3,9,2,1,3,5,5,7,71.4,2,6,2,4,0,9,3,0
Carlos Ponck,CPV,DF,Moreirense,29-299,1995,2.9,5,4,3,1,1,1,2,50.0,1,2,2,0,4,9,25,0
Boris Popović,SRB,DF,Arouca,24-255,2000,5.1,5,2,4,1,0,2,2,100.0,0,8,5,3,4,9,19,1
Darío Poveda,ESP,"FW,MF",Farense,27-239,1997,3.8,1,1,0,1,0,0,3,0.0,3,1,0,1,0,1,3,0
Gianluca Prestianni,ARG,"MF,FW",Benfica,18-281,2006,3.0,3,2,1,0,2,2,7,28.6,5,5,0,5,0,3,2,0
Miguel Puche García,ESP,FW,Arouca,23-191,2001,0.2,0,0,0,0,0,0,0,,0,0,0,0,0,0,0,0
Quaresma,BRA,DF,Arouca,28-077,1996,0.9,2,1,1,1,0,0,0,,0,0,0,0,2,4,1,0
Eduardo Quaresma,POR,DF,Sporting CP,22-250,2002,4.3,10,5,4,4,2,5,5,100.0,0,0,0,0,1,11,9,0
Geovany Quenda,POR,"MF,DF",Sporting CP,17-191,2007,7.4,7,4,3,3,1,6,9,66.7,3,5,1,4,2,9,7,0
Jesús Ramírez,VEN,FW,Vitória,26-187,1998,2.8,3,3,1,0,2,0,2,0.0,2,0,0,0,0,3,2,0
Guilherme Ramos,POR,DF,Santa Clara,27-088,1997,0.8,2,0,0,1,1,1,1,100.0,0,1,1,0,0,2,4,0
João Rêgo,POR,FW,Benfica,19-140,2005,0.1,0,0,0,0,0,0,1,0.0,1,0,0,0,0,0,0,0
Francisco Reis Ferreira,POR,DF,Estrela,27-226,1997,4.0,8,5,7,1,0,6,12,50.0,6,4,2,2,8,16,17,0
Matheus Reis,BRA,"DF,MF",Sporting CP,29-263,1995,3.0,3,3,2,1,0,3,3,100.0,0,1,0,1,3,6,5,0
Tiago Reis,BRA,FW,Nacional,25-085,1999,2.3,1,0,1,0,0,0,0,,0,2,0,2,0,1,0,0
Miguel Reisinho,POR,"MF,FW",Boavista,25-212,1999,6.8,21,9,4,14,3,13,16,81.3,3,6,0,6,11,32,9,0
Marco Ribeiro,POR,MF,Boavista,19-146,2005,0.6,2,1,1,0,1,1,2,50.0,1,0,0,0,0,2,1,0
Rodrigo Ribeiro,POR,FW,Sporting CP,19-193,2005,0.0,0,0,0,0,0,0,0,,0,0,0,0,0,0,0,0
Rodrigo Ribeiro,POR,FW,AVS Futebol,19-193,2005,4.0,1,1,0,1,0,0,0,,0,2,1,1,1,2,5,0
Tomás Ribeiro,POR,DF,Vitória,25-191,1999,3.5,6,4,4,2,0,4,6,66.7,2,7,5,2,6,12,14,0
Yuri Ribeiro,POR,DF,Braga,27-288,1997,3.1,1,1,1,0,0,1,1,100.0,0,5,1,4,1,2,11,0
Ricardinho,POR,"FW,MF",Santa Clara,26-093,1998,3.3,7,6,2,2,3,3,8,37.5,5,2,0,2,5,12,2,0
Riccieli,BRA,DF,Famalicão,26-051,1998,1.5,2,2,2,0,0,2,2,100.0,0,1,1,0,2,4,3,0
Omar Richards,ENG,"DF,MF",Rio Ave,26-266,1998,5.5,16,11,8,8,0,8,9,88.9,1,7,1,6,4,20,16,0
Rivaldo,,DF,Farense,24-050,2000,4.0,11,7,4,7,0,5,8,62.5,3,6,3,3,7,18,15,0
Pablo Roberto,BRA,"FW,MF",Casa Pia,24-359,1999,2.6,4,2,3,1,0,3,7,42.9,4,3,0,3,0,4,0,0
Joel Robles,ESP,GK,Estoril,34-143,1990,9.0,0,0,0,0,0,0,0,,0,0,0,0,0,0,6,0
Matí­as Rocha,URU,DF,Arouca,23-268,2001,2.9,4,3,3,1,0,3,3,100.0,0,2,1,1,0,4,12,0
Rochinha,POR,FW,Famalicão,29-188,1995,6.1,8,6,6,1,1,7,9,77.8,2,1,1,0,3,11,3,0
Afonso Rodrigues,POR,FW,Famalicão,22-080,2002,0.0,0,0,0,0,0,0,0,,0,1,0,1,0,0,0,0
Ivo Rodrigues,POR,"MF,FW",Arouca,29-222,1995,5.4,16,11,8,7,1,9,15,60.0,6,8,1,7,4,20,7,0
Luís Carlos Rocha Rodrigues,POR,DF,Santa Clara,38-086,1986,8.0,5,3,5,0,0,2,5,40.0,3,5,4,1,6,11,30,0
Rafael Rodrigues,POR,DF,AVS Futebol,22-254,2002,1.6,2,1,1,1,0,2,2,100.0,0,1,0,1,4,6,5,0
Ignacio Rodríguez,URU,DF,AVS Futebol,20-363,2003,0.1,0,0,0,0,0,0,0,,0,0,0,0,1,1,2,0
Benjamín Rollheiser,ARG,"MF,FW",Benfica,24-228,2000,1.2,4,4,0,3,1,2,4,50.0,2,1,0,1,0,4,0,0
Baptiste Roux,FRA,"DF,MF",AVS Futebol,24-347,1999,8.9,17,10,10,7,0,15,24,62.5,9,12,6,6,11,28,38,0
Alan Ruiz,ARG,"MF,FW",Estrela,31-080,1993,4.3,7,5,1,6,0,1,9,11.1,8,4,0,4,0,7,7,1
Gustavo sá,POR,MF,Famalicão,19-362,2004,7.0,12,9,6,4,2,1,9,11.1,8,10,2,8,3,15,3,1
Josué Sá,POR,DF,Gil Vicente FC,32-143,1992,0.4,0,0,0,0,0,0,0,,0,0,0,0,0,0,2,0
Safira,BRA,FW,Santa Clara,29-235,1995,7.0,5,3,1,1,3,2,6,33.3,4,3,0,3,2,7,7,0
Sala,ESP,FW,Estoril,21-181,2003,1.1,1,1,0,1,0,0,5,0.0,5,1,0,1,1,2,4,0
Samu,POR,MF,Vitória,28-200,1996,5.8,15,8,4,8,3,6,8,75.0,2,11,2,9,0,15,3,0
Renato Sanches,POR,MF,Benfica,27-081,1997,0.9,1,1,0,1,0,1,1,100.0,0,1,0,1,0,1,0,0
Caio Santana,BRA,"FW,MF",Estrela,20-230,2004,1.0,9,5,6,3,0,7,8,87.5,1,0,0,0,2,11,3,0
Aderlan Santos,BRA,DF,Rio Ave,35-212,1989,9.7,23,13,17,6,0,15,16,93.8,1,9,4,5,17,40,68,0
Bruno Santos,POR,FW,Farense,21-205,2003,0.6,1,0,0,1,0,0,1,0.0,1,0,0,0,1,2,0,0
Gabriel Santos,BRA,"FW,MF",Nacional,25-236,1999,1.0,2,1,1,0,1,0,1,0.0,1,1,0,1,0,2,0,0
Léo Santos,BRA,DF,Nacional,25-334,1998,2.2,1,0,1,0,0,1,2,50.0,1,3,2,1,0,1,12,1
Nuno Santos,POR,"MF,DF",Sporting CP,29-268,1995,3.9,4,0,1,1,2,2,4,50.0,2,5,0,5,4,8,4,0
Nuno Santos,POR,"MF,FW",Vitória,25-250,1999,5.8,10,8,4,2,4,7,12,58.3,5,5,0,5,3,13,6,0
Pedro Santos,POR,"MF,FW",Arouca,24-026,2000,2.6,8,8,3,4,1,3,11,27.3,8,2,1,1,1,9,3,1
Pedro Santos,POR,"FW,MF",Moreirense,21-271,2003,2.0,3,2,1,2,0,1,5,20.0,4,1,0,1,2,5,2,0
Guilherme Schettine,BRA,FW,Moreirense,29-028,1995,3.2,2,2,0,2,0,0,2,0.0,2,4,0,4,1,3,3,0
Andreas Schjelderup,NOR,FW,Benfica,20-159,2004,0.4,1,1,0,0,1,1,2,50.0,1,0,0,0,0,1,0,0
Telasco Segovia,VEN,MF,Casa Pia,21-219,2003,4.1,10,7,4,5,1,4,15,26.7,11,2,1,1,3,13,5,0
Patrick Sequeira,CRC,GK,Casa Pia,25-251,1999,9.0,0,0,0,0,0,0,0,,0,0,0,0,0,0,11,0
Serginho,POR,MF,Santa Clara,24-342,1999,0.9,0,0,0,0,0,0,0,,0,1,0,1,2,2,1,0
Sidney,BRA,DF,Santa Clara,27-295,1997,10.0,22,15,12,7,3,12,15,80.0,3,16,8,8,20,42,36,0
Alysson Silva,BRA,DF,Santa Clara,22-042,2002,1.8,2,2,2,0,0,1,1,100.0,0,0,0,0,0,2,2,0
António Silva,POR,DF,Benfica,21-008,2003,5.0,11,5,5,4,2,6,8,75.0,2,6,4,2,5,16,13,0
Gustavo da Silva,BRA,"FW,MF",Vitória,25-159,1999,2.0,4,2,3,0,1,3,3,100.0,0,7,2,5,1,5,7,0
Joel silva,POR,"MF,FW",Boavista,21-270,2003,9.6,26,19,11,10,5,13,38,34.2,25,12,2,10,11,37,18,0
Luís Manuel Costa Silva,POR,MF,AVS Futebol,32-039,1992,1.0,1,1,1,0,0,0,0,,0,1,1,0,0,1,0,0
Raul Silva,BRA,DF,Farense,35-003,1989,3.8,6,4,3,2,1,3,5,60.0,2,5,2,3,3,9,17,0
Tiago Silva,POR,MF,Vitória,31-158,1993,8.2,13,6,4,7,2,6,8,75.0,2,6,2,4,6,19,11,0
Tomás Silva,POR,"DF,MF",Boavista,18-166,2006,0.4,0,0,0,0,0,0,0,,0,0,0,0,0,0,1,0
David Simão,POR,MF,Arouca,34-176,1990,8.8,15,10,4,7,4,6,16,37.5,10,12,3,9,8,23,5,1
Sphephelo Sithole,RSA,"FW,MF",Gil Vicente FC,25-249,1999,0.6,2,2,2,0,0,2,3,66.7,1,1,1,0,0,2,1,0
Filipe Soares,POR,MF,Farense,25-171,1999,2.3,1,1,0,1,0,0,1,0.0,1,0,0,0,2,3,1,0
Lucas Soares,BRA,MF,Santa Clara,26-187,1998,4.7,8,6,4,4,0,3,7,42.9,4,4,1,3,6,14,6,0
Rafa Soares,POR,DF,Famalicão,29-182,1995,3.4,8,3,6,2,0,6,6,100.0,0,2,0,2,2,10,11,0
Djibril Soumaré,SEN,MF,Nacional,21-305,2003,1.2,8,6,6,2,0,4,4,100.0,0,3,3,0,2,10,5,0
André Sousa,POR,"MF,DF",Nacional,34-121,1990,0.6,0,0,0,0,0,0,1,0.0,1,4,2,2,0,0,1,0
Dyego Sousa,POR,FW,Nacional,35-054,1989,0.3,0,0,0,0,0,0,0,,0,0,0,0,0,0,0,0
Miguel Sousa,POR,MF,Casa Pia,26-049,1998,4.3,7,2,1,4,2,2,4,50.0,2,8,1,7,1,8,5,0
Vasco Sousa,POR,MF,Porto,21-218,2003,3.4,12,8,6,6,0,7,10,70.0,3,2,0,2,2,14,1,1
Gabriel Airton de Souza,BRA,FW,Moreirense,28-223,1996,5.3,8,6,2,6,0,2,7,28.6,5,4,0,4,3,11,1,0
Jerry St. Juste,NED,DF,Sporting CP,28-019,1996,0.7,2,2,2,0,0,2,2,100.0,0,1,0,1,0,2,0,0
Max Svensson,ESP,"FW,MF",Casa Pia,,,5.2,6,5,2,3,1,5,11,45.5,6,4,0,4,2,8,0,0
Morlaye Sylla,GUI,FW,Arouca,26-103,1998,7.8,8,6,3,4,1,1,11,9.1,10,9,0,9,0,8,4,0
Sidnei Tavares,POR,MF,Moreirense,23-039,2001,4.5,10,5,6,4,0,2,8,25.0,6,2,1,1,4,14,6,0
Duplexe Tchamba,CMR,DF,Casa Pia,26-120,1998,3.8,9,5,5,3,1,3,5,60.0,2,5,4,1,8,17,9,0
João Teixeira,POR,MF,Gil Vicente FC,30-275,1994,0.5,3,3,0,2,1,0,1,0.0,1,1,0,1,1,4,0,0
Jorge Teixeira,POR,"DF,FW",AVS Futebol,38-072,1986,1.6,1,0,1,0,0,1,1,100.0,0,2,0,2,1,2,9,0
Nigel Thomas,NED,"FW,MF",Nacional,23-280,2001,5.3,6,2,2,3,1,3,11,27.3,8,6,1,5,2,8,6,0
Demir Tıknaz,TUR,MF,Rio Ave,20-082,2004,2.6,12,7,6,5,1,5,10,50.0,5,5,3,2,5,17,4,1
Tomané,POR,FW,Farense,32-015,1992,4.0,3,1,1,2,0,1,2,50.0,1,3,0,3,0,3,7,0
Tomé,POR,GK,Boavista,17-327,2006,2.0,0,0,0,0,0,0,0,,0,0,0,0,0,0,2,0
João Tomé,POR,"MF,DF",Rio Ave,21-269,2003,3.0,8,3,6,2,0,3,5,60.0,2,1,1,0,3,11,14,0
Mirko Topić,SRB,MF,Famalicão,23-276,2001,9.8,26,16,11,13,2,10,20,50.0,10,13,3,10,16,42,22,0
Diogo Travassos,POR,DF,Estrela,20-221,2004,3.3,3,2,1,2,0,0,2,0.0,2,5,1,4,3,6,2,0
Alfonso Trezza,URU,"FW,MF",Arouca,25-138,1999,5.9,8,6,4,3,1,2,8,25.0,6,9,1,8,1,9,8,0
Francisco Trincão,POR,"FW,MF",Sporting CP,24-314,1999,9.4,14,11,1,9,4,4,9,44.4,5,7,0,7,1,15,5,0
Anatolii Trubin,UKR,GK,Benfica,23-098,2001,9.0,0,0,0,0,0,0,0,,0,0,0,0,0,0,1,1
Ulisses,BRA,DF,Nacional,25-040,1999,6.7,10,5,8,2,0,6,7,85.7,1,8,5,3,6,16,36,1
Alan Varela,ARG,MF,Porto,23-126,2001,9.1,14,6,5,8,1,9,14,64.3,5,5,1,4,6,20,11,0
Bruno Varela,CPV,GK,Vitória,30-003,1994,10.0,0,0,0,0,0,0,0,,0,0,0,0,0,0,2,1
Nilton Varela,POR,"DF,MF",Estrela,23-166,2001,8.8,23,14,13,8,2,13,16,81.3,3,9,1,8,10,33,27,1
Danilo Veiga,POR,"DF,MF",Estrela,22-043,2002,7.4,16,10,8,5,3,9,17,52.9,8,11,4,7,5,21,29,1
Eric Veiga,LUX,"MF,FW",AVS Futebol,27-263,1997,1.6,0,0,0,0,0,0,0,,0,2,1,1,0,0,0,0
Jhon Velásquez,COL,"FW,MF",Farense,29-189,1995,0.2,0,0,0,0,0,0,0,,0,1,0,1,0,0,0,0
Ricardo Velho,POR,GK,Farense,26-079,1998,10.0,0,0,0,0,0,0,0,,0,0,0,0,0,0,6,0
Frederico Venâncio,POR,DF,Santa Clara,31-277,1993,8.7,14,6,10,2,2,4,7,57.1,3,3,1,2,13,27,37,0
Paulo Victor,BRA,"DF,MF",Farense,23-208,2001,1.8,8,5,3,3,2,6,8,75.0,2,5,0,5,2,10,5,0
Fabio Vieira,POR,"FW,MF",Porto,24-161,2000,1.9,4,2,1,3,0,0,1,0.0,1,0,0,0,3,7,2,0
Gabriel Vieira,BRA,"FW,MF",Santa Clara,22-230,2002,9.0,9,9,4,3,2,5,10,50.0,5,9,0,9,2,11,4,0
Mikel Villanueva,VEN,DF,Vitória,31-207,1993,6.0,5,3,3,2,0,4,8,50.0,4,2,1,1,3,8,18,0
Marcos Vinicios Sorriso,BRA,FW,Famalicão,23-258,2001,5.3,14,7,6,5,3,6,13,46.2,7,7,1,6,3,17,3,0
Vinícius,BRA,"FW,MF",Santa Clara,25-184,1999,7.1,11,8,1,5,5,5,8,62.5,3,6,0,6,3,14,3,0
Bernardo Vital,POR,MF,Estoril,23-314,2000,0.3,2,1,1,0,1,0,1,0.0,1,1,1,0,0,2,0,0
Zé Vitor,BRA,DF,Nacional,23-272,2001,9.0,10,5,8,2,0,4,7,57.1,3,10,8,2,13,23,57,3
Marious Vrousai,GRE,"MF,DF",Rio Ave,26-128,1998,9.0,23,13,14,6,3,12,21,57.1,9,12,0,12,9,32,26,1
Ilija Vukotić,MNE,MF,Boavista,25-305,1999,7.3,17,11,2,11,4,7,15,46.7,8,12,5,7,6,23,9,0
Wendell,BRA,DF,Porto,31-110,1993,0.3,0,0,0,0,0,0,0,,0,0,0,0,0,0,0,0
Weverson,BRA,DF,Arouca,24-125,2000,3.1,2,2,0,2,0,1,3,33.3,2,4,1,3,2,4,5,1
Xeka,POR,MF,Estoril,29-363,1994,1.4,4,1,2,2,0,4,4,100.0,0,0,0,0,5,9,4,0
Güven Yalçın,TUR,"FW,MF",Arouca,25-294,1999,2.6,6,5,1,1,4,0,3,0.0,3,1,0,1,1,7,1,0
Zaydou Youssouf,FRA,MF,Famalicão,25-119,1999,9.3,23,18,10,12,1,12,21,57.1,9,9,2,7,7,30,5,0
Yassir Zabiri,MAR,"FW,MF",Famalicão,19-258,2005,0.5,2,1,0,2,0,1,2,50.0,1,1,0,1,0,2,0,0
Rodrigo Zalazar,URU,"MF,FW",Braga,25-087,1999,4.6,5,3,1,3,1,0,2,0.0,2,4,0,4,0,5,3,0
Vinícius Zanocelo,BRA,MF,Estoril,23-282,2001,10.0,13,4,5,8,0,9,25,36.0,16,13,4,9,10,23,22,0
Ivan Zlobin,RUS,GK,Famalicão,27-245,1997,9.0,0,0,0,0,0,0,0,,0,0,0,0,0,0,6,0
Nermin Zolotić,BIH,DF,Casa Pia,31-123,1993,6.0,12,6,9,3,0,8,9,88.9,1,9,6,3,5,17,17,1
