Player,Nation,Pos,Squad,Age,Born,90s,Tackles,TacklesWon,TacklesDef3rd,TacklesMid3rd,TacklesAtt3rd,DribTkl,DribTklAtt,DribTkl%,ChallengesLost,Blocks,ShotsBlocked,PassesBlocked,Int,Tkl+Int,Clr,ErrorsLeadingToShot
Abner,BRA,DF,Juventude,20-181,2004,1.2,2,0,2,0,0,2,4,50.0,2,1,1,0,3,5,10,1
Luiz Adriano,BRA,FW,Vitória,37-188,1987,2.2,0,0,0,0,0,0,0,,0,2,1,1,0,0,0,0
Adryelson,BRA,DF,Botafogo (RJ),26-208,1998,0.8,1,1,1,0,0,0,0,,0,1,0,1,1,2,6,0
Adson,BRA,FW,Vasco da Gama,24-011,2000,13.6,25,20,11,9,5,5,18,27.8,13,15,2,13,6,31,9,0
Lucas Alario,ARG,"FW,MF",Internacional,32-009,1992,7.1,5,1,1,2,2,0,5,0.0,5,2,0,2,1,6,14,0
Carlos Alberto,BRA,FW,Botafogo (RJ),22-186,2002,2.3,3,2,2,1,0,1,2,50.0,1,3,1,2,0,3,2,0
Yuri Alberto,BRA,FW,Corinthians,23-213,2001,18.4,7,3,0,3,4,3,8,37.5,5,8,1,7,6,13,10,0
Carlos Alcaraz,ARG,MF,Flamengo,21-322,2002,2.4,10,5,5,4,1,4,10,40.0,6,5,1,4,0,10,2,0
Alerrandro,BRA,FW,Vitória,24-279,2000,18.9,16,11,4,11,1,6,19,31.6,13,20,5,15,8,24,17,0
Caio Alexandre,BRA,MF,Bahia,25-236,1999,25.0,52,26,22,28,2,26,61,42.6,35,19,1,18,9,61,17,1
Matheus Alexandre,BRA,DF,Cuiabá,25-193,1999,19.3,41,27,28,11,2,31,50,62.0,19,28,3,25,29,70,49,0
Alexsander,BRA,MF,Fluminense,21-009,2003,8.8,24,12,9,9,6,11,29,37.9,18,13,3,10,9,33,9,0
Alisson,BRA,GK,Criciúma,29-131,1995,3.3,0,0,0,0,0,0,0,,0,0,0,0,0,0,1,0
Alisson,BRA,"DF,FW",Atlético Mineiro,19-026,2005,6.2,12,10,5,2,5,3,8,37.5,5,3,0,3,4,16,4,0
Alisson,BRA,MF,São Paulo,31-114,1993,15.0,25,16,12,11,2,15,29,51.7,14,13,3,10,13,38,13,0
Allan,BRA,MF,Flamengo,27-228,1997,13.5,26,13,9,15,2,14,23,60.9,9,13,4,9,17,43,18,1
Allan,BRA,MF,Botafogo (RJ),33-283,1991,3.1,15,7,7,6,2,8,13,61.5,5,5,2,3,5,20,5,0
Allano,BRA,"FW,MF",Criciúma,29-176,1995,11.8,26,17,12,12,2,13,26,50.0,13,16,1,15,2,28,6,0
Thiago Almada,ARG,"FW,MF",Botafogo (RJ),23-174,2001,6.5,1,0,1,0,0,0,15,0.0,15,4,0,4,3,4,1,0
Júnior Alonso,PAR,DF,Atlético Mineiro,31-251,1993,8.6,14,8,6,8,0,9,17,52.9,8,4,3,1,12,26,28,0
Anderson,BRA,GK,Cruzeiro,26-226,1998,15.0,0,0,0,0,0,0,1,0.0,1,0,0,0,0,0,5,3
Felipe Anderson,BRA,"FW,MF",Palmeiras,31-185,1993,8.5,21,13,8,9,4,9,22,40.9,13,17,3,14,7,28,11,0
Kervin Andrade,VEN,MF,Fortaleza,19-187,2005,4.6,2,1,1,1,0,2,5,40.0,3,6,0,6,4,6,2,0
Rodrigo Andrade,BRA,"MF,FW",Vitória,27-135,1997,4.3,6,5,4,1,1,4,5,80.0,1,8,3,5,3,9,3,0
André,BRA,MF,Fluminense,23-093,2001,11.9,24,16,5,17,2,8,14,57.1,6,16,8,8,15,39,14,0
José Andrés Martínez,VEN,MF,Corinthians,30-071,1994,4.2,11,5,6,3,2,6,10,60.0,4,5,2,3,6,17,6,0
Wilker Ángel,VEN,DF,Criciúma,31-213,1993,9.8,9,5,6,3,0,6,10,60.0,4,24,14,10,12,21,61,1
Anthoni,BRA,GK,Internacional,22-268,2002,2.0,0,0,0,0,0,0,0,,0,0,0,0,0,0,3,1
Marcos Antônio,BRA,MF,São Paulo,24-126,2000,5.0,6,4,3,3,0,3,10,30.0,7,8,2,6,2,8,12,0
Guilherme Arana,BRA,DF,Atlético Mineiro,27-186,1997,12.5,21,15,11,6,4,10,19,52.6,9,12,3,9,13,34,14,0
Charles Aránguiz,CHI,MF,Internacional,35-183,1989,3.2,6,5,0,5,1,3,8,37.5,5,4,1,3,1,7,4,0
Luiz Araújo,BRA,"FW,MF",Flamengo,28-137,1996,16.7,36,24,14,15,7,12,27,44.4,15,24,3,21,20,56,14,0
Matheus Araújo,BRA,MF,Corinthians,22-148,2002,0.5,1,1,0,1,0,0,0,,0,0,0,0,0,1,0,0
Michel Araujo,URU,"DF,FW",São Paulo,28-019,1996,9.1,27,18,14,11,2,10,29,34.5,19,10,0,10,6,33,15,0
Alexander Aravena,CHI,"FW,MF",Grêmio,22-041,2002,3.5,4,4,2,2,0,1,3,33.3,2,1,0,1,3,7,4,0
Robert Arboleda,ECU,DF,São Paulo,32-361,1991,22.7,30,18,17,13,0,14,22,63.6,8,21,12,9,21,51,87,2
Lucas Arcanjo,BRA,GK,Vitória,26-070,1998,28.0,1,0,1,0,0,1,4,25.0,3,0,0,0,1,2,7,3
Matias Arezo,URU,"FW,MF",Grêmio,21-331,2002,0.8,2,1,1,0,1,1,2,50.0,1,1,0,1,0,2,1,0
Jhon Arias,COL,FW,Fluminense,27-026,1997,17.9,32,18,10,10,12,15,30,50.0,15,22,1,21,9,41,9,0
Santiago Arias,COL,DF,Bahia,32-278,1992,17.2,35,25,20,12,3,16,28,57.1,12,13,5,8,14,49,40,1
Arthur,BRA,FW,Cruzeiro,26-106,1998,14.1,16,10,6,5,5,5,13,38.5,8,8,1,7,3,19,6,0
Arthur,BRA,FW,Criciúma,32-124,1992,15.1,4,2,0,3,1,1,3,33.3,2,11,1,10,1,5,17,0
Arthur,BRA,FW,Corinthians,21-219,2003,0.2,0,0,0,0,0,0,0,,0,0,0,0,0,0,0,0
Arthur,BRA,"FW,MF",Red Bull Bragantino,21-219,2003,1.1,0,0,0,0,0,0,0,,0,0,0,0,0,0,1,0
Filipe Augusto,BRA,MF,Cuiabá,31-066,1993,4.3,5,2,4,0,1,2,6,33.3,4,5,0,5,4,9,9,0
Renato Augusto,BRA,"MF,FW",Fluminense,36-252,1988,3.5,8,5,3,1,4,5,9,55.6,4,0,0,0,5,13,3,0
Yarlen Augusto,BRA,MF,Botafogo (RJ),18-240,2006,0.9,2,1,0,1,1,0,2,0.0,2,2,0,2,1,3,0,0
Pablo Baianinho,BRA,"MF,DF",Vitória,21-075,2003,0.3,0,0,0,0,0,0,2,0.0,2,1,0,1,0,0,0,0
Gabriel Baralhas,BRA,MF,Atl Goianiense,26-007,1998,19.6,45,23,14,27,4,15,40,37.5,25,27,5,22,27,72,25,2
Danilo Barbosa,BRA,MF,Botafogo (RJ),28-232,1996,12.7,29,22,17,11,1,14,19,73.7,5,15,8,7,25,54,35,0
Diogo Barbosa,BRA,DF,Fluminense,32-061,1992,12.6,22,16,14,5,3,14,25,56.0,11,6,1,5,8,30,27,0
Gabriel Barbosa,BRA,"FW,MF",Flamengo,28-048,1996,5.3,4,2,2,2,0,2,6,33.3,4,2,0,2,0,4,0,0
Lucas Barbosa,BRA,FW,Juventude,23-238,2001,20.9,54,32,16,24,14,25,57,43.9,32,46,2,44,16,70,17,1
Alexander Barboza,ARG,DF,Botafogo (RJ),29-215,1995,15.6,17,10,11,5,1,9,13,69.2,4,22,16,6,19,36,87,0
Mateo Barcia,URU,"MF,FW",Criciúma,23-241,2001,0.3,4,3,1,3,0,3,5,60.0,2,0,0,0,1,5,1,0
Álvaro Barreal,ARG,"MF,FW",Cruzeiro,24-061,2000,13.1,31,19,11,13,7,11,27,40.7,16,36,4,32,4,35,16,1
Barreto,BRA,MF,Criciúma,28-312,1995,19.5,37,25,21,12,4,20,44,45.5,24,38,9,29,13,50,28,0
Gabriel Barros,BRA,"FW,MF",Atl Goianiense,22-358,2001,0.9,2,1,2,0,0,2,5,40.0,3,1,0,1,0,2,0,0
Bastos,ANG,DF,Botafogo (RJ),33-204,1991,25.1,29,24,16,10,3,16,27,59.3,11,24,17,7,26,55,102,1
Rodrigo Battaglia,ARG,"DF,MF",Atlético Mineiro,33-097,1991,20.4,32,20,19,12,1,19,31,61.3,12,23,13,10,10,42,79,2
José Luis Rodríguez Bebanz,URU,DF,Vasco da Gama,27-217,1997,6.2,16,11,13,3,0,10,22,45.5,12,8,1,7,6,22,31,0
Muriel Becker,BRA,GK,Vitória,37-246,1987,1.0,0,0,0,0,0,0,0,,0,0,0,0,0,0,0,0
Ramiro Benetti,BRA,MF,Cruzeiro,31-148,1993,12.0,23,14,7,12,4,16,37,43.2,21,14,3,11,15,38,21,0
Bento,BRA,GK,Ath Paranaense,25-129,1999,7.0,0,0,0,0,0,0,1,0.0,1,0,0,0,0,0,1,0
Alexandro Bernabei,ARG,DF,Internacional,24-023,2000,13.9,33,20,13,17,3,16,34,47.1,18,16,6,10,28,61,27,0
Facundo Bernal,URU,MF,Fluminense,21-057,2003,5.1,9,3,4,5,0,4,10,40.0,6,7,1,6,5,14,12,0
Bernard,BRA,"MF,FW",Atlético Mineiro,32-039,1992,6.4,12,7,3,7,2,5,12,41.7,7,3,1,2,2,14,4,0
Raul Bicalho,BRA,DF,Corinthians,25-176,1999,1.0,0,0,0,0,0,0,0,,0,0,0,0,4,4,2,0
Matheus Bidu,BRA,DF,Corinthians,25-166,1999,8.6,20,11,11,9,0,10,16,62.5,6,10,2,8,13,33,22,0
Biel,BRA,"FW,MF",Bahia,23-199,2001,7.7,5,4,2,2,1,1,10,10.0,9,6,1,5,5,10,7,0
Biro,BRA,"MF,DF",Corinthians,20-180,2004,0.2,0,0,0,0,0,0,0,,0,0,0,0,0,0,0,0
Damián Bobadilla,PAR,MF,São Paulo,23-098,2001,11.3,34,18,16,17,1,14,28,50.0,14,16,1,15,8,42,6,1
Yannick Bolasie,COD,FW,Criciúma,35-146,1989,20.1,23,16,6,5,12,7,15,46.7,8,10,1,9,3,26,9,0
Thiago Borbas,URU,FW,Red Bull Bragantino,22-193,2002,10.6,7,4,0,5,2,3,6,50.0,3,8,4,4,2,9,14,0
Marllon Borges,BRA,DF,Cuiabá,32-184,1992,24.0,29,20,24,5,0,19,25,76.0,6,37,22,15,26,55,121,0
Pedro Borges,BRA,MF,Fortaleza,27-228,1997,12.9,58,31,31,23,4,24,33,72.7,9,22,12,10,20,78,40,0
Rafael Borré,COL,FW,Internacional,29-032,1995,12.6,10,8,3,5,2,3,14,21.4,11,9,0,9,3,13,11,0
Danilo Boza,BRA,DF,Juventude,26-164,1998,22.5,19,9,13,6,0,8,19,42.1,11,34,27,7,21,40,95,1
Martin Braithwaite,DEN,FW,Grêmio,33-134,1991,7.9,3,2,0,2,1,1,3,33.3,2,3,0,3,1,4,12,0
Breno,BRA,FW,Fortaleza,28-267,1996,18.7,12,5,6,6,0,3,7,42.9,4,13,2,11,4,16,11,0
Breno,BRA,MF,Corinthians,19-240,2005,13.6,21,11,4,13,4,8,21,38.1,13,23,5,18,15,36,20,0
José Breno,BRA,MF,Vitória,20-133,2004,0.1,0,0,0,0,0,0,0,,0,0,0,0,1,1,0,0
Emanuel Brítez,ARG,DF,Fortaleza,32-205,1992,22.0,49,32,35,11,3,26,43,60.5,17,23,13,10,22,71,102,0
Bruninho,BRA,"FW,MF",Red Bull Bragantino,21-217,2003,0.9,1,0,0,0,1,1,3,33.3,2,0,0,0,0,1,1,0
Fabrício Bruno,BRA,DF,Flamengo,28-248,1996,19.6,22,13,15,6,1,12,14,85.7,2,13,11,2,12,34,82,0
Fabricio Bustos,ARG,DF,Internacional,28-172,1996,9.6,38,23,20,12,6,18,25,72.0,7,10,2,8,11,49,29,0
Rafael Cabral,BRA,GK,Grêmio,34-150,1990,5.1,0,0,0,0,0,0,0,,0,0,0,0,0,0,0,0
Cacá,BRA,DF,Corinthians,25-175,1999,22.8,25,13,20,4,1,20,24,83.3,4,39,30,9,13,38,100,1
Raúl Cáceres,PAR,DF,Vitória,33-029,1991,10.9,27,14,12,12,3,19,31,61.3,12,8,2,6,9,36,34,0
Caetano,BRA,DF,Corinthians,25-115,1999,3.1,4,3,2,2,0,2,3,66.7,1,4,4,0,4,8,20,0
Jonathan Cafu,BRA,"FW,MF",Cuiabá,33-099,1991,13.5,16,11,7,8,1,7,22,31.8,15,8,0,8,9,25,8,0
Rodrigo Caio,BRA,DF,Grêmio,31-061,1993,2.2,6,4,4,2,0,3,6,50.0,3,7,5,2,1,7,10,0
Caíque,BRA,GK,Grêmio,27-078,1997,3.9,0,0,0,0,0,0,0,,0,0,0,0,0,0,0,0
Calebe,BRA,"FW,MF",Fortaleza,24-170,2000,0.5,0,0,0,0,0,0,1,0.0,1,0,0,0,0,0,0,0
Lucas Calegari,BRA,DF,Fluminense,22-233,2002,0.9,4,4,2,1,1,2,2,100.0,0,1,1,0,1,5,1,0
Jonathan Calleri,ARG,FW,São Paulo,31-024,1993,19.8,10,9,0,8,2,2,10,20.0,8,7,2,5,3,13,17,0
Patric Calmon PK,BRA,DF,Vitória,30-104,1994,5.5,10,5,4,5,1,6,8,75.0,2,7,4,3,15,25,16,0
Gustavo Campanharo,BRA,MF,Atl Goianiense,32-196,1992,0.2,2,1,2,0,0,0,1,0.0,1,1,0,1,0,2,2,0
Joel Campbell,CRC,"MF,FW",Atl Goianiense,32-113,1992,6.0,13,10,2,6,5,8,12,66.7,4,3,0,3,2,15,2,0
Camutanga,BRA,DF,Vitória,31-020,1993,5.0,8,5,7,0,1,5,9,55.6,4,7,6,1,2,10,19,0
Yerson Candelo,COL,DF,Criciúma,32-236,1992,0.3,3,1,1,2,0,0,0,,0,0,0,0,1,4,0,0
Luan Cândido,BRA,DF,Red Bull Bragantino,23-258,2001,20.0,40,27,20,18,2,16,28,57.1,12,23,14,9,30,70,94,1
Germán Cano,ARG,FW,Fluminense,36-258,1988,13.9,7,5,1,4,2,4,6,66.7,2,4,2,2,1,8,9,1
Agustín Canobbio,URU,"FW,MF",Ath Paranaense,26-016,1998,11.7,26,16,6,16,4,10,28,35.7,18,20,0,20,4,30,6,0
Juninho Capixaba,BRA,"DF,MF",Red Bull Bragantino,27-103,1997,13.1,43,28,23,16,4,20,38,52.6,18,19,7,12,23,66,45,1
Felipe Carballo,URU,MF,Grêmio,28-013,1996,5.3,15,10,6,9,0,5,22,22.7,17,5,0,5,4,19,9,0
Tomás Cardona,ARG,DF,Fortaleza,29-007,1995,15.0,24,17,16,8,0,13,22,59.1,9,32,18,14,25,49,92,4
Edson Carioca,BRA,"FW,MF",Juventude,27-105,1997,3.9,9,7,4,2,3,4,7,57.1,3,4,0,4,0,9,3,0
Carlinhos,BRA,FW,Flamengo,27-248,1997,4.7,5,1,2,1,2,2,4,50.0,2,0,0,0,0,5,5,0
Antonio Carlos,BRA,DF,Fluminense,31-224,1993,12.0,6,4,5,1,0,2,4,50.0,2,12,11,1,20,26,73,1
Jan Carlos Hurtado,VEN,FW,Atl Goianiense,24-226,2000,6.6,3,3,0,2,1,0,6,0.0,6,7,1,6,2,5,6,0
João Carlos,BRA,"MF,FW",Criciúma,23-118,2001,0.3,2,2,0,1,1,2,2,100.0,0,0,0,0,1,3,1,0
Jean Carlos Vicente,BRA,"MF,FW",Juventude,32-245,1992,10.0,5,3,0,5,0,2,7,28.6,5,6,1,5,6,11,4,0
André Carrillo,PER,MF,Corinthians,33-125,1991,1.8,5,2,5,0,0,3,8,37.5,5,7,2,5,2,7,1,0
Ronie Carrillo,ECU,FW,Juventude,28-039,1996,6.9,4,3,0,1,3,1,4,25.0,3,3,1,2,2,6,7,0
Gabriel Carvalho,BRA,"FW,MF",Internacional,17-061,2007,10.6,21,16,6,11,4,8,26,30.8,18,26,0,26,3,24,6,1
Cássio,BRA,GK,Cruzeiro,37-133,1987,14.0,1,1,1,0,0,1,1,100.0,0,0,0,0,1,2,2,0
Cássio,BRA,GK,Corinthians,37-133,1987,3.0,0,0,0,0,0,0,0,,0,0,0,0,0,0,0,1
Iury de Castilho,BRA,"FW,MF",Vitória,29-041,1995,1.4,2,0,2,0,0,1,1,100.0,0,2,0,2,0,2,1,0
Erick Castillo,ECU,"FW,MF",Vitória,29-255,1995,3.0,2,0,2,0,0,2,4,50.0,2,4,0,4,0,2,4,0
Ivan Cavaleiro,POR,"FW,MF",Red Bull Bragantino,30-365,1993,0.6,1,1,0,1,0,1,1,100.0,0,0,0,0,0,1,0,0
Murilo Cerqueira,BRA,DF,Palmeiras,27-204,1997,20.5,34,22,13,18,3,13,23,56.5,10,16,10,6,19,53,85,0
Reynaldo Cesar Moraes,BRA,DF,Vitória,27-288,1997,4.0,10,6,6,4,0,3,6,50.0,3,9,5,4,0,10,22,0
Christian,BRA,"MF,FW",Ath Paranaense,23-303,2000,14.8,26,14,10,14,2,9,20,45.0,11,13,3,10,10,36,9,0
Eliel Chrystian,BRA,"FW,MF",Cuiabá,21-265,2003,3.9,7,5,3,2,2,2,6,33.3,4,6,1,5,1,8,7,0
Chumbinho,BRA,"MF,FW",Red Bull Bragantino,21-025,2003,0.1,0,0,0,0,0,0,0,,0,1,0,1,0,0,0,0
Cicinho,BUL,"DF,FW",Bahia,35-296,1988,0.9,1,1,1,0,0,1,2,50.0,1,2,1,1,0,1,0,1
José Cifuentes,ECU,MF,Cruzeiro,25-219,1999,0.8,3,2,0,2,1,2,3,66.7,1,0,0,0,0,3,3,0
Claudinho,BRA,DF,Criciúma,24-023,2000,19.0,51,35,31,14,6,31,74,41.9,43,32,8,24,26,77,40,0
Mateus Claus,BRA,GK,Juventude,30-075,1994,3.5,0,0,0,0,0,0,0,,0,0,0,0,0,0,2,2
Clayson,BRA,"FW,MF",Cuiabá,29-212,1995,15.0,7,5,1,4,2,3,26,11.5,23,17,1,16,7,14,14,0
Clayton,BRA,DF,Internacional,24-196,2000,2.0,1,0,1,0,0,0,1,0.0,1,2,2,0,1,2,10,0
Clayton,BRA,FW,Vasco da Gama,25-280,1999,1.6,3,3,1,0,2,1,1,100.0,0,1,1,0,1,4,2,0
Cleiton,BRA,DF,Flamengo,21-175,2003,1.1,2,2,2,0,0,1,2,50.0,1,0,0,0,0,2,0,0
Mateus Cocão,BRA,MF,Vasco da Gama,22-213,2002,16.5,64,39,29,32,3,25,49,51.0,24,31,6,25,24,88,13,1
Robert Conceição,BRA,"MF,DF",Atlético Mineiro,21-089,2003,0.2,0,0,0,0,0,0,0,,0,0,0,0,0,0,0,0
Igor Coronado,BRA,"MF,FW",Corinthians,32-060,1992,13.4,29,15,10,12,7,13,30,43.3,17,26,4,22,9,38,7,0
Diego Costa,ESP,FW,Grêmio,36-010,1988,3.2,3,1,0,2,1,1,1,100.0,0,1,1,0,0,3,1,0
Douglas Costa,BRA,FW,Fluminense,34-033,1990,3.2,6,6,3,2,1,1,3,33.3,2,4,0,4,2,8,2,0
Philippe Coutinho,BRA,MF,Vasco da Gama,32-127,1992,3.4,7,4,1,3,3,3,3,100.0,0,0,0,0,4,11,0,0
Franco Cristaldo,ARG,"MF,FW",Grêmio,28-063,1996,19.1,30,21,6,20,4,9,30,30.0,21,17,1,16,11,41,12,0
Alejo Cruz,URU,"MF,FW",Atl Goianiense,24-046,2000,16.1,26,18,11,11,4,13,30,43.3,17,22,2,20,17,43,17,0
Tomás Cuello,ARG,"FW,MF",Ath Paranaense,24-226,2000,13.0,21,15,15,6,0,10,22,45.5,12,21,3,18,11,32,8,0
Víctor Cuesta,ARG,DF,Bahia,35-333,1988,5.6,12,9,4,7,1,7,10,70.0,3,7,2,5,5,17,23,0
Cuiabano,BRA,DF,Grêmio,21-244,2003,1.8,3,0,2,1,0,2,2,100.0,0,4,2,2,5,8,5,0
Cuiabano,BRA,DF,Botafogo (RJ),21-244,2003,13.4,41,29,22,15,4,20,30,66.7,10,17,2,15,21,62,45,0
Lucas Cunha,BRA,DF,Red Bull Bragantino,27-268,1997,5.7,9,7,7,1,1,4,7,57.1,3,7,6,1,3,12,32,0
Matheus Cunha,BRA,GK,Flamengo,23-146,2001,2.0,0,0,0,0,0,0,0,,0,0,0,0,0,0,0,0
Danielzinho,BRA,"MF,FW",Atl Goianiense,28-280,1996,1.1,1,1,0,1,0,0,1,0.0,1,0,0,0,0,1,1,0
David,BRA,FW,Vasco da Gama,29-000,1995,17.6,21,15,8,10,3,6,21,28.6,15,10,1,9,9,30,10,1
David,BRA,"MF,FW",Juventude,24-282,2000,0.7,0,0,0,0,0,0,2,0.0,2,1,0,1,0,0,2,0
Giorgian De Arrascaeta,URU,MF,Flamengo,30-138,1994,10.0,14,10,3,6,5,7,25,28.0,18,12,1,11,4,18,3,0
Nicolás De La Cruz,URU,MF,Flamengo,27-138,1997,9.5,19,13,2,11,6,8,18,44.4,10,15,3,12,8,27,5,1
Sergio Antonio De Luiz Junior,BRA,MF,Criciúma,29-194,1995,0.2,1,1,1,0,0,0,2,0.0,2,0,0,0,0,1,0,0
Sergio Antonio De Luiz Junior,BRA,"FW,MF",Vasco da Gama,29-194,1995,0.5,0,0,0,0,0,0,1,0.0,1,0,0,0,0,0,0,0
Denilson,BRA,MF,Cuiabá,23-208,2001,17.4,34,13,12,16,6,16,26,61.5,10,8,0,8,8,42,11,0
Derek,BRA,FW,Atl Goianiense,26-320,1997,5.2,11,6,1,7,3,3,6,50.0,3,10,0,10,2,13,2,0
Deyverson,BRA,FW,Atlético Mineiro,33-162,1991,6.0,2,0,1,0,1,0,2,0.0,2,4,1,3,0,2,9,0
Deyverson,BRA,FW,Cuiabá,33-162,1991,2.4,2,1,1,0,1,1,2,50.0,1,2,0,2,1,3,3,0
Lucas Di Yorio,ARG,FW,Ath Paranaense,27-330,1996,8.1,4,2,1,2,1,1,5,20.0,4,5,0,5,2,6,9,0
Matheus Dias,BRA,"FW,MF",Internacional,27-253,1997,0.8,3,2,1,2,0,3,5,60.0,2,0,0,0,1,4,0,0
Lautaro Díaz,ARG,FW,Cruzeiro,26-149,1998,6.6,8,7,1,4,3,2,3,66.7,1,2,0,2,3,11,7,0
Diego,BRA,DF,São Paulo,25-088,1999,9.9,13,8,8,5,0,6,11,54.5,5,10,5,5,12,25,49,0
Dodi,BRA,MF,Grêmio,28-183,1996,20.2,60,33,22,32,6,29,43,67.4,14,19,6,13,32,92,22,0
Maxime Dominguez,SUI,"FW,MF",Vasco da Gama,28-259,1996,0.7,2,0,1,1,0,0,3,0.0,3,1,0,1,1,3,1,0
Matheus Donelli,BRA,GK,Corinthians,22-153,2002,7.0,0,0,0,0,0,0,0,,0,0,0,0,0,0,1,0
Thiago dos Santos,BRA,DF,Fluminense,35-042,1989,14.9,25,16,22,3,0,19,31,61.3,12,18,12,6,23,48,68,1
Lucca Drummond,BRA,FW,Internacional,20-279,2004,1.8,2,0,0,1,1,0,0,,0,0,0,0,0,2,0,0
David Duarte,BRA,DF,Bahia,29-267,1995,0.8,0,0,0,0,0,0,0,,0,1,1,0,0,0,3,1
Dudu,BRA,MF,Vitória,25-134,1999,3.3,12,6,6,6,0,2,9,22.2,7,7,0,7,2,14,1,0
Dudu,BRA,"FW,MF",Palmeiras,32-284,1992,3.7,3,3,0,3,0,2,2,100.0,0,0,0,0,2,5,1,0
Edenílson,BRA,"MF,FW",Grêmio,34-304,1989,11.3,10,5,6,2,2,3,6,50.0,3,8,2,6,7,17,10,0
Éder,ITA,FW,Criciúma,37-337,1986,8.5,7,4,0,4,3,2,3,66.7,1,2,0,2,1,8,0,0
EDU,BRA,DF,Vitória,24-123,2000,2.0,4,2,3,0,1,1,2,50.0,1,3,2,1,1,5,14,0
Carlos Eduardo,BRA,"FW,MF",Vitória,28-007,1996,5.1,14,13,7,4,3,7,11,63.6,4,4,0,4,1,15,13,0
Carlos Eduardo,BRA,"FW,MF",Atlético Mineiro,20-146,2004,11.2,29,19,10,13,6,10,17,58.8,7,8,1,7,9,38,9,0
Carlos Eduardo,BRA,"FW,MF",Botafogo (RJ),35-000,1989,6.8,5,3,3,2,0,2,6,33.3,4,3,1,2,6,11,2,0
Alysson Edward,BRA,"MF,FW",Grêmio,18-165,2006,0.5,1,1,0,1,0,0,2,0.0,2,2,0,2,0,1,2,0
Eli,BRA,FW,Atl Goianiense,20-208,2004,0.2,1,1,0,1,0,0,1,0.0,1,0,0,0,0,1,0,0
Kauã Elias,BRA,FW,Fluminense,18-203,2006,10.4,17,7,3,6,8,10,13,76.9,3,3,0,3,3,20,5,0
Rafael Elias,BRA,FW,Cruzeiro,25-188,1999,1.1,0,0,0,0,0,0,5,0.0,5,1,1,0,0,0,2,0
Eliédson,BRA,MF,Criciúma,21-214,2003,0.3,2,2,2,0,0,2,3,66.7,1,2,1,1,0,2,1,0
Rodrigo Ely,BRA,DF,Grêmio,30-349,1993,13.9,28,18,18,10,0,15,18,83.3,3,23,18,5,18,46,57,1
Emersonn,BRA,"FW,MF",Ath Paranaense,20-093,2004,1.8,3,1,0,3,0,0,1,0.0,1,1,0,1,1,4,2,0
Leandro Emmanuel Martínez,ARG,"MF,FW",Fortaleza,30-135,1994,5.8,15,7,6,7,2,9,18,50.0,9,12,3,9,2,17,2,2
Alan Empereur,BRA,DF,Cuiabá,30-221,1994,23.8,17,13,12,5,0,11,19,57.9,8,16,10,6,21,38,92,1
Endrick,BRA,"MF,FW",Palmeiras,18-088,2006,5.0,5,2,1,4,0,3,5,60.0,2,5,0,5,0,5,2,0
Erick,BRA,"MF,DF",Ath Paranaense,26-338,1997,20.9,34,26,18,13,3,11,35,31.4,24,40,8,32,33,67,39,0
Erick,BRA,"FW,MF",São Paulo,26-312,1997,5.7,9,5,4,4,1,1,3,33.3,2,3,0,3,4,13,5,1
Erick,BRA,FW,Juventude,27-288,1997,19.1,18,15,5,10,3,8,16,50.0,8,18,5,13,11,29,12,2
Esquerdinha,BRA,"DF,FW",Fluminense,18-232,2006,1.4,0,0,0,0,0,0,2,0.0,2,2,1,1,0,0,4,0
Lucas Esquivel,ARG,DF,Ath Paranaense,23-003,2001,20.6,52,34,20,28,4,23,48,47.9,25,20,6,14,25,77,70,0
Estevão,BRA,FW,Palmeiras,18-176,2006,15.7,23,18,12,5,6,11,32,34.4,21,8,0,8,6,29,7,0
Lucas Esteves,BRA,"DF,MF",Vitória,24-115,2000,24.6,44,32,29,13,2,21,34,61.8,13,25,6,19,22,66,63,0
Guilherme Estrella,BRA,MF,Vasco da Gama,19-178,2005,1.6,0,0,0,0,0,0,0,,0,1,0,1,3,3,0,0
Oscar Estupiñan,COL,"FW,MF",Bahia,27-293,1996,2.8,2,1,1,1,0,0,3,0.0,3,1,0,1,1,3,5,0
Lucas Evangelista,BRA,MF,Red Bull Bragantino,29-164,1995,19.7,31,16,13,16,2,15,26,57.7,11,20,8,12,13,44,21,0
Everaldo,BRA,"MF,FW",Vitória,30-142,1994,2.4,4,3,3,1,0,3,6,50.0,3,0,0,0,0,4,2,1
Éverson,BRA,GK,Atlético Mineiro,34-087,1990,17.9,1,1,1,0,0,1,1,100.0,0,0,0,0,0,1,5,1
Everton,BRA,"FW,MF",Grêmio,27-214,1997,5.1,6,5,2,2,2,4,7,57.1,3,4,1,3,1,7,5,0
Everton,BRA,FW,Red Bull Bragantino,22-236,2002,0.3,0,0,0,0,0,0,0,,0,1,0,1,0,0,0,0
Evertton,BRA,MF,Flamengo,21-232,2003,2.0,7,6,2,1,4,3,5,60.0,2,4,1,3,3,10,4,0
Ewerton,BRA,"DF,FW",Juventude,23-342,2000,7.8,14,6,9,4,1,8,15,53.3,7,3,2,1,6,20,30,1
Fabiano,BRA,DF,Botafogo (RJ),18-185,2006,0.2,3,2,2,1,0,1,2,50.0,1,0,0,0,0,3,0,0
Bruno Fabiano Alves,BRA,DF,Cuiabá,33-184,1991,13.4,15,7,11,4,0,9,18,50.0,9,13,5,8,17,32,79,0
Fabinho,BRA,MF,Palmeiras,22-191,2002,5.4,6,4,4,1,1,1,9,11.1,8,10,3,7,6,12,6,0
Fábio,BRA,GK,Fluminense,44-017,1980,28.0,2,1,2,0,0,2,2,100.0,0,0,0,0,2,4,17,4
Fábio,BRA,DF,Grêmio,34-100,1990,7.5,12,7,5,5,2,6,12,50.0,6,5,1,4,5,17,16,0
Fabrício,BRA,GK,Internacional,38-284,1986,8.0,0,0,0,0,0,0,0,,0,0,0,0,0,0,2,0
Fabrício,BRA,GK,Red Bull Bragantino,24-124,2000,1.0,0,0,0,0,0,0,0,,0,0,0,0,0,0,0,0
Fagner,BRA,DF,Corinthians,35-128,1989,9.1,20,8,10,7,3,11,22,50.0,11,7,3,4,11,31,12,1
Rodrigo Fagundes,BRA,DF,Criciúma,37-221,1987,24.0,37,30,27,7,3,22,28,78.6,6,39,23,16,32,69,150,1
Luiz Felipe,BRA,DF,Atl Goianiense,31-038,1993,9.1,11,8,7,4,0,5,12,41.7,7,10,8,2,15,26,44,0
Marcos Felipe,BRA,GK,Bahia,28-187,1996,29.0,2,1,2,0,0,2,3,66.7,1,0,0,0,0,2,21,2
Lucas Fernandes,BRA,"MF,FW",Cuiabá,27-027,1997,9.1,9,4,1,7,1,5,10,50.0,5,3,0,3,7,16,1,0
Matheus Fernandes,BRA,MF,Red Bull Bragantino,26-109,1998,5.4,24,19,9,11,4,8,15,53.3,7,10,1,9,11,35,14,0
Nathan Fernandes,BRA,"FW,MF",Grêmio,19-244,2005,5.5,8,6,2,5,1,2,8,25.0,6,5,0,5,4,12,5,0
Gatito Fernández,PAR,GK,Botafogo (RJ),36-202,1988,3.0,0,0,0,0,0,0,0,,0,0,0,0,0,0,3,0
Fernandinho,BRA,MF,Ath Paranaense,39-166,1985,15.2,24,18,8,12,4,9,18,50.0,9,10,3,7,10,34,22,0
Fernando,BRA,DF,Ath Paranaense,25-033,1999,6.3,8,4,5,1,2,6,11,54.5,5,6,0,6,12,20,10,0
Fernando,BRA,"MF,DF",Internacional,37-084,1987,14.3,26,19,13,12,1,11,18,61.1,7,12,5,7,19,45,42,0
Luiz Fernando,BRA,"FW,MF",Atl Goianiense,28-001,1996,23.2,19,11,8,7,4,5,18,27.8,13,33,5,28,13,32,23,0
Nahuel Ferraresi,VEN,DF,São Paulo,25-333,1998,10.0,21,18,10,9,2,14,27,51.9,13,23,10,13,8,29,43,0
Ferreira,BRA,"FW,MF",São Paulo,26-291,1997,9.5,17,12,9,6,2,7,14,50.0,7,9,1,8,4,21,4,0
Jean Carlos Alves Ferreira,BRA,"MF,FW",Atl Goianiense,19-162,2005,0.1,0,0,0,0,0,0,0,,0,0,0,0,2,2,0,0
Tobias Figueiredo,POR,DF,Criciúma,30-258,1994,15.1,15,11,10,5,0,9,16,56.3,7,26,23,3,21,36,87,0
Filipinho,BRA,MF,Ath Paranaense,22-365,2001,2.0,15,9,6,6,3,6,10,60.0,4,6,2,4,6,21,2,0
Alan Franco,ECU,MF,Atlético Mineiro,26-057,1998,15.1,26,15,9,12,5,13,19,68.4,6,10,1,9,18,44,10,0
Alan Franco,ARG,DF,São Paulo,28-006,1996,16.5,19,12,11,7,1,9,18,50.0,9,15,11,4,8,27,59,1
Gonzalo Freitas,URU,MF,Atl Goianiense,33-015,1991,6.9,17,10,7,6,4,6,16,37.5,10,6,3,3,10,27,22,0
Lucas Freitas,BRA,DF,Juventude,23-271,2001,7.3,5,5,3,2,0,1,4,25.0,3,12,10,2,5,10,31,0
Marlon Freitas,BRA,MF,Botafogo (RJ),29-204,1995,19.4,32,21,17,14,1,21,31,67.7,10,29,13,16,16,48,31,0
Bruno Fuchs,BRA,DF,Atlético Mineiro,25-199,1999,18.6,36,22,22,9,5,24,32,75.0,8,24,13,11,24,60,73,0
Gabriel Fuentes,COL,DF,Fluminense,27-251,1997,0.4,1,1,0,1,0,0,1,0.0,1,0,0,0,0,1,3,0
Gabriel,BRA,DF,Bahia,23-164,2001,27.0,52,37,35,16,1,23,29,79.3,6,40,25,15,42,94,155,2
Gabriel,BRA,MF,Ath Paranaense,32-099,1992,11.0,32,21,12,18,2,13,36,36.1,23,15,3,12,16,48,18,0
Gabriel,BRA,MF,Fluminense,31-029,1993,2.6,10,7,4,4,2,6,12,50.0,6,3,0,3,10,20,3,2
Gabriel,BRA,GK,Juventude,32-020,1992,25.5,1,0,1,0,0,1,4,25.0,3,0,0,0,0,1,23,0
Marquinhos Gabriel,BRA,MF,Criciúma,34-088,1990,10.4,13,6,8,4,1,6,12,50.0,6,9,1,8,6,19,9,0
Zé Gabriel,BRA,MF,Vasco da Gama,25-270,1999,5.1,15,11,3,8,4,9,12,75.0,3,3,3,0,5,20,10,0
Pablo Galdames Millán,CHI,MF,Vasco da Gama,27-292,1996,8.7,19,11,7,10,2,9,24,37.5,15,11,2,9,10,29,13,0
Giuliano Galoppo,ARG,MF,São Paulo,25-121,1999,4.3,7,4,1,5,1,3,8,37.5,5,4,0,4,6,13,5,1
Léo Gamalho,BRA,FW,Vitória,38-261,1986,0.2,0,0,0,0,0,0,0,,0,0,0,0,0,0,0,0
Mateo Gamarra,PAR,DF,Ath Paranaense,23-363,2000,13.3,26,14,18,8,0,13,23,56.5,10,23,13,10,19,45,53,0
Ganso,BRA,MF,Fluminense,35-005,1989,19.7,31,21,12,16,3,11,23,47.8,12,12,2,10,11,42,10,1
García,BRA,"MF,FW",Palmeiras,22-287,2002,0.1,0,0,0,0,0,0,0,,0,1,0,1,0,0,1,0
Luan Garcia,BRA,DF,Palmeiras,31-160,1993,2.6,2,1,0,2,0,1,3,33.3,2,2,2,0,2,4,5,1
Rodrigo Garro,ARG,"MF,FW",Corinthians,26-287,1998,25.3,36,23,9,17,10,15,63,23.8,48,22,3,19,20,56,9,0
Wesley Gasolina,BRA,"DF,MF",Cruzeiro,24-218,2000,0.5,1,1,0,1,0,0,0,,0,0,0,0,0,1,0,0
Pedro Geromel,BRA,DF,Grêmio,39-026,1985,6.0,8,7,5,3,0,4,8,50.0,4,9,7,2,4,12,33,0
Gerson,BRA,"MF,FW",Flamengo,27-150,1997,22.3,49,34,24,16,9,14,30,46.7,16,16,3,13,4,53,16,0
Agustín Giay,ARG,DF,Palmeiras,20-275,2004,5.5,24,10,15,7,2,15,25,60.0,10,6,2,4,6,30,9,0
Gilberto,BRA,DF,Bahia,31-224,1993,10.3,24,15,15,6,3,19,27,70.4,8,10,2,8,5,29,20,0
Gilberto,BRA,FW,Juventude,35-134,1989,9.7,6,2,2,3,1,3,8,37.5,5,5,0,5,2,8,14,0
Luciano Giménez,ARG,"FW,MF",Cuiabá,24-242,2000,0.8,0,0,0,0,0,0,1,0.0,1,1,0,1,0,0,1,0
Giovane,BRA,"FW,MF",Corinthians,20-328,2003,3.0,0,0,0,0,0,0,3,0.0,3,0,0,0,0,0,3,0
Leonardo Godoy,ARG,DF,Ath Paranaense,29-172,1995,11.9,13,11,10,3,0,4,12,33.3,8,11,4,7,7,20,21,0
Davi Goes,BRA,MF,Juventude,19-117,2005,0.6,2,2,1,1,0,1,2,50.0,1,0,0,0,0,2,1,0
Bruno Gomes,BRA,"DF,MF",Internacional,23-196,2001,15.0,40,23,21,13,6,17,31,54.8,14,17,3,14,12,52,40,1
Igor Gomes,BRA,MF,Atlético Mineiro,25-214,1999,12.2,15,11,8,5,2,6,12,50.0,6,16,0,16,7,22,9,0
Igor Gomes,BRA,DF,Internacional,23-225,2001,7.6,15,9,8,6,1,11,19,57.9,8,16,9,7,7,22,34,0
William Gomes,BRA,"FW,MF",São Paulo,18-216,2006,3.9,8,7,5,3,0,4,12,33.3,8,7,0,7,2,10,0,0
Gustavo Gómez,PAR,DF,Palmeiras,31-164,1993,19.0,26,18,12,13,1,9,15,60.0,6,28,21,7,24,50,79,0
Diego Gonçalves,BRA,"FW,MF",Juventude,30-087,1994,1.5,4,3,0,2,2,1,7,14.3,6,2,0,2,1,5,4,0
Mateus Gonçalves Martins,BRA,"MF,FW",Vitória,30-019,1994,2.3,2,1,0,2,0,0,1,0.0,1,0,0,0,0,2,2,0
Matheus Gonçalves,BRA,"FW,MF",Flamengo,19-060,2005,4.1,8,4,3,2,3,3,11,27.3,8,3,0,3,4,12,3,0
Yony González,COL,"FW,MF",Atl Goianiense,30-098,1994,3.0,2,2,1,1,0,1,1,100.0,0,5,1,4,1,3,5,0
Gregore,BRA,MF,Botafogo (RJ),30-229,1994,15.9,67,45,34,29,4,27,55,49.1,28,22,7,15,21,88,39,0
Guga,BRA,DF,Fluminense,26-049,1998,2.9,6,6,2,4,0,5,5,100.0,0,6,3,3,2,8,14,0
Guilherme,BRA,DF,Red Bull Bragantino,22-246,2002,7.0,14,8,12,2,0,9,14,64.3,5,7,2,5,10,24,32,0
Luis Guilherme,BRA,"FW,DF",Palmeiras,18-251,2006,2.0,2,2,1,0,1,1,1,100.0,0,0,0,0,0,2,1,0
Zé Guilherme,BRA,DF,Grêmio,19-215,2005,2.5,11,7,8,3,0,5,10,50.0,5,2,1,1,7,18,3,0
Gustavinho,BRA,"MF,FW",Red Bull Bragantino,20-177,2004,9.0,22,9,6,10,6,8,21,38.1,13,13,1,12,4,26,10,0
Gustavo,BRA,GK,Criciúma,31-221,1993,25.7,0,0,0,0,0,0,0,,0,0,0,0,0,0,7,1
Luiz Gustavo,BRA,DF,Atl Goianiense,21-140,2003,0.5,0,0,0,0,0,0,1,0.0,1,1,0,1,1,1,1,0
Luiz Gustavo,BRA,MF,São Paulo,37-086,1987,17.7,27,15,13,13,1,11,21,52.4,10,15,6,9,26,53,14,1
Ryan Gustavo,BRA,MF,Corinthians,21-094,2003,5.8,27,14,9,16,2,14,28,50.0,14,12,1,11,7,34,10,0
Rafael Haller,URU,DF,Atl Goianiense,24-061,2000,0.6,2,1,1,0,1,1,3,33.3,2,1,1,0,2,4,3,0
Lucas Halter,BRA,DF,Botafogo (RJ),24-168,2000,14.8,12,10,11,1,0,9,20,45.0,11,7,7,0,11,23,67,2
Héctor,ESP,"FW,DF",Corinthians,29-033,1995,0.7,0,0,0,0,0,0,0,,0,0,0,0,0,0,0,0
Thiago Heleno,BRA,DF,Ath Paranaense,36-030,1988,16.5,16,9,9,7,0,6,11,54.5,5,31,22,9,21,37,70,1
Helinho,BRA,"FW,MF",Red Bull Bragantino,24-175,2000,12.2,9,6,2,2,5,1,11,9.1,10,18,0,18,10,19,11,0
Henrique,BRA,FW,São Paulo,17-343,2006,0.1,0,0,0,0,0,0,0,,0,0,0,0,0,0,0,0
Bruno Henrique,BRA,FW,Flamengo,33-292,1990,14.9,20,12,6,8,6,5,17,29.4,12,15,0,15,10,30,12,0
Bruno Henrique,BRA,"MF,FW",Internacional,34-362,1989,16.0,31,21,7,17,7,19,44,43.2,25,26,7,19,11,42,28,0
Gustavo Henrique,BRA,DF,Corinthians,31-207,1993,10.4,13,8,7,5,1,6,6,100.0,0,14,11,3,13,26,46,0
Luiz Henrique,BRA,"FW,MF",Botafogo (RJ),23-289,2001,21.2,40,26,16,15,9,12,31,38.7,19,23,3,20,10,50,25,0
Matheus Henrique,BRA,"MF,FW",Cruzeiro,26-303,1997,10.9,20,11,7,9,4,9,13,69.2,4,16,5,11,6,26,10,0
Paulo Henrique,BRA,DF,Vasco da Gama,28-084,1996,22.4,81,49,48,26,7,45,72,62.5,27,29,12,17,34,115,58,0
Pedro Henrique,BRA,"FW,MF",Corinthians,34-123,1990,3.8,8,4,3,3,2,2,4,50.0,2,2,0,2,1,9,4,0
Pedro Henrique,BRA,DF,Red Bull Bragantino,29-015,1995,17.8,34,25,28,6,0,19,30,63.3,11,18,11,7,11,45,75,3
Hércules,BRA,MF,Fortaleza,23-363,2000,19.0,40,24,15,22,3,15,44,34.1,29,17,3,14,5,45,21,0
Marcelo Hermes,BRA,"DF,MF",Criciúma,29-259,1995,26.6,42,26,26,10,6,28,50,56.0,22,28,6,22,34,76,75,0
Diego Hernández,URU,"FW,MF",Botafogo (RJ),24-117,2000,2.3,6,4,2,3,1,3,5,60.0,2,5,1,4,1,7,4,0
Lucca Holanda,BRA,"FW,MF",Internacional,21-198,2003,3.0,3,3,0,1,2,2,5,40.0,3,2,0,2,0,3,0,0
Hugo,BRA,DF,Corinthians,27-049,1997,19.3,48,22,22,19,7,26,44,59.1,18,17,5,12,21,69,68,0
Hugo,BRA,DF,Botafogo (RJ),23-027,2001,4.9,11,7,9,1,1,6,12,50.0,6,4,1,3,5,16,11,0
Vitor Hugo Amorim,BRA,"MF,FW",Cruzeiro,20-242,2004,4.8,8,3,3,5,0,4,6,66.7,2,4,2,2,3,11,4,0
José Hugo,BRA,"MF,FW",Vitória,25-000,1999,5.9,13,11,5,6,2,7,12,58.3,5,4,0,4,5,18,4,0
Victor Hugo,BRA,MF,Atlético Mineiro,19-341,2004,0.0,0,0,0,0,0,0,1,0.0,1,0,0,0,0,0,0,0
Victor Hugo,BRA,"FW,MF",Flamengo,20-159,2004,2.9,5,4,2,2,1,2,6,33.3,4,2,0,2,0,5,2,0
Victor Hugo,BRA,MF,Fluminense,20-160,2004,0.5,0,0,0,0,0,0,1,0.0,1,0,0,0,1,1,0,0
Vitor Hugo,BRA,DF,Bahia,33-150,1991,0.2,0,0,0,0,0,0,1,0.0,1,0,0,0,1,1,1,0
Hulk,BRA,FW,Atlético Mineiro,38-084,1986,16.1,9,4,1,5,3,4,10,40.0,6,5,2,3,1,10,11,0
José Hurtado,ECU,DF,Red Bull Bragantino,22-299,2001,8.4,15,10,7,6,2,9,14,64.3,5,4,2,2,10,25,32,1
Hyoran,BRA,"FW,MF",Internacional,31-145,1993,3.7,8,6,2,5,1,3,9,33.3,6,4,0,4,0,8,3,1
Iago,BRA,"DF,MF",Bahia,27-208,1997,4.2,10,7,5,5,0,4,7,57.1,3,6,3,3,6,16,9,0
Ignácio,BRA,DF,Fluminense,27-321,1996,2.0,11,6,8,2,1,4,4,100.0,0,3,2,1,0,11,8,0
Juan Ignacio Dinenno,ARG,"FW,DF",Cruzeiro,30-050,1994,2.7,4,2,0,4,0,1,2,50.0,1,1,0,1,0,4,3,0
Igor,BRA,MF,Flamengo,21-224,2003,0.8,4,3,2,1,1,1,1,100.0,0,4,2,2,3,7,0,0
Igor,BRA,FW,Botafogo (RJ),23-235,2001,8.7,2,2,0,2,0,1,6,16.7,5,11,2,9,1,3,6,0
Gabriel Inocêncio,BRA,DF,Juventude,30-058,1994,9.6,28,18,12,14,2,11,21,52.4,10,7,3,4,9,37,27,0
Isaac,BRA,FW,Atlético Mineiro,20-205,2004,0.1,0,0,0,0,0,0,0,,0,0,0,0,0,0,0,0
Isaac,BRA,"FW,DF",Fluminense,20-176,2004,1.7,2,2,0,0,2,2,3,66.7,1,3,0,3,0,2,1,0
Zé Ivaldo,BRA,DF,Cruzeiro,27-239,1997,23.2,28,16,18,9,1,18,33,54.5,15,23,13,10,15,43,99,2
Jadsom,BRA,"MF,DF",Red Bull Bragantino,23-150,2001,13.1,49,32,30,13,6,20,36,55.6,16,8,2,6,18,67,33,0
Jadson,BRA,MF,Juventude,31-048,1993,23.7,64,32,25,35,4,21,45,46.7,24,26,7,19,29,93,12,1
Jadson,BRA,MF,Cuiabá,19-068,2005,0.2,0,0,0,0,0,0,0,,0,0,0,0,0,0,0,0
Janderson,BRA,"FW,MF",Atl Goianiense,25-234,1999,7.6,14,9,7,6,1,6,15,40.0,9,3,0,3,3,17,2,0
Janderson,BRA,"FW,MF",Vitória,25-164,1999,11.2,16,10,7,9,0,4,10,40.0,6,12,2,10,2,18,14,1
Jandrei,BRA,GK,São Paulo,31-230,1993,12.0,0,0,0,0,0,0,0,,0,1,0,1,0,0,5,2
Léo Jardim,BRA,GK,Vasco da Gama,29-211,1995,29.0,0,0,0,0,0,0,0,,0,0,0,0,0,0,12,1
Jeffinho,BRA,"FW,MF",Botafogo (RJ),24-292,1999,3.6,6,2,1,5,0,4,9,44.4,5,1,0,1,2,8,0,0
Jemerson,BRA,DF,Atlético Mineiro,32-054,1992,2.3,2,1,1,1,0,2,2,100.0,0,4,3,1,5,7,4,0
Jemerson,BRA,DF,Grêmio,32-054,1992,4.7,7,3,5,1,1,5,7,71.4,2,10,6,4,4,11,13,0
Caíque de Jesus Gonçalves,BRA,MF,Juventude,29-007,1995,15.8,44,24,20,24,0,17,32,53.1,15,19,6,13,24,68,33,1
John,BRA,GK,Botafogo (RJ),28-247,1996,26.0,0,0,0,0,0,0,1,0.0,1,1,0,1,0,0,15,1
Felipe Jonatan,BRA,DF,Fortaleza,26-245,1998,15.7,20,14,9,8,3,9,25,36.0,16,14,5,9,23,43,64,0
Jonathan,BRA,DF,Cruzeiro,20-143,2004,0.8,2,0,1,1,0,1,2,50.0,1,0,0,0,0,2,3,0
Jonathan,BRA,DF,Criciúma,32-053,1992,6.0,11,5,9,0,2,6,15,40.0,9,9,1,8,6,17,15,0
Kaio Jorge,BRA,FW,Cruzeiro,22-267,2002,10.0,2,1,0,1,1,0,1,0.0,1,5,0,5,0,2,9,0
Jorginho,BRA,"MF,FW",Atl Goianiense,33-286,1991,0.8,1,0,1,0,0,1,3,33.3,2,1,0,1,1,2,1,0
Jhonatan Jowjow,BRA,MF,Palmeiras,22-038,2002,1.6,5,3,2,2,1,0,4,0.0,4,3,0,3,3,8,4,0
Jhonatan Jowjow,BRA,"MF,FW",Red Bull Bragantino,22-038,2002,5.8,16,13,6,5,5,8,10,80.0,2,10,1,9,1,17,4,0
Daniel Jr,BRA,"MF,FW",Vitória,22-161,2002,1.5,3,1,1,2,0,2,4,50.0,2,0,0,0,0,3,0,0
Luciano Juba,BRA,DF,Bahia,25-049,1999,25.9,34,25,22,10,2,26,51,51.0,25,18,4,14,45,79,68,0
Juliano,BRA,FW,Red Bull Bragantino,16-230,2008,0.3,0,0,0,0,0,0,0,,0,0,0,0,0,0,0,0
Julimar,BRA,"FW,MF",Ath Paranaense,23-266,2001,14.6,27,17,5,14,8,11,18,61.1,7,16,1,15,12,39,25,0
Kaiki,BRA,DF,Cruzeiro,21-223,2003,10.3,33,26,13,17,3,11,19,57.9,8,10,1,9,21,54,34,1
Lucas Kal,BRA,"MF,DF",Atl Goianiense,28-215,1996,12.8,14,7,7,4,3,7,16,43.8,9,13,3,10,15,29,21,0
Walter Kannemann,ARG,DF,Grêmio,33-217,1991,11.1,18,12,12,5,1,9,20,45.0,11,16,7,9,19,37,52,0
Kanu,BRA,DF,Bahia,27-224,1997,22.0,21,9,12,9,0,10,16,62.5,6,29,14,15,25,46,67,1
Alan Kardec,BRA,"FW,DF",Atlético Mineiro,35-279,1989,2.2,1,0,0,0,1,1,1,100.0,0,2,1,1,0,1,7,0
Kauan,BRA,MF,Fortaleza,19-184,2005,0.6,1,0,0,1,0,0,2,0.0,2,1,0,1,1,2,1,0
Kauê,BRA,"MF,FW",Botafogo (RJ),19-361,2004,1.9,3,0,2,0,1,1,4,25.0,3,3,0,3,0,3,5,0
Kayke,BRA,"MF,FW",Corinthians,20-172,2004,0.2,0,0,0,0,0,0,0,,0,0,0,0,0,0,0,0
Renato Kayser,BRA,FW,Criciúma,28-243,1996,0.9,0,0,0,0,0,0,0,,0,1,0,1,0,0,1,0
Renato Kayser,BRA,FW,Fortaleza,28-243,1996,11.9,15,7,2,9,4,4,15,26.7,11,10,0,10,2,17,15,0
John Kennedy,BRA,"FW,MF",Fluminense,22-152,2002,7.3,5,3,0,4,1,2,7,28.6,5,6,1,5,0,5,8,0
Keno,BRA,"FW,MF",Fluminense,35-037,1989,10.8,24,14,3,14,7,6,16,37.5,10,7,3,4,8,32,12,1
Kleiton,BRA,FW,Juventude,25-177,1999,0.3,0,0,0,0,0,0,0,,0,0,0,0,0,0,0,0
Gabriel Knesowitsch,BRA,DF,Cuiabá,20-365,2003,2.2,5,5,4,1,0,3,4,75.0,1,0,0,0,3,8,4,0
Benjamín Kuscevic,CHI,DF,Fortaleza,28-168,1996,13.6,23,14,15,7,1,13,17,76.5,4,21,16,5,14,37,89,2
Matías Lacava,VEN,"FW,MF",Atl Goianiense,21-359,2002,2.3,4,3,2,1,1,0,2,0.0,2,1,0,1,1,5,0,0
Derik Lacerda,BRA,"FW,MF",Cuiabá,25-020,1999,11.4,14,8,6,6,2,4,7,57.1,3,9,1,8,2,16,7,0
Ignacio Laquintana,URU,"FW,MF",Red Bull Bragantino,25-259,1999,3.1,3,1,2,1,0,1,4,25.0,3,1,0,1,3,6,1,0
Lawan,BRA,FW,Vitória,19-145,2005,1.2,0,0,0,0,0,0,1,0.0,1,0,0,0,0,0,1,0
Lázaro,BRA,"FW,MF",Palmeiras,22-219,2002,8.5,7,3,1,1,5,4,7,57.1,3,8,0,8,0,7,2,0
Leandrinho,BRA,"DF,FW",Vasco da Gama,19-214,2005,3.3,7,5,6,1,0,3,6,50.0,3,5,0,5,1,8,13,0
Mauricio Lemos,URU,DF,Atlético Mineiro,28-294,1995,3.2,3,2,1,2,0,1,3,33.3,2,5,3,2,2,5,9,0
Willean Lepo,BRA,DF,Vitória,27-275,1997,18.0,56,39,39,10,7,41,70,58.6,29,25,8,17,27,83,61,1
Jamal Lewis,NIR,DF,São Paulo,26-266,1998,1.0,2,1,1,1,0,2,3,66.7,1,1,1,0,0,2,3,0
Lima,BRA,"MF,FW",Fluminense,28-128,1996,12.0,23,9,6,12,5,8,18,44.4,10,9,0,9,14,37,7,0
Leonardo Linck,BRA,GK,Ath Paranaense,23-228,2001,13.6,0,0,0,0,0,0,2,0.0,2,0,0,0,0,0,8,2
Lincoln,BRA,"MF,FW",Red Bull Bragantino,25-345,1998,12.0,24,16,7,9,8,10,25,40.0,15,15,4,11,8,32,15,1
Liziero,BRA,"MF,DF",São Paulo,26-253,1998,1.9,13,7,5,5,3,7,8,87.5,1,3,0,3,0,13,2,1
Marcelo Lomba,BRA,GK,Palmeiras,37-304,1986,1.0,0,0,0,0,0,0,0,,0,0,0,0,0,0,0,0
Santiago Longo,ARG,MF,São Paulo,26-188,1998,0.9,2,1,1,1,0,1,2,50.0,1,2,1,1,1,3,3,0
Bruno Lopes,BRA,FW,Vasco da Gama,17-084,2007,0.1,1,1,1,0,0,0,1,0.0,1,0,0,0,0,1,0,0
José López,ARG,FW,Palmeiras,23-316,2000,17.8,12,6,1,7,4,3,16,18.8,13,21,2,19,3,15,6,0
Lorran,BRA,"MF,FW",Flamengo,18-105,2006,7.4,16,14,9,5,2,6,15,40.0,9,5,0,5,2,18,0,0
Vágner Love,BRA,"FW,MF",Atl Goianiense,40-128,1984,2.0,0,0,0,0,0,0,4,0.0,4,3,0,3,1,1,2,0
Lucão,BRA,GK,Red Bull Bragantino,23-234,2001,6.0,0,0,0,0,0,0,0,,0,0,0,0,0,0,4,0
Ayrton Lucas,BRA,DF,Flamengo,27-120,1997,19.5,32,19,20,8,4,11,27,40.7,16,17,2,15,13,45,32,0
Jean Lucas,BRA,MF,Bahia,26-117,1998,26.1,41,24,19,18,4,20,52,38.5,32,27,4,23,17,58,17,1
João Lucas,BRA,DF,Juventude,26-222,1998,20.5,64,34,27,27,10,30,49,61.2,19,21,8,13,22,86,36,0
Luciano,BRA,"MF,FW",São Paulo,31-152,1993,18.9,19,13,5,11,3,7,19,36.8,12,18,2,16,5,24,5,0
Jan Lucumí González,COL,"FW,MF",Fluminense,20-249,2004,1.0,4,0,3,1,0,1,3,33.3,2,4,1,3,1,5,1,0
Luighi,BRA,"MF,FW",Palmeiras,18-170,2006,0.2,0,0,0,0,0,0,0,,0,1,0,1,0,0,0,0
André Luis,BRA,"FW,MF",Cuiabá,27-179,1997,4.8,9,6,4,2,3,6,12,50.0,6,4,2,2,1,10,4,0
Victor Luis,BRA,DF,Vasco da Gama,31-116,1993,4.4,14,9,8,5,1,8,12,66.7,4,3,1,2,6,20,15,0
David Luiz,BRA,DF,Flamengo,37-178,1987,15.5,10,7,4,5,1,2,6,33.3,4,14,8,6,12,22,62,1
Lyanco,BRA,DF,Atlético Mineiro,27-259,1997,6.0,9,7,4,5,0,6,9,66.7,3,10,5,5,15,24,21,1
Lyncon,BRA,DF,Vasco da Gama,19-163,2005,0.5,1,0,1,0,0,1,2,50.0,1,0,0,0,0,1,5,0
Machado,BRA,MF,Cruzeiro,28-271,1996,1.9,4,2,1,3,0,1,1,100.0,0,2,0,2,5,9,0,0
Machado,BRA,MF,Vitória,28-271,1996,5.8,9,6,5,4,0,6,12,50.0,6,5,2,3,6,15,9,0
João Machado Cruz,BRA,MF,Ath Paranaense,18-158,2006,5.1,11,3,6,3,2,3,10,30.0,7,5,0,5,2,13,5,0
Imanol Machuca,ARG,"FW,MF",Fortaleza,24-276,2000,4.8,8,6,3,5,0,4,8,50.0,4,5,0,5,0,8,0,0
Guilherme Madruga,BRA,"MF,FW",Cuiabá,23-341,2000,1.2,3,2,3,0,0,3,4,75.0,1,3,0,3,1,4,1,0
Mádson,BRA,DF,Ath Paranaense,32-278,1992,9.6,10,5,5,3,2,3,6,50.0,3,11,8,3,12,22,27,0
Talles Magno,BRA,"MF,FW",Corinthians,22-113,2002,2.3,2,2,1,0,1,1,3,33.3,2,6,1,5,2,4,1,0
Maguinho,BRA,DF,Atl Goianiense,31-285,1993,15.1,29,12,14,12,3,11,17,64.7,6,16,6,10,15,44,28,0
Caio Maia,BRA,FW,Atlético Mineiro,19-199,2005,0.2,0,0,0,0,0,0,0,,0,0,0,0,0,0,0,0
Pablo Maia,BRA,MF,São Paulo,22-281,2002,2.9,7,2,3,3,1,1,3,33.3,2,4,2,2,0,7,0,0
Thiago Maia,BRA,MF,Internacional,27-208,1997,17.6,37,28,11,20,6,19,37,51.4,18,19,6,13,26,63,29,2
Walisson Maia,BRA,DF,Criciúma,33-057,1991,9.5,9,8,6,3,0,2,7,28.6,5,9,8,1,7,16,55,2
Maicon,BRA,DF,Vasco da Gama,36-033,1988,22.9,33,18,17,15,1,22,32,68.8,10,40,26,14,26,59,133,0
Hugo Mallo,ESP,DF,Internacional,33-117,1991,4.0,9,7,5,1,3,5,6,83.3,1,4,0,4,4,13,8,0
Léo Mana,BRA,DF,Corinthians,20-194,2004,2.3,6,3,4,2,0,2,7,28.6,5,5,3,2,3,9,10,0
Eros Mancuso,ARG,DF,Fortaleza,25-183,1999,3.6,6,5,2,4,0,2,8,25.0,6,7,1,6,2,8,4,0
Luis Mandaca,BRA,"MF,FW",Juventude,23-015,2001,6.6,15,8,5,8,2,5,10,50.0,5,14,2,12,4,19,7,0
Manoel,BRA,DF,Fluminense,34-234,1990,7.5,6,4,5,0,1,2,8,25.0,6,8,6,2,4,10,23,0
Fernando Marçal,BRA,DF,Botafogo (RJ),35-241,1989,10.0,23,13,13,9,1,8,18,44.4,10,9,1,8,21,44,39,0
Dé Marcão,BRA,DF,Atl Goianiense,23-155,2001,0.8,4,0,4,0,0,1,2,50.0,1,1,1,0,3,7,4,0
Marcelinho,BRA,"FW,MF",Juventude,21-311,2002,9.6,8,6,4,4,0,4,15,26.7,11,4,0,4,10,18,4,0
Marcelo,BRA,DF,Fluminense,36-158,1988,11.2,24,18,12,8,4,15,35,42.9,20,14,2,12,8,32,18,0
João Marcelo,BRA,DF,Cruzeiro,24-126,2000,22.9,33,21,23,9,1,19,21,90.5,2,30,21,9,33,66,127,0
Agustín Marchesín,ARG,GK,Grêmio,36-215,1988,20.0,1,0,1,0,0,1,1,100.0,0,1,0,1,0,1,7,1
Zé Marcos,BRA,DF,Juventude,26-259,1998,18.3,26,15,18,8,0,16,28,57.1,12,22,16,6,14,40,96,1
Erick Marcus,BRA,"FW,MF",Vasco da Gama,20-230,2004,1.9,5,4,2,3,0,1,4,25.0,3,3,0,3,2,7,1,0
Mariano,BRA,DF,Atlético Mineiro,38-116,1986,5.7,10,9,5,3,2,7,12,58.3,5,3,1,2,3,13,18,0
Marinho,BRA,FW,Fortaleza,34-141,1990,8.9,15,10,5,5,5,6,13,46.2,7,12,0,12,4,19,4,1
Marlon,BRA,DF,Cruzeiro,27-150,1997,18.1,40,26,23,14,3,21,28,75.0,7,25,6,19,19,59,48,1
Marlon,BRA,DF,Fluminense,29-040,1995,3.9,4,4,2,2,0,1,2,50.0,1,6,5,1,3,7,17,1
Marquinhos,BRA,"FW,DF",Fluminense,21-193,2003,12.9,22,11,10,10,2,13,21,61.9,8,19,0,19,10,32,17,0
Juan Martín Lucero,ARG,FW,Fortaleza,32-322,1991,17.6,15,8,0,12,3,4,19,21.1,15,9,4,5,0,15,16,0
Martinelli,BRA,"MF,DF",Fluminense,23-160,2001,20.9,31,19,11,17,3,16,29,55.2,13,37,11,26,14,45,36,0
Adriano Martins,BRA,DF,Atl Goianiense,27-199,1997,25.6,35,26,24,11,0,18,27,66.7,9,34,25,9,45,80,126,1
Matheus Martins,BRA,"MF,FW",Botafogo (RJ),21-093,2003,3.5,8,4,3,3,2,4,5,80.0,1,4,1,3,5,13,3,0
Gustavo Martins Santos,BRA,DF,Grêmio,22-067,2002,14.8,23,14,14,8,1,8,15,53.3,7,19,10,9,15,38,66,0
Gonzalo Mastriani,URU,FW,Ath Paranaense,31-172,1993,9.7,15,7,5,5,5,5,12,41.7,7,7,2,5,3,18,11,0
Fellipe Mateus,BRA,"MF,FW",Criciúma,33-248,1991,16.1,22,12,11,9,2,10,30,33.3,20,18,2,16,12,34,14,0
Matheusinho,BRA,"MF,FW",Vitória,26-365,1997,21.8,36,24,15,12,9,14,30,46.7,16,9,2,7,22,58,4,0
Matheusinho,BRA,MF,Criciúma,26-249,1998,14.1,18,10,13,4,1,7,20,35.0,13,12,0,12,9,27,10,0
Matheuzinho,BRA,DF,Corinthians,24-039,2000,16.9,36,31,21,11,4,20,42,47.6,22,23,9,14,19,55,46,2
Ricardo Mathias,BRA,"FW,MF",Internacional,18-084,2006,0.8,0,0,0,0,0,0,0,,0,1,0,1,1,1,2,0
Mauricio,BRA,MF,Internacional,23-148,2001,4.2,6,5,0,5,1,1,3,33.3,2,2,0,2,1,7,1,0
Mauricio,BRA,MF,Palmeiras,23-148,2001,8.8,9,3,1,7,1,6,9,66.7,3,7,1,6,4,13,5,0
Max,BRA,"FW,MF",Atl Goianiense,22-111,2002,2.9,9,6,4,3,2,7,8,87.5,1,1,0,1,0,9,2,0
Max,BRA,MF,Cuiabá,23-158,2001,11.3,13,9,4,6,3,6,14,42.9,8,14,2,12,13,26,8,0
Maycon,BRA,MF,Corinthians,27-094,1997,0.5,1,0,0,1,0,0,1,0.0,1,1,0,1,0,1,0,0
Mayk,BRA,DF,Grêmio,25-047,1999,2.9,6,4,2,3,1,2,4,50.0,2,8,2,6,3,9,11,0
Mayke,BRA,DF,Palmeiras,31-342,1992,9.6,29,17,10,19,0,13,24,54.2,11,9,3,6,22,51,17,0
Gary Medel,CHI,DF,Vasco da Gama,37-075,1987,1.2,1,0,1,0,0,0,0,,0,1,1,0,0,1,3,0
Felipe Melo,BRA,DF,Fluminense,41-113,1983,4.6,5,3,4,1,0,3,7,42.9,4,5,3,2,7,12,26,1
Memphis,NED,"FW,MF",Corinthians,30-247,1994,1.5,1,1,1,0,0,1,3,33.3,2,0,0,0,0,1,0,0
Douglas Mendes,BRA,DF,Red Bull Bragantino,20-126,2004,14.3,24,17,11,11,2,11,17,64.7,6,14,8,6,17,41,64,0
Matheus Mendes,BRA,GK,Atlético Mineiro,25-221,1999,11.1,0,0,0,0,0,0,0,,0,0,0,0,0,0,10,0
Nathan Mendes,BRA,DF,Red Bull Bragantino,22-059,2002,12.4,24,15,14,7,3,16,25,64.0,9,11,5,6,11,35,27,0
Vinicius Mendonça,BRA,"FW,MF",Red Bull Bragantino,20-240,2004,3.0,7,7,4,1,2,3,5,60.0,2,7,0,7,1,8,4,0
Jean Meneses,CHI,"FW,MF",Vasco da Gama,31-215,1993,2.1,4,3,1,2,1,1,4,25.0,3,4,0,4,4,8,2,0
Gabriel Menino,BRA,"MF,FW",Palmeiras,24-018,2000,10.4,26,16,10,14,2,11,24,45.8,13,15,5,10,10,36,9,0
Gabriel Mercado,ARG,DF,Internacional,37-213,1987,13.2,17,6,9,7,1,9,12,75.0,3,7,4,3,10,27,37,0
Higor Meritão,BRA,MF,Criciúma,30-116,1994,10.8,27,16,12,15,0,15,44,34.1,29,15,6,9,22,49,22,1
Michael,BRA,FW,Flamengo,28-219,1996,1.2,1,0,0,0,1,0,0,,0,1,0,1,1,2,3,0
Carlos Miguel,BRA,GK,Corinthians,26-008,1998,6.0,0,0,0,0,0,0,0,,0,0,0,0,0,0,2,1
Luis Miguel,BRA,"MF,FW",Vitória,19-256,2005,0.2,0,0,0,0,0,0,0,,0,0,0,0,0,0,0,0
Lucas Mineiro,BRA,MF,Cuiabá,28-236,1996,21.5,48,28,17,29,2,15,27,55.6,12,38,14,24,8,56,47,1
Moises,BRA,FW,Fortaleza,28-045,1996,7.6,5,3,1,4,0,2,13,15.4,11,3,0,3,4,9,8,0
Miguel Monsalve,COL,"FW,MF",Grêmio,20-233,2004,7.3,9,4,5,2,2,4,10,40.0,6,3,0,3,0,9,3,0
Jacob Montes,NCA,"FW,MF",Botafogo (RJ),25-363,1998,0.2,0,0,0,0,0,0,0,,0,0,0,0,0,0,0,0
João Moreira,POR,"DF,MF",São Paulo,20-149,2004,1.9,4,2,0,4,0,2,3,66.7,1,1,0,1,3,7,3,1
Aníbal Moreno,ARG,MF,Palmeiras,25-157,1999,21.9,40,29,17,23,0,19,63,30.2,44,14,2,12,37,77,20,1
Gabriel Moscardo,BRA,MF,Corinthians,19-019,2005,0.9,4,3,2,2,0,2,4,50.0,2,1,0,1,0,4,4,0
Henry Mosquera,COL,"FW,MF",Red Bull Bragantino,22-337,2001,19.2,21,10,10,7,4,8,13,61.5,5,9,1,8,7,28,6,0
Gustavo Mosquito,BRA,FW,Vitória,27-040,1997,3.7,7,4,3,4,0,3,4,75.0,1,1,1,0,2,9,2,0
Gustavo Mosquito,BRA,FW,Corinthians,27-040,1997,4.5,7,4,3,3,1,1,8,12.5,7,1,0,1,3,10,1,0
Jean Mota,BRA,MF,Vitória,31-002,1993,4.1,3,2,1,2,0,2,6,33.3,4,1,1,0,0,3,5,0
Hugo Moura,BRA,MF,Vasco da Gama,26-288,1998,17.1,56,41,29,23,4,28,57,49.1,29,19,7,12,14,70,29,0
Lucas Moura,BRA,"FW,MF",São Paulo,32-065,1992,18.0,18,9,4,10,4,8,16,50.0,8,12,0,12,15,33,13,0
Mycael,BRA,GK,Ath Paranaense,20-219,2004,6.4,0,0,0,0,0,0,0,,0,0,0,0,0,0,2,0
Léo Naldi,BRA,MF,Vitória,23-060,2001,11.6,37,24,18,17,2,18,30,60.0,12,18,5,13,16,53,21,1
Matheus Nascimento,BRA,FW,Botafogo (RJ),20-228,2004,0.3,1,1,0,0,1,0,0,,0,1,0,1,0,1,0,0
Nata,BRA,DF,Grêmio,23-134,2001,5.6,8,4,8,0,0,4,6,66.7,2,11,9,2,7,15,38,0
Nathan,BRA,DF,Internacional,23-042,2001,0.1,0,0,0,0,0,0,0,,0,0,0,0,0,0,0,0
Nathan,BRA,"FW,MF",Grêmio,28-218,1996,3.6,3,2,1,2,0,1,5,20.0,4,4,0,4,2,5,1,0
Kaiky Naves,BRA,DF,Palmeiras,22-162,2002,8.1,25,14,14,10,1,13,18,72.2,5,11,5,6,17,42,34,0
Nenê,BRA,"MF,FW",Juventude,43-090,1981,14.8,8,8,5,2,1,3,18,16.7,15,8,1,7,4,12,3,0
Neris,BRA,DF,Cruzeiro,32-122,1992,3.4,6,3,3,2,1,3,4,75.0,1,2,2,0,3,9,11,0
Neris,BRA,DF,Vitória,32-122,1992,8.1,18,10,13,4,1,10,15,66.7,5,11,6,5,8,26,43,0
Rodrigo Nestor,BRA,"MF,FW",São Paulo,24-069,2000,9.4,13,8,6,6,1,5,14,35.7,9,6,1,5,8,21,6,0
José Vitor Silva Neves,BRA,"MF,FW",Ath Paranaense,24-168,2000,2.0,8,4,3,4,1,2,3,66.7,1,7,0,7,2,10,1,0
Newton,BRA,MF,Criciúma,24-219,2000,18.7,42,24,18,19,5,16,32,50.0,16,12,2,10,22,64,49,1
Nikão,BRA,"FW,MF",Ath Paranaense,32-080,1992,10.2,18,12,5,6,7,7,16,43.8,9,8,1,7,6,24,4,0
Nonato,BRA,MF,Fluminense,26-228,1998,2.3,14,5,8,6,0,5,10,50.0,5,3,3,0,2,16,3,0
Gustavo Nunes,BRA,"FW,MF",Grêmio,18-332,2005,13.8,17,12,6,4,7,7,11,63.6,4,14,0,14,2,19,7,0
Cauly Oliveira Souza,BRA,"MF,FW",Bahia,29-032,1995,24.0,10,5,4,3,3,2,15,13.3,13,9,1,8,6,16,10,0
Leo Ortiz,BRA,"MF,DF",Flamengo,28-288,1996,15.2,22,10,13,7,2,14,20,70.0,6,14,6,8,14,36,30,0
Osvaldo,BRA,"MF,FW",Vitória,37-189,1987,11.9,8,7,4,4,0,5,19,26.3,14,10,1,9,6,14,5,0
Otávio,BRA,MF,Atlético Mineiro,30-166,1994,15.9,41,21,16,22,3,18,32,56.3,14,19,7,12,20,61,22,0
Luis Oyama,BRA,MF,Juventude,27-261,1997,6.5,14,8,5,8,1,4,12,33.3,8,4,0,4,11,25,11,0
Pablo,BRA,"FW,MF",Ath Paranaense,32-116,1992,10.9,11,8,2,8,1,1,6,16.7,5,6,3,3,2,13,8,1
Pablo,BRA,DF,Botafogo (RJ),33-118,1991,0.3,1,1,0,1,0,1,1,100.0,0,0,0,0,0,1,3,0
Juan Pablo,BRA,DF,Cuiabá,22-175,2002,2.8,10,7,4,5,1,6,11,54.5,5,0,0,0,2,12,7,0
Ruan Pablo,BRA,MF,Bahia,16-086,2008,0.1,0,0,0,0,0,0,0,,0,0,0,0,0,0,0,0
Bruno Pacheco,BRA,DF,Fortaleza,32-314,1991,12.7,30,16,20,9,1,21,26,80.8,5,11,2,9,14,44,34,1
Brahian Palacios,COL,"DF,FW",Atlético Mineiro,21-328,2002,7.7,10,7,6,3,1,5,15,33.3,10,12,0,12,5,15,8,0
Helibelton Palacios,COL,DF,Cruzeiro,31-128,1993,1.0,1,0,1,0,0,1,1,100.0,0,1,1,0,3,4,0,0
Sergio Palacios,COL,DF,Red Bull Bragantino,19-246,2005,0.3,0,0,0,0,0,0,1,0.0,1,0,0,0,1,1,0,0
Mateus Pasinato,BRA,GK,Cuiabá,32-111,1992,1.0,0,0,0,0,0,0,0,,0,0,0,0,0,0,1,0
Alan Patrick,BRA,"MF,FW",Internacional,33-157,1991,12.0,16,11,4,7,5,9,19,47.4,10,12,0,12,1,17,1,0
Patryck,BRA,"DF,FW",São Paulo,21-273,2003,4.3,10,5,5,4,1,6,13,46.2,7,3,0,3,5,15,7,0
Patrick de Paula,BRA,MF,Criciúma,25-039,1999,2.7,10,6,5,4,1,9,13,69.2,4,3,0,3,3,13,6,0
Patrick de Paula,BRA,"MF,FW",Botafogo (RJ),25-039,1999,0.3,0,0,0,0,0,0,1,0.0,1,2,2,0,1,1,0,0
Paulinho,BRA,"FW,MF",Atlético Mineiro,24-094,2000,19.9,22,13,5,12,5,4,13,30.8,9,11,3,8,4,26,7,0
Paulinho,BRA,MF,Corinthians,36-084,1988,1.3,6,5,2,3,1,4,6,66.7,2,2,1,1,0,6,3,0
Caio Paulista,BRA,"DF,FW",Palmeiras,26-159,1998,7.1,15,10,5,9,1,9,14,64.3,5,4,0,4,5,20,11,1
Cristian Pavón,ARG,"FW,MF",Grêmio,28-270,1996,9.9,11,6,5,6,0,5,14,35.7,9,12,1,11,7,18,8,0
Dimitri Payet,FRA,"MF,FW",Vasco da Gama,37-202,1987,9.8,11,8,4,5,2,2,6,33.3,4,1,0,1,5,16,1,0
Pedrão,BRA,DF,Atl Goianiense,31-304,1992,6.1,15,7,10,4,1,6,7,85.7,1,9,4,5,1,16,25,0
Pedrinho,BRA,"MF,DF",Atlético Mineiro,26-187,1998,2.3,6,5,3,3,0,3,3,100.0,0,2,0,2,1,7,1,0
Pedro,BRA,FW,Flamengo,27-119,1997,18.4,12,5,0,6,6,2,5,40.0,3,15,2,13,6,18,15,0
João Pedro,BRA,"FW,MF",Cruzeiro,21-258,2003,0.9,0,0,0,0,0,0,0,,0,0,0,0,2,2,1,0
João Pedro,BRA,MF,Vasco da Gama,19-181,2005,4.8,16,12,7,6,3,7,12,58.3,5,8,0,8,4,20,7,0
João Pedro,BRA,DF,Corinthians,20-291,2003,0.1,0,0,0,0,0,0,0,,0,0,0,0,0,0,1,0
João Pedro,ITA,FW,Grêmio,32-222,1992,6.4,2,0,0,1,1,0,0,,0,2,0,2,1,3,4,0
João Pedro,BRA,DF,Grêmio,27-337,1996,21.9,30,15,21,7,2,16,26,61.5,10,27,11,16,11,41,45,0
João Pedro Pepê,BRA,MF,Grêmio,26-285,1998,11.1,37,20,18,17,2,13,25,52.0,12,9,3,6,15,52,19,0
Peixoto,BRA,MF,Juventude,27-109,1997,0.2,3,2,2,1,0,3,3,100.0,0,0,0,0,0,3,1,0
Léo Pelé,BRA,DF,Vasco da Gama,28-225,1996,22.0,30,12,20,10,0,9,17,52.9,8,24,16,8,19,49,106,1
Carlos de Pena,URU,MF,Bahia,32-220,1992,7.0,13,9,1,9,3,5,11,45.5,6,9,3,6,14,27,14,1
Fabrizio Peralta,PAR,"MF,FW",Cruzeiro,22-076,2002,1.0,6,3,4,2,0,3,5,60.0,2,1,0,1,0,6,2,0
Léo Pereira,BRA,DF,Flamengo,28-260,1996,17.3,27,20,18,9,0,18,28,64.3,10,15,10,5,12,39,70,0
Matheus Pereira,BRA,"FW,MF",Cruzeiro,28-165,1996,24.5,20,14,7,9,4,11,28,39.3,17,12,1,11,7,27,5,0
Yago Pikachu,BRA,"FW,MF",Fortaleza,32-134,1992,16.3,17,13,3,10,4,7,24,29.2,17,14,0,14,9,26,7,0
Joaquín Piquerez,URU,DF,Palmeiras,26-054,1998,14.6,27,14,15,7,5,18,36,50.0,18,20,4,16,13,40,28,0
Rafael Pires,BRA,GK,São Paulo,35-116,1989,18.0,0,0,0,0,0,0,0,,0,0,0,0,0,0,2,1
Lucas Piton,BRA,DF,Vasco da Gama,24-008,2000,23.1,47,31,26,17,4,27,45,60.0,18,19,6,13,31,78,65,0
Isidro Pitta,PAR,FW,Cuiabá,25-064,1999,23.3,5,3,0,3,2,2,8,25.0,6,6,0,6,1,6,16,0
Gonzalo Plata,ECU,FW,Flamengo,23-351,2000,1.8,2,2,1,1,0,1,5,20.0,4,2,0,2,1,3,0,0
Tomas Pochettino,ARG,MF,Fortaleza,28-259,1996,15.6,23,8,7,16,0,7,22,31.8,15,20,1,19,5,28,15,0
Mateo Ponte,URU,DF,Botafogo (RJ),21-146,2003,10.1,30,23,16,11,3,8,18,44.4,10,6,3,3,18,48,17,0
Werik Popó,BRA,FW,Criciúma,23-000,2001,0.1,0,0,0,0,0,0,0,,0,0,0,0,0,0,0,0
Werik Popó,BRA,FW,Juventude,23-000,2001,0.5,0,0,0,0,0,0,0,,0,1,0,1,0,0,2,0
Gustavo Prado,BRA,"FW,MF",Internacional,19-133,2005,6.2,24,15,5,9,10,8,22,36.4,14,11,0,11,1,25,4,0
Bruno Praxedes,BRA,MF,Ath Paranaense,22-252,2002,1.6,5,2,1,3,1,2,5,40.0,3,6,2,4,2,7,1,0
Bruno Praxedes,BRA,MF,Vasco da Gama,22-252,2002,2.9,5,4,1,2,2,1,7,14.3,6,0,0,0,2,7,4,1
Erick Pulgar,CHI,MF,Flamengo,30-276,1994,13.2,37,23,15,14,8,21,37,56.8,16,12,5,7,22,59,17,0
Du Queiroz,BRA,MF,Grêmio,24-272,2000,6.5,19,13,7,9,3,10,17,58.8,7,9,0,9,9,28,8,0
Igor Rabello,BRA,DF,Atlético Mineiro,29-172,1995,7.2,15,7,4,11,0,8,12,66.7,4,10,7,3,8,23,42,0
Zé Rafael,BRA,MF,Palmeiras,31-123,1993,9.2,24,15,6,16,2,11,27,40.7,16,8,2,6,11,35,6,0
Rafinha,BRA,DF,São Paulo,39-040,1985,4.1,4,1,4,0,0,3,7,42.9,4,6,3,3,2,6,10,1
Railan,BRA,"DF,FW",Cuiabá,24-221,2000,9.3,16,10,8,6,2,7,13,53.8,6,5,2,3,15,31,18,0
André Ramalho,BRA,DF,Corinthians,32-244,1992,9.7,14,8,11,3,0,5,11,45.5,6,12,6,6,16,30,38,0
Eric Ramires,BRA,MF,Red Bull Bragantino,24-068,2000,11.7,23,16,11,7,5,12,25,48.0,13,9,2,7,8,31,8,0
Ramon,BRA,DF,Cuiabá,23-218,2001,20.4,42,27,27,11,4,16,26,61.5,10,18,6,12,20,62,55,0
Randerson,BRA,MF,Atl Goianiense,20-219,2004,0.2,1,1,0,0,1,0,1,0.0,1,0,0,0,0,1,0,0
Pedro Rangel,BRA,GK,Atl Goianiense,24-110,2000,6.0,0,0,0,0,0,0,1,0.0,1,0,0,0,0,0,3,2
Raniele,BRA,"MF,DF",Corinthians,27-291,1996,19.5,46,21,19,24,3,23,51,45.1,28,31,12,19,35,81,55,0
Rafael Ratão,BRA,"FW,MF",Bahia,28-322,1995,3.5,8,4,5,2,1,4,16,25.0,12,5,1,4,1,9,2,0
Wellington Rato,BRA,"FW,MF",São Paulo,32-111,1992,10.6,10,3,4,5,1,5,17,29.4,12,5,1,4,2,12,6,0
Raul,BRA,MF,Red Bull Bragantino,28-098,1996,13.0,21,16,8,11,2,13,26,50.0,13,12,4,8,19,40,24,1
Pedro Raul,BRA,FW,Corinthians,27-347,1996,5.8,10,8,0,9,1,4,8,50.0,4,4,1,3,0,10,6,0
Leonardo Realpe,ECU,DF,Red Bull Bragantino,23-234,2001,1.0,2,2,1,1,0,0,2,0.0,2,3,2,1,4,6,8,0
Reinaldo,BRA,DF,Grêmio,35-019,1989,20.1,36,24,18,10,8,18,31,58.1,13,14,3,11,15,51,55,1
Vitor Reis,BRA,DF,Palmeiras,18-279,2006,9.2,16,4,8,7,1,12,20,60.0,8,9,7,2,5,21,38,0
Robert Renan,BRA,DF,Internacional,21-006,2003,10.7,24,21,16,8,0,14,25,56.0,11,10,5,5,20,44,36,1
Renê,BRA,DF,Internacional,32-033,1992,10.6,31,20,10,18,3,11,17,64.7,6,7,2,5,17,48,28,0
Rezende,BRA,"MF,DF",Bahia,29-289,1995,6.4,24,16,13,9,2,8,12,66.7,4,8,3,5,8,32,24,0
Rhaldney,BRA,MF,Atl Goianiense,25-332,1998,18.4,56,38,16,31,9,20,51,39.2,31,21,6,15,10,66,17,0
Everton Ribeiro,BRA,MF,Bahia,35-190,1989,22.0,44,28,18,20,6,18,46,39.1,28,19,2,17,29,73,9,0
Ricardo,BRA,MF,Vitória,30-233,1994,5.2,21,14,8,11,2,11,20,55.0,9,5,2,3,4,25,7,0
João Ricardo Riedi,BRA,GK,Fortaleza,36-041,1988,30.0,1,0,1,0,0,0,0,,0,0,0,0,0,1,7,1
Charles Rigon Matos,BRA,"MF,DF",Corinthians,28-120,1996,5.2,21,19,9,10,2,11,27,40.7,16,9,2,7,8,29,11,0
Rikelme,BRA,DF,Cuiabá,21-093,2003,5.5,12,8,8,4,0,9,13,69.2,4,6,0,6,11,23,16,0
Rildo,BRA,"FW,MF",Juventude,24-270,2000,1.3,2,1,1,1,0,1,5,20.0,4,0,0,0,1,3,1,0
Richard Ríos,COL,MF,Palmeiras,24-137,2000,12.4,34,19,11,15,8,9,35,25.7,26,16,3,13,11,45,7,0
Riquelme,BRA,MF,Red Bull Bragantino,18-284,2006,0.1,1,0,1,0,0,0,0,,0,1,0,1,0,1,1,0
Robert,BRA,"MF,FW",Cruzeiro,19-187,2005,4.4,3,1,2,1,0,2,6,33.3,4,4,2,2,1,4,5,1
Jhonata Robert,BRA,MF,Criciúma,24-357,1999,0.7,3,3,2,1,0,1,1,100.0,0,2,1,1,1,4,0,0
Kaique Rocha,BRA,DF,Ath Paranaense,23-232,2001,24.6,34,24,25,7,2,23,35,65.7,12,27,19,8,32,66,125,1
Marcos Rocha,BRA,DF,Palmeiras,35-311,1988,15.8,40,23,21,15,4,15,32,46.9,17,17,6,11,23,63,34,2
Pedro Rocha Neves,BRA,MF,Criciúma,30-017,1994,0.1,1,0,0,1,0,0,0,,0,0,0,0,0,1,0,0
Pedro Rocha Neves,BRA,"FW,MF",Fortaleza,30-017,1994,0.5,3,2,1,0,2,2,3,66.7,1,2,0,2,0,3,1,0
Sergio Rochet,URU,GK,Internacional,31-208,1993,18.0,0,0,0,0,0,0,1,0.0,1,0,0,0,0,0,15,0
Yeferson Rodallega,COL,DF,Atl Goianiense,23-329,2000,1.2,1,1,1,0,0,0,1,0.0,1,2,0,2,0,1,7,0
Rodrigo,BRA,MF,São Paulo,20-215,2004,0.7,4,2,1,2,1,2,4,50.0,2,3,0,3,1,5,4,0
Arthur Rodrigues,BRA,"FW,MF",Cruzeiro,20-248,2004,0.9,0,0,0,0,0,0,1,0.0,1,1,0,1,0,0,1,0
Emerson Rodríguez,COL,FW,Vasco da Gama,24-053,2000,5.9,7,6,2,3,2,3,11,27.3,8,10,1,9,2,9,3,0
Emiliano Rodríguez,URU,FW,Atl Goianiense,21-093,2003,12.2,7,4,1,3,3,3,12,25.0,9,8,1,7,1,8,9,0
James Rodríguez,COL,MF,São Paulo,33-097,1991,0.4,0,0,0,0,0,0,1,0.0,1,0,0,0,0,0,0,0
Luciano Rodríguez,URU,"FW,MF",Bahia,21-093,2003,2.7,2,1,0,1,1,2,4,50.0,2,2,0,2,1,3,1,0
Agustín Rogel,URU,DF,Internacional,27-000,1997,5.2,4,3,1,3,0,3,5,60.0,2,2,0,2,6,10,19,0
Robert Rojas,PAR,DF,Vasco da Gama,28-170,1996,1.9,4,3,3,1,0,2,2,100.0,0,0,0,0,1,5,14,0
Guilherme Romão,BRA,DF,Atl Goianiense,27-010,1997,23.5,25,13,10,14,1,10,20,50.0,10,20,7,13,25,50,64,0
Ángel Romero,PAR,FW,Corinthians,32-105,1992,14.0,11,6,1,8,2,7,24,29.2,17,13,0,13,4,15,11,0
Lucas Romero,ARG,MF,Cruzeiro,30-182,1994,21.7,58,41,18,29,11,22,49,44.9,27,21,4,17,16,74,18,0
Óscar Romero,PAR,"MF,FW",Botafogo (RJ),32-105,1992,7.2,19,12,11,3,5,9,18,50.0,9,7,0,7,6,25,10,0
Rômulo,BRA,DF,Atlético Mineiro,20-260,2004,5.5,14,9,8,5,1,8,12,66.7,4,8,3,5,9,23,24,0
Romulo,BRA,MF,Internacional,24-230,2000,12.7,34,20,17,16,1,17,26,65.4,9,18,8,10,21,55,30,1
Romulo,BRA,"FW,MF",Palmeiras,23-010,2001,1.7,6,4,3,1,2,2,4,50.0,2,1,0,1,0,6,1,0
Ronald,BRA,MF,Criciúma,27-121,1997,10.3,35,16,18,10,7,16,35,45.7,19,14,0,14,10,45,7,0
Ronald,BRA,"MF,DF",Grêmio,21-249,2003,0.5,1,1,1,0,0,0,0,,0,2,2,0,0,1,4,0
Ronaldo,BRA,GK,Atl Goianiense,28-056,1996,23.0,0,0,0,0,0,0,2,0.0,2,0,0,0,0,0,10,0
Ronaldo,BRA,"MF,DF",Juventude,27-360,1996,3.7,16,10,5,7,4,7,9,77.8,2,6,4,2,3,19,8,0
Budiga Roni,BRA,"MF,DF",Atl Goianiense,25-185,1999,9.9,26,23,13,7,6,12,25,48.0,13,15,9,6,9,35,23,1
Rony,BRA,FW,Palmeiras,29-159,1995,15.5,14,8,0,8,6,3,10,30.0,7,7,1,6,2,16,11,0
Matheus Rossetto,BRA,MF,Fortaleza,28-136,1996,11.0,16,12,2,12,2,5,14,35.7,9,7,0,7,13,29,13,0
Rossi,BRA,"FW,MF",Vasco da Gama,31-178,1993,5.6,8,8,4,4,0,3,6,50.0,3,10,1,9,5,13,7,0
Agustín Rossi,ARG,GK,Flamengo,29-057,1995,26.0,0,0,0,0,0,0,0,,0,0,0,0,1,1,5,0
Ruan,BRA,DF,São Paulo,25-132,1999,3.0,7,6,6,1,0,4,4,100.0,0,1,1,0,1,8,22,0
Ruan,BRA,"FW,MF",Juventude,19-167,2005,1.1,0,0,0,0,0,0,1,0.0,1,3,0,3,0,0,1,0
Rubens,BRA,"DF,MF",Atlético Mineiro,23-118,2001,6.8,32,24,20,9,3,13,23,56.5,10,9,1,8,12,44,20,0
Alan Ruschel,BRA,DF,Juventude,35-055,1989,20.8,57,29,29,26,2,34,66,51.5,32,28,12,16,30,87,39,0
José Sabino,BRA,DF,São Paulo,27-358,1996,6.9,14,12,10,2,2,6,10,60.0,4,6,4,2,11,25,44,0
Daniel Sales,BRA,DF,Flamengo,18-116,2006,0.0,0,0,0,0,0,0,0,,0,0,0,0,0,0,0,0
Rodrigo Sam,BRA,DF,Juventude,29-085,1995,8.4,14,10,10,3,1,8,14,57.1,6,13,11,2,18,32,35,0
Philipe Sampaio,BRA,DF,Atl Goianiense,29-341,1994,1.0,1,1,1,0,0,1,1,100.0,0,1,1,0,0,1,1,0
Alex Sandro,BRA,DF,Flamengo,33-265,1991,1.3,2,2,0,1,1,0,0,,0,0,0,0,1,3,4,0
Alex Santana,BRA,"MF,FW",Ath Paranaense,29-157,1995,1.1,2,0,0,1,1,1,5,20.0,4,1,0,1,0,2,0,0
Alex Santana,BRA,MF,Corinthians,29-157,1995,3.8,12,6,8,4,0,7,10,70.0,3,3,2,1,4,16,6,0
Ademir Santos,BRA,"FW,MF",Bahia,29-244,1995,6.7,17,13,4,4,9,7,16,43.8,9,5,0,5,4,21,5,0
Allyson Aires dos Santos,BRA,DF,Cuiabá,33-360,1990,1.0,0,0,0,0,0,0,0,,0,0,0,0,2,2,7,0
Eduardo Santos,BRA,DF,Red Bull Bragantino,26-324,1997,13.3,24,20,13,11,0,8,12,66.7,4,16,12,4,15,39,78,1
Juan Santos,BRA,"FW,MF",São Paulo,22-225,2002,2.9,4,3,0,4,0,1,3,33.3,2,7,1,6,2,6,2,0
Júnior Santos,BRA,FW,Botafogo (RJ),30-006,1994,14.7,12,8,4,4,4,7,14,50.0,7,10,3,7,2,14,7,0
Kayke Santos,BRA,FW,Ath Paranaense,16-174,2008,0.0,0,0,0,0,0,0,0,,0,0,0,0,0,0,0,0
Luis Eduardo Marques dos Santos,BRA,DF,Criciúma,27-140,1997,4.3,13,7,6,7,0,7,11,63.6,4,5,0,5,5,18,10,0
Luis Eduardo Marques dos Santos,BRA,"FW,DF",Fortaleza,27-140,1997,0.2,0,0,0,0,0,0,1,0.0,1,0,0,0,0,0,0,0
Tevis Gabriel Alves Santos,BRA,FW,Cruzeiro,18-263,2006,0.3,0,0,0,0,0,0,0,,0,0,0,0,0,0,0,0
Renzo Saravia,ARG,DF,Atlético Mineiro,31-123,1993,17.8,66,38,40,19,7,34,65,52.3,31,26,6,20,21,87,31,0
Eduardo Sasha,BRA,FW,Red Bull Bragantino,32-236,1992,16.2,5,2,2,2,1,3,6,50.0,3,10,3,7,4,9,11,0
Lucas Sasha,BRA,MF,Fortaleza,34-230,1990,13.4,60,41,22,34,4,26,56,46.4,30,35,9,26,26,86,28,0
Gustavo Sauer,BRA,"FW,MF",Cuiabá,31-170,1993,2.6,6,5,1,5,0,2,6,33.3,4,3,0,3,0,6,1,0
Jefferson Savarino,VEN,"MF,FW",Botafogo (RJ),27-341,1996,15.3,6,2,2,2,2,5,15,33.3,10,7,2,5,2,8,7,0
Gustavo Scarpa,BRA,"DF,MF",Atlético Mineiro,30-286,1994,20.8,35,23,13,17,5,17,25,68.0,8,11,4,7,13,48,23,0
Igor Schlemper,BRA,"DF,FW",Grêmio,19-230,2005,1.1,4,1,1,2,1,2,3,66.7,1,4,0,4,0,4,6,0
Cleiton Schwengber,BRA,GK,Red Bull Bragantino,27-059,1997,22.0,0,0,0,0,0,0,0,,0,0,0,0,0,0,13,1
Kevin Serna,COL,FW,Fluminense,26-305,1997,6.3,19,15,11,3,5,13,23,56.5,10,6,0,6,5,24,3,0
Juan Sforza,ARG,MF,Vasco da Gama,22-246,2002,13.3,22,14,8,11,3,12,29,41.4,17,16,5,11,16,38,21,0
Shaylon,BRA,"FW,MF",Atl Goianiense,27-173,1997,19.6,12,4,6,5,1,5,28,17.9,23,15,1,14,14,26,13,0
André Silva,BRA,"FW,MF",São Paulo,27-136,1997,12.3,1,0,0,1,0,1,9,11.1,8,11,2,9,5,6,11,0
Luan Silva,BRA,MF,Vitória,25-156,1999,16.0,16,10,4,11,1,7,12,58.3,5,12,0,12,24,40,27,0
Lucas Silva,BRA,MF,Cruzeiro,31-244,1993,15.4,11,5,4,6,1,5,18,27.8,13,22,4,18,4,15,21,1
Rafael Silva,BRA,FW,Cruzeiro,32-196,1992,5.9,4,3,1,3,0,3,3,100.0,0,3,0,3,1,5,4,0
Thiago Silva,BRA,DF,Fluminense,40-025,1984,8.0,8,5,4,4,0,2,4,50.0,2,7,5,2,7,15,47,0
Everton Soares,BRA,FW,Flamengo,28-209,1996,6.0,9,6,1,5,3,1,6,16.7,5,10,0,10,2,11,5,0
Fábio Soares,BRA,MF,Vitória,19-319,2004,1.0,4,3,2,2,0,1,1,100.0,0,3,0,3,0,4,2,0
Tiquinho Soares,BRA,"FW,MF",Botafogo (RJ),33-274,1991,12.8,10,6,3,4,3,2,5,40.0,3,10,0,10,3,13,9,0
Fernando Sobral,BRA,MF,Cuiabá,29-305,1994,15.5,53,33,28,21,4,22,43,51.2,21,22,6,16,13,66,30,0
Yeferson Soteldo,VEN,"FW,MF",Grêmio,27-109,1997,12.7,10,6,4,5,1,6,12,50.0,6,8,1,7,4,14,2,1
Yan Souto,BRA,"DF,MF",Juventude,23-012,2001,2.6,4,4,3,1,0,1,2,50.0,1,4,1,3,1,5,13,0
Gabriel Souza,BRA,FW,Vasco da Gama,19-286,2005,1.0,4,2,0,2,2,0,0,,0,1,0,1,1,5,0,0
Hugo Souza,BRA,GK,Corinthians,25-260,1999,13.0,0,0,0,0,0,0,0,,0,0,0,0,0,0,4,0
Igor Vinícius de Souza,BRA,DF,São Paulo,27-199,1997,20.0,46,26,29,13,4,25,40,62.5,15,19,0,19,15,61,30,0
Josef de Souza,BRA,MF,Vasco da Gama,35-249,1989,0.8,3,1,2,1,0,1,3,33.3,2,0,0,0,1,4,4,0
Everaldo Stum,BRA,FW,Bahia,33-104,1991,19.9,17,14,4,5,8,4,20,20.0,16,9,2,7,2,19,19,0
Damián Suárez,URU,DF,Botafogo (RJ),36-173,1988,13.8,32,23,16,12,4,19,41,46.3,22,12,3,9,9,41,25,0
Bruno Tabata,BRA,"MF,FW",Internacional,27-201,1997,5.4,5,2,1,3,1,2,5,40.0,3,4,1,3,2,7,4,0
Gabriel Taliari,BRA,FW,Juventude,27-187,1997,5.0,6,6,0,3,3,1,6,16.7,5,2,0,2,0,6,3,0
Talisson,BRA,FW,Red Bull Bragantino,22-149,2002,1.3,1,1,0,1,0,0,1,0.0,1,0,0,0,0,1,0,0
Tchê Tchê,BRA,"MF,FW",Botafogo (RJ),32-048,1992,16.7,15,8,7,7,1,9,12,75.0,3,9,0,9,6,21,9,0
Alex Teixeira,BRA,FW,Vasco da Gama,34-285,1990,0.1,0,0,0,0,0,0,0,,0,0,0,0,0,0,0,0
Alex Telles,BRA,DF,Botafogo (RJ),31-307,1992,1.5,2,2,2,0,0,1,3,33.3,2,4,1,3,5,7,4,0
David Terans,URU,"MF,FW",Fluminense,30-067,1994,2.4,6,4,1,4,1,4,7,57.1,3,4,0,4,0,6,1,0
Felipe Teresa,BRA,"MF,FW",Flamengo,18-289,2006,0.1,0,0,0,0,0,0,0,,0,0,0,0,0,0,0,0
Thaciano,BRA,FW,Bahia,29-158,1995,21.1,14,11,9,4,1,0,16,0.0,16,11,2,9,14,28,23,0
Thiaguinho,BRA,MF,Juventude,27-189,1997,3.4,8,4,4,3,1,4,10,40.0,6,5,0,5,2,10,5,0
Tiago,BRA,FW,Bahia,19-192,2005,0.1,0,0,0,0,0,0,0,,0,1,0,1,0,0,0,0
Guilherme Tinga,BRA,DF,Fortaleza,31-046,1993,20.7,29,19,21,7,1,16,29,55.2,13,19,5,14,30,59,97,1
Titi,BRA,DF,Fortaleza,36-219,1988,15.4,19,11,16,3,0,9,21,42.9,12,18,12,6,17,36,51,3
Félix Torres Caicedo,ECU,DF,Corinthians,27-280,1997,16.0,22,11,16,6,0,11,22,50.0,11,12,7,5,23,45,67,0
Miguel Trauco,PER,DF,Criciúma,32-053,1992,12.4,21,17,15,5,1,10,18,55.6,8,11,5,6,7,28,31,0
Bruno Tubarão,BRA,DF,Atl Goianiense,29-226,1995,10.7,27,16,16,10,1,10,16,62.5,6,8,2,6,10,37,21,0
Bruno Uvini,BRA,DF,Vitória,33-136,1991,4.8,1,1,0,1,0,1,1,100.0,0,6,3,3,6,7,15,0
Enner Valencia,ECU,FW,Internacional,34-348,1989,7.2,5,4,1,1,3,2,4,50.0,2,4,0,4,1,6,3,0
Vanderlan,BRA,DF,Palmeiras,22-040,2002,9.2,22,16,5,14,3,11,18,61.1,7,9,1,8,12,34,21,0
Guillermo Varela,URU,DF,Flamengo,31-207,1993,8.4,11,9,7,2,2,5,8,62.5,3,6,2,4,10,21,13,0
Eduardo Vargas,CHI,"FW,MF",Atlético Mineiro,34-332,1989,6.5,6,5,3,3,0,3,5,60.0,2,5,1,4,3,9,4,0
Pablo Vegetti,ARG,FW,Vasco da Gama,36-002,1988,26.0,15,11,8,6,1,9,19,47.4,10,20,5,15,1,16,37,0
Raphael Veiga,BRA,"MF,FW",Palmeiras,29-120,1995,19.7,16,11,3,12,1,4,19,21.1,15,15,5,10,8,24,6,0
Fausto Vera,ARG,MF,Atlético Mineiro,24-205,2000,11.6,23,13,8,11,4,10,21,47.6,11,8,6,2,10,33,19,0
Fausto Vera,ARG,MF,Corinthians,24-205,2000,2.4,1,1,0,1,0,1,4,25.0,3,2,1,1,5,6,0,0
Gabriel Veron,BRA,"FW,MF",Cruzeiro,22-044,2002,11.9,16,14,5,7,4,6,17,35.3,11,11,1,10,8,24,8,0
João Victor,BRA,DF,Vasco da Gama,26-092,1998,12.3,20,17,17,2,1,11,15,73.3,4,16,8,8,10,30,66,0
Dudu Vieira,BRA,MF,Juventude,30-240,1994,2.9,4,3,1,3,0,1,2,50.0,1,6,3,3,4,8,5,1
Felipe Vieira,,"DF,MF",Fluminense,,,1.8,5,3,3,1,1,1,1,100.0,0,1,1,0,4,9,10,0
Lucas Villalba,ARG,DF,Cruzeiro,30-059,1994,9.7,10,6,8,2,0,5,6,83.3,1,14,7,7,13,23,42,1
Mathías Villasanti,PAR,MF,Grêmio,27-267,1997,18.0,54,29,23,25,6,24,48,50.0,24,24,7,17,27,81,28,1
Matías Viña,URU,DF,Flamengo,26-343,1997,4.7,8,5,3,5,0,5,10,50.0,5,5,0,5,5,13,14,0
Alix Vinicius,BRA,DF,Atl Goianiense,24-346,1999,15.7,12,11,9,2,1,9,15,60.0,6,31,19,12,21,33,95,0
Caio Vinícius,BRA,"DF,MF",Vitória,25-280,1999,6.7,14,7,8,5,1,5,9,55.6,4,7,2,5,6,20,26,0
Mateus Vital,BRA,"MF,FW",Cruzeiro,26-248,1998,3.6,7,5,3,2,2,1,8,12.5,7,2,0,2,0,7,0,0
Vitão,BRA,DF,Internacional,24-258,2000,18.0,15,11,11,2,2,9,17,52.9,8,19,9,10,15,30,75,0
Vitinho,BRA,DF,Botafogo (RJ),25-086,1999,2.7,6,3,5,1,0,4,13,30.8,9,4,1,3,1,7,8,0
Vitinho,BRA,"FW,MF",Red Bull Bragantino,25-199,1999,16.7,26,15,8,14,4,14,23,60.9,9,22,2,20,9,35,25,0
Paulo Vitor,BRA,MF,Atlético Mineiro,20-052,2004,4.2,14,5,5,7,2,9,17,52.9,8,7,0,7,2,16,13,0
Rayan Vitor,BRA,"FW,MF",Vasco da Gama,18-075,2006,7.1,8,6,3,4,1,2,7,28.6,5,10,1,9,5,13,12,1
Felipe Vizeu,BRA,FW,Criciúma,27-219,1997,1.4,3,2,1,2,0,1,2,50.0,1,1,0,1,0,3,0,0
Wagner,BRA,DF,Vitória,25-086,1999,27.1,27,14,17,9,1,15,22,68.2,7,36,25,11,41,68,150,1
Walace,BRA,"MF,DF",Cruzeiro,29-196,1995,3.5,6,5,6,0,0,4,8,50.0,4,0,0,0,6,12,2,1
Wallace,BRA,"MF,FW",Flamengo,19-252,2005,0.2,0,0,0,0,0,0,0,,0,0,0,0,0,0,0,0
Walter,BRA,GK,Cuiabá,36-334,1987,27.0,1,0,1,0,0,0,0,,0,0,0,0,0,1,7,2
Wanderson,BRA,"FW,MF",Internacional,30-010,1994,9.3,8,4,1,5,2,3,11,27.3,8,6,0,6,5,13,7,0
Welington,BRA,DF,São Paulo,23-241,2001,18.9,39,23,19,18,2,18,32,56.3,14,10,4,6,23,62,32,0
José Welison,BRA,MF,Fortaleza,29-220,1995,8.4,24,17,13,11,0,11,19,57.9,8,15,5,10,10,34,16,1
João Wellington,BRA,"MF,FW",Cruzeiro,20-289,2004,2.0,7,5,1,3,3,1,2,50.0,1,0,0,0,4,11,3,0
Werton,BRA,"MF,FW",Flamengo,21-031,2003,0.5,3,2,1,2,0,2,4,50.0,2,1,0,1,1,4,0,0
Wesley,BRA,DF,Flamengo,21-041,2003,19.0,47,39,28,16,3,20,45,44.4,25,28,13,15,29,76,54,1
Wesley,BRA,"FW,MF",Internacional,25-201,1999,21.1,30,23,8,16,6,15,41,36.6,26,23,2,21,6,36,12,0
Wesley,BRA,FW,Corinthians,19-226,2005,16.0,14,11,2,6,6,8,19,42.1,11,23,0,23,8,22,0,0
Wéverton,BRA,GK,Palmeiras,36-309,1987,28.0,1,1,1,0,0,1,2,50.0,1,0,0,0,0,1,6,0
William,BRA,DF,Cruzeiro,29-197,1995,25.4,83,53,30,41,12,43,82,52.4,39,38,5,33,37,120,67,0
Willian,BRA,MF,Vitória,31-154,1993,22.4,38,26,17,20,1,19,41,46.3,22,25,4,21,21,59,37,1
Samuel Xavier,BRA,DF,Fluminense,34-133,1990,20.7,38,22,22,14,2,21,32,65.6,11,15,7,8,18,56,42,0
Yago,BRA,MF,Bahia,29-257,1995,0.6,3,2,3,0,0,2,6,33.3,4,2,0,2,0,3,1,0
Bruno Zapelli,ARG,"MF,FW",Ath Paranaense,22-153,2002,13.1,26,18,5,11,10,12,32,37.5,20,12,2,10,6,32,10,0
Federico Zaracho,ARG,MF,Atlético Mineiro,26-221,1998,8.0,20,11,7,9,4,7,18,38.9,11,9,0,9,11,31,2,0
Zeca,BRA,DF,Vitória,30-154,1994,4.3,10,5,5,3,2,3,8,37.5,5,4,3,1,3,13,8,0
Mateo Zuleta,COL,"FW,MF",Atl Goianiense,22-132,2002,0.5,2,1,0,1,1,1,4,25.0,3,2,0,2,1,3,0,0
