Player,Nation,Pos,Squad,Age,Born,90s,Tackles,TacklesWon,TacklesDef3rd,TacklesMid3rd,TacklesAtt3rd,DribTkl,DribTklAtt,DribTkl%,ChallengesLost,Blocks,ShotsBlocked,PassesBlocked,Int,Tkl+Int,Clr,ErrorsLeadingToShot
Salis Abdul Samed,GHA,MF,Lens,23,2000,1.4,4,1,2,1,1,3,3,100.0,0,0,0,0,3,7,2,0
Abner,BRA,DF,Betis,23,2000,4.4,9,3,5,4,0,6,11,54.5,5,4,0,4,4,13,5,0
Zakaria Aboukhlal,MAR,FW,Toulouse,23,2000,0.4,0,0,0,0,0,0,0,,0,0,0,0,0,0,0,0
Tammy Abraham,ENG,FW,Roma,25,1997,0.9,0,0,0,0,0,0,2,0.0,2,0,0,0,1,1,2,1
Peter Abrahamsson,SWE,GK,Häcken,35,1988,6.0,0,0,0,0,0,0,1,0.0,1,1,0,1,0,0,2,2
Junior Adamu,AUT,FW,Freiburg,22,2001,1.4,5,2,2,3,0,3,3,100.0,0,2,0,2,1,6,2,0
Antonio Adán,ESP,GK,Sporting CP,36,1987,6.0,0,0,0,0,0,0,0,,0,0,0,0,0,0,2,0
Peter Ademo,NGA,MF,Sheriff Tiraspol,20,2003,1.5,4,3,1,3,0,1,1,100.0,0,1,0,1,0,4,0,0
Simon Adingra,CIV,"FW,MF",Brighton,21,2002,5.9,6,3,2,3,1,2,6,33.3,4,9,1,8,0,6,5,1
Amine Adli,MAR,"MF,FW",Leverkusen,23,2000,10.9,21,11,5,6,10,10,16,62.5,6,16,0,16,4,25,7,0
Yacine Adli,FRA,MF,Milan,23,2000,2.5,5,4,1,3,1,2,3,66.7,1,2,1,1,2,7,0,0
David Affengruber,AUT,DF,Sturm Graz,22,2001,5.9,15,11,12,3,0,9,19,47.4,10,6,4,2,6,21,36,1
Nayef Aguerd,MAR,DF,West Ham,27,1996,4.5,4,4,3,1,0,3,3,100.0,0,7,3,4,1,5,10,0
Ruben Aguilar,FRA,DF,Lens,30,1993,1.2,3,3,3,0,0,2,2,100.0,0,3,1,2,1,4,5,0
Ilias Akhomach,MAR,"MF,FW",Villarreal,19,2004,4.5,5,3,3,2,0,0,6,0.0,6,1,0,1,4,9,2,1
David Akpan Ankeye,NGA,FW,Sheriff Tiraspol,21,2002,4.5,6,5,2,3,1,0,0,,0,3,1,2,0,6,2,0
Chuba Akpom,ENG,"FW,MF",Ajax,27,1995,2.1,2,1,0,1,1,0,1,0.0,1,0,0,0,2,4,4,0
Kerem Aktürkoğlu,TUR,FW,Galatasaray,24,1998,1.6,0,0,0,0,0,0,1,0.0,1,1,0,1,1,1,1,0
Raúl Albiol,ESP,DF,Villarreal,37,1985,1.6,1,1,1,0,0,0,0,,0,1,1,0,1,2,9,0
Trent Alexander-Arnold,ENG,DF,Liverpool,24,1998,3.1,5,2,3,2,0,5,7,71.4,2,8,1,7,6,11,2,0
Sotiris Alexandropoulos,GRE,"MF,FW",Olympiacos,21,2001,2.7,5,4,3,2,0,1,4,25.0,3,4,0,4,0,5,0,0
Alisson,BRA,GK,Liverpool,30,1992,2.0,0,0,0,0,0,0,0,,0,0,0,0,0,0,1,0
Barış Alper Yılmaz,TUR,"FW,DF",Galatasaray,23,2000,2.0,5,3,4,0,1,4,5,80.0,1,2,0,2,1,6,2,1
Adrià Altimira,ESP,DF,Villarreal,22,2001,3.1,8,5,3,4,1,6,8,75.0,2,2,0,2,2,10,3,0
Edson Álvarez,MEX,MF,West Ham,25,1997,5.5,13,6,9,3,1,7,12,58.3,5,10,3,7,6,19,8,0
Mohamed Aly Camara,GUI,DF,Young Boys,25,1997,1.0,3,2,1,1,1,1,1,100.0,0,2,1,1,1,4,3,0
Romeo Amane,CIV,MF,Häcken,20,2003,4.1,5,4,2,1,2,2,5,40.0,3,0,0,0,6,11,2,0
Jaydon Amauri Banel,NED,MF,Ajax,18,2004,0.0,0,0,0,0,0,0,0,,0,0,0,0,0,0,1,0
Aurele Amenda,SUI,DF,Young Boys,20,2003,2.0,3,3,2,1,0,0,1,0.0,1,6,4,2,1,4,8,0
Michael Amir Murillo,PAN,"DF,MF",Marseille,27,1996,3.1,4,2,3,1,0,2,3,66.7,1,5,0,5,3,7,5,0
Mohamed Amoura,ALG,FW,Union SG,23,2000,4.9,3,3,0,3,0,0,3,0.0,3,3,0,3,0,3,0,0
Nordin Amrabat,MAR,"MF,FW",AEK Athens,36,1987,5.1,6,5,2,3,1,5,12,41.7,7,8,0,8,0,6,0,0
Andrés Andrade Cedeño,PAN,DF,LASK,24,1998,5.2,16,9,11,5,0,3,6,50.0,3,9,5,4,9,25,21,0
Leandro Andrade,CPV,"FW,MF",Qarabağ,23,1999,8.7,11,5,6,1,4,6,17,35.3,11,17,0,17,8,19,4,0
Patrick Andrade,CPV,MF,Qarabağ,30,1993,2.8,10,5,5,5,0,7,9,77.8,2,4,1,3,4,14,3,0
Markus Andreas Kaasa,NOR,MF,Molde,26,1997,4.0,7,5,1,5,1,4,9,44.4,5,4,1,3,8,15,4,0
Robert Andrich,GER,"MF,DF",Leverkusen,28,1994,8.4,10,7,6,4,0,4,8,50.0,4,10,6,4,7,17,5,0
Angeliño,ESP,"DF,FW",Roma,26,1997,1.5,4,3,4,0,0,2,2,100.0,0,4,2,2,2,6,5,0
Goran Antonić,SRB,DF,TSC Bačka Top,32,1990,4.7,9,8,7,2,0,7,7,100.0,0,8,5,3,8,17,18,0
Michail Antonio,JAM,FW,West Ham,33,1990,3.6,1,1,1,0,0,1,2,50.0,1,2,1,1,0,1,2,0
Alexis Antunes,SUI,"MF,FW",Servette FC,23,2000,3.2,10,7,4,5,1,5,6,83.3,1,6,1,5,5,15,0,0
Houssem Aouar,ALG,MF,Roma,25,1998,4.4,7,5,2,4,1,2,6,33.3,4,5,0,5,2,9,3,0
Ayman Aourir,GER,MF,Leverkusen,18,2004,0.0,0,0,0,0,0,0,0,,0,0,0,0,0,0,0,0
Kostas Apostolakis,GRE,DF,Sheriff Tiraspol,24,1999,2.2,8,4,7,1,0,5,6,83.3,1,7,2,5,2,10,7,0
Youssef El-Arabi,MAR,FW,Olympiacos,36,1987,0.4,1,1,0,1,0,0,0,,0,0,0,0,0,1,0,0
Willian Arão,BRA,"MF,DF",Panathinaikos,30,1992,4.3,10,7,6,4,0,3,3,100.0,0,5,2,3,1,11,6,1
Sergio Araujo,ARG,"MF,FW",AEK Athens,31,1992,2.3,2,2,1,0,1,1,3,33.3,2,1,0,1,1,3,2,0
Alphonse Areola,FRA,GK,West Ham,30,1993,1.0,0,0,0,0,0,0,0,,0,0,0,0,0,0,0,0
Zoran Arsenić,CRO,DF,RKS Raków,29,1994,0.1,0,0,0,0,0,0,0,,0,0,0,0,0,0,1,0
Alejandro Artunduaga,COL,DF,Sheriff Tiraspol,25,1997,5.5,13,10,10,3,0,7,15,46.7,8,11,1,10,8,21,13,0
Lorenz Assignon,TOG,DF,Rennes,23,2000,4.0,5,4,1,4,0,2,4,50.0,2,3,1,2,4,9,2,0
Giorgos Athanasiadis,GRE,GK,AEK Athens,30,1993,2.4,0,0,0,0,0,0,0,,0,0,0,0,0,0,3,3
Noah Atubolu,GER,GK,Freiburg,21,2002,10.3,0,0,0,0,0,0,0,,0,0,0,0,0,0,2,2
Pierre-Emerick Aubameyang,GAB,FW,Marseille,34,1989,11.4,4,3,1,1,2,1,4,25.0,3,14,2,12,3,7,8,0
Fredrik Aursnes,NOR,DF,Benfica,27,1995,5.6,19,13,9,9,1,12,14,85.7,2,8,2,6,4,23,14,0
Gastón Ávila,ARG,DF,Ajax,21,2001,1.0,1,0,1,0,0,0,1,0.0,1,1,1,0,1,2,5,1
Nəriman Axundzadə,AZE,FW,Qarabağ,19,2004,0.7,1,0,1,0,0,0,1,0.0,1,0,0,0,0,1,0,0
Kaan Ayhan,TUR,DF,Galatasaray,28,1994,1.4,4,2,1,1,2,2,3,66.7,1,0,0,0,3,7,1,0
Neil El Aynaoui,FRA,MF,Lens,22,2001,2.3,5,1,1,4,0,3,5,60.0,2,3,1,2,1,6,6,0
Irakli Azarov,GEO,DF,Shakhtar,21,2002,1.9,1,0,1,0,0,1,1,100.0,0,1,1,0,3,4,6,0
Sardar Azmoun,IRN,FW,Roma,28,1995,1.9,3,2,2,0,1,0,2,0.0,2,0,0,0,3,6,0,0
Sanoussy Ba,GER,"DF,MF",LASK,19,2004,0.1,0,0,0,0,0,0,0,,0,2,0,2,0,0,0,0
Shavy Babicka,GAB,"FW,MF",Toulouse,23,2000,0.4,0,0,0,0,0,0,0,,0,0,0,0,0,0,0,0
Shavy Babicka,GAB,FW,Aris Limassol FC,23,2000,3.9,5,4,0,4,1,2,6,33.3,4,2,0,2,1,6,1,0
Cédric Badolo,BFA,MF,Sheriff Tiraspol,24,1998,4.4,7,5,3,2,2,3,5,60.0,2,1,0,1,3,10,4,0
Alex Baena,ESP,"FW,MF",Villarreal,22,2001,4.6,3,0,2,0,1,1,9,11.1,8,1,0,1,6,9,2,0
Alexander Bah,DEN,DF,Benfica,25,1997,5.6,14,11,6,7,1,10,17,58.8,7,15,5,10,6,20,19,0
Eric Bailly,CIV,DF,Villarreal,29,1994,1.6,1,1,0,1,0,1,2,50.0,1,0,0,0,0,1,6,0
Stefan Bajcetic,ESP,DF,Liverpool,18,2004,0.7,1,1,0,1,0,0,1,0.0,1,0,0,0,0,1,0,0
Mitchel Bakker,NED,DF,Atalanta,23,2000,1.7,2,1,0,2,0,2,5,40.0,3,2,0,2,4,6,0,0
Tommaso Baldanzi,ITA,"FW,MF",Roma,20,2003,1.5,1,0,0,0,1,0,3,0.0,3,1,0,1,1,2,1,0
Carlos Baleba,CMR,MF,Brighton,19,2004,0.7,2,2,0,2,0,0,0,,0,2,0,2,1,3,4,0
Leonardo Balerdi,ARG,DF,Marseille,24,1999,11.4,39,25,32,6,1,23,32,71.9,9,12,6,6,25,64,47,0
Husein Balic,AUT,FW,LASK,27,1996,0.1,0,0,0,0,0,0,0,,0,0,0,0,1,1,0,0
David von Ballmoos,SUI,GK,Young Boys,28,1994,2.0,0,0,0,0,0,0,0,,0,0,0,0,0,0,0,0
Simon Banza,COD,FW,Braga,26,1996,2.3,1,1,0,1,0,0,2,0.0,2,2,0,2,0,1,2,0
Abdülkerim Bardakcı,TUR,DF,Galatasaray,28,1994,1.4,2,1,2,0,0,1,2,50.0,1,2,0,2,2,4,3,0
Borna Barišić,CRO,DF,Rangers,30,1992,5.0,10,5,6,3,1,6,8,75.0,2,3,0,3,5,15,14,0
Anthony Baron,GLP,"DF,MF",Servette FC,30,1992,1.4,2,2,1,1,0,1,2,50.0,1,2,1,1,0,2,4,0
Marc Bartra,ESP,DF,Betis,32,1991,1.0,4,2,4,0,0,2,2,100.0,0,2,2,0,2,6,5,0
Toral Bayramov,AZE,"DF,FW",Qarabağ,22,2001,3.7,13,9,9,4,0,8,11,72.7,3,4,0,4,5,18,19,1
Chris Bedia,CIV,FW,Servette FC,27,1996,4.4,2,0,0,0,2,2,2,100.0,0,1,0,1,0,2,0,0
Thomas Beelen,NED,DF,Feyenoord,22,2001,2.3,3,1,2,1,0,2,2,100.0,0,1,0,1,5,8,9,0
Yanis Begraoui,MAR,"FW,MF",Toulouse,22,2001,0.4,1,0,0,1,0,0,1,0.0,1,1,0,1,0,1,0,0
Héctor Bellerín,ESP,DF,Betis,28,1995,2.0,1,1,1,0,0,0,2,0.0,2,4,3,1,4,5,1,0
George Bello,USA,"MF,DF",LASK,21,2002,4.0,14,9,8,3,3,6,13,46.2,7,5,1,4,6,20,3,0
Jeanuël Belocian,FRA,DF,Rennes,18,2005,2.1,2,0,1,1,0,0,1,0.0,1,4,4,0,1,3,8,0
Andrea Belotti,ITA,FW,Roma,29,1993,3.0,7,5,4,2,1,2,4,50.0,2,1,0,1,1,8,5,0
Leo Bengtsson,SWE,"FW,MF",Aris Limassol FC,25,1998,5.1,9,5,4,4,1,5,13,38.5,8,14,1,13,5,14,4,0
Ismaël Bennacer,ALG,MF,Milan,25,1997,2.0,4,4,0,4,0,1,2,50.0,1,0,0,0,1,5,0,0
Saïd Benrahma,ALG,"FW,MF",West Ham,27,1995,3.4,4,1,4,0,0,2,7,28.6,5,1,0,1,0,4,0,0
Yassine Benzia,ALG,MF,Qarabağ,28,1994,8.0,13,9,1,8,4,5,12,41.7,7,8,2,6,6,19,12,0
Gustav Berggren,SWE,MF,RKS Raków,25,1997,4.9,8,5,1,7,0,1,7,14.3,6,14,4,10,6,14,7,0
Steven Berghuis,NED,"MF,FW",Ajax,31,1991,4.3,2,1,0,2,0,0,3,0.0,3,2,0,2,2,4,2,0
Steven Bergwijn,NED,FW,Ajax,25,1997,4.8,1,1,1,0,0,1,6,16.7,5,0,0,0,0,1,1,0
Veton Berisha,NOR,FW,Molde,29,1994,2.2,3,2,1,2,0,0,1,0.0,1,1,0,1,0,3,1,0
Bernard,BRA,"FW,MF",Panathinaikos,30,1992,5.0,8,3,3,2,3,4,10,40.0,6,7,0,7,3,11,1,0
Pep Biel,ESP,MF,Olympiacos,26,1996,0.8,0,0,0,0,0,0,0,,0,0,0,0,1,1,0,0
El Bilal Touré,MLI,"FW,MF",Atalanta,21,2001,0.4,0,0,0,0,0,0,1,0.0,1,1,0,1,0,0,0,0
Veljko Birmančević,SRB,"FW,MF",Sparta Prague,25,1998,7.1,5,3,2,0,3,2,10,20.0,8,14,0,14,4,9,4,0
Martin Bjørnbak,NOR,DF,Molde,31,1992,2.5,3,3,3,0,0,2,2,100.0,0,1,1,0,2,5,15,0
Rubén Blanco,ESP,GK,Marseille,28,1995,1.0,0,0,0,0,0,0,0,,0,0,0,0,0,0,0,0
Ludovic Blas,FRA,"FW,MF",Rennes,25,1997,4.1,5,3,3,2,0,1,2,50.0,1,4,0,4,1,6,0,0
Lewin Blum,SUI,DF,Young Boys,22,2001,1.3,3,3,1,1,1,2,3,66.7,1,2,0,2,1,4,1,0
Eric Boakye,GHA,DF,Aris Limassol FC,23,1999,2.2,6,5,6,0,0,4,6,66.7,2,0,0,0,8,14,3,0
Bendegúz Bolla,HUN,"MF,DF",Servette FC,23,1999,4.7,9,6,3,4,2,8,9,88.9,1,5,0,5,7,16,7,0
Valerii Bondar,UKR,DF,Shakhtar,24,1999,1.0,0,0,0,0,0,0,1,0.0,1,1,1,0,0,0,3,0
Artem Bondarenko,UKR,MF,Shakhtar,22,2000,1.9,1,1,0,1,0,1,2,50.0,1,3,2,1,3,4,2,0
Giovanni Bonfanti,ITA,DF,Atalanta,20,2003,1.0,2,1,0,2,0,2,2,100.0,0,1,1,0,8,10,3,0
Victor Boniface,NGA,FW,Leverkusen,22,2000,4.2,3,2,0,3,0,0,3,0.0,3,1,0,1,2,5,4,0
Jan Bořil,CZE,"DF,MF",Slavia Prague,32,1991,2.2,3,1,1,1,1,3,4,75.0,1,2,0,2,1,4,4,0
Cristian Borja,COL,DF,Braga,30,1993,1.7,4,3,3,1,0,0,2,0.0,2,1,0,1,0,4,4,0
Aleksandar Borković,AUT,DF,Sturm Graz,24,1999,0.8,1,1,1,0,0,1,3,33.3,2,1,1,0,0,1,1,0
Dan Boţan,MDA,MF,Sheriff Tiraspol,18,2005,0.0,0,0,0,0,0,0,0,,0,0,0,0,0,0,0,0
Benjamin Bourigeaud,FRA,"MF,FW",Rennes,29,1994,5.2,4,2,1,3,0,4,10,40.0,6,5,1,4,8,12,2,0
Edoardo Bove,ITA,MF,Roma,21,2002,7.9,26,15,16,8,2,20,32,62.5,12,12,4,8,9,35,5,0
Jarrod Bowen,ENG,FW,West Ham,26,1996,6.1,4,2,2,2,0,0,4,0.0,4,3,0,3,1,5,1,0
Conor Bradley,NIR,DF,Liverpool,20,2003,2.6,4,2,2,2,0,4,11,36.4,7,8,1,7,2,6,4,0
Daniel Bragança,POR,MF,Sporting CP,24,1999,5.5,21,12,6,13,2,12,18,66.7,6,11,0,11,4,25,4,0
Claudio Bravo,CHI,GK,Betis,40,1983,2.0,0,0,0,0,0,0,1,0.0,1,0,0,0,0,0,2,0
Emil Breivik,NOR,MF,Molde,23,2000,5.0,10,8,4,4,2,3,9,33.3,6,8,2,6,5,15,6,0
Ben Brereton,CHI,FW,Villarreal,24,1999,2.4,2,1,0,1,1,1,1,100.0,0,1,0,1,0,2,0,0
Maximilian Breunig,GER,FW,Freiburg,22,2000,0.0,0,0,0,0,0,0,0,,0,1,0,1,0,0,0,0
Alberto Brignoli,ITA,GK,Panathinaikos,31,1991,5.0,0,0,0,0,0,0,0,,0,0,0,0,0,0,1,0
Brian Brobbey,NED,FW,Ajax,21,2002,5.1,0,0,0,0,0,0,0,,0,3,0,3,0,0,2,0
Franz Brorsson,SWE,"DF,FW",Aris Limassol FC,27,1996,2.1,3,1,2,1,0,3,5,60.0,2,5,3,2,3,6,11,1
Morgan Brown,ENG,MF,Aris Limassol FC,23,1999,1.3,5,5,3,2,0,4,7,57.1,3,1,1,0,1,6,2,0
Bruma,POR,"DF,MF",Braga,28,1994,0.6,1,1,1,0,0,1,2,50.0,1,1,1,0,0,1,0,0
Isak Brusberg,SWE,MF,Häcken,16,2006,0.1,0,0,0,0,0,0,1,0.0,1,0,0,0,0,0,0,0
Facundo Buonanotte,ARG,"MF,FW",Brighton,18,2004,2.4,4,4,2,1,1,1,7,14.3,6,4,0,4,1,5,0,0
Mick van Buren,NED,FW,Slavia Prague,30,1992,2.4,1,1,1,0,0,0,3,0.0,3,3,0,3,3,4,1,0
Christian Burgess,ENG,DF,Union SG,31,1991,6.0,7,5,6,1,0,4,5,80.0,1,5,5,0,3,10,38,1
Jack Butland,ENG,GK,Rangers,30,1993,8.0,0,0,0,0,0,0,0,,0,0,0,0,0,0,3,0
Arthur Cabral,BRA,FW,Benfica,25,1998,2.4,2,1,0,1,1,0,0,,0,4,2,2,0,2,3,0
Caju,BRA,DF,Aris Limassol FC,28,1995,4.7,17,12,12,5,0,12,17,70.6,5,5,1,4,3,20,12,0
Davide Calabria,ITA,DF,Milan,26,1996,2.5,9,6,4,4,1,4,8,50.0,4,5,1,4,4,13,6,0
Josip Čalušić,CRO,DF,TSC Bačka Top,29,1993,4.5,1,0,1,0,0,0,1,0.0,1,8,6,2,3,4,20,0
Mohamed Camara,GUI,MF,Olympiacos,26,1997,5.9,9,3,3,5,1,4,4,100.0,0,6,2,4,10,19,5,0
Aitor Cantalapiedra,ESP,FW,Panathinaikos,27,1996,2.6,4,1,1,2,1,0,3,0.0,3,2,0,2,3,7,0,0
Todd Cantwell,ENG,"FW,MF",Rangers,25,1998,2.0,1,1,0,1,0,0,0,,0,2,0,2,2,3,0,0
Étienne Capoue,FRA,MF,Villarreal,35,1988,5.2,12,5,4,5,3,6,8,75.0,2,2,0,2,8,20,4,0
Christian Cappis,USA,"MF,DF",Molde,23,1999,0.3,2,1,1,1,0,1,2,50.0,1,1,0,1,1,3,1,0
Marco Carnesecchi,ITA,GK,Atalanta,23,2000,0.9,0,0,0,0,0,0,0,,0,0,0,0,0,0,0,0
Álvaro Carreras,ESP,DF,Benfica,20,2003,1.2,1,0,0,1,0,0,2,0.0,2,1,0,1,1,2,6,0
João Carvalho,POR,MF,Olympiacos,26,1997,0.3,2,2,0,0,2,2,2,100.0,0,0,0,0,0,2,0,0
Vitor Carvalho,BRA,MF,Braga,26,1997,1.4,1,0,1,0,0,1,2,50.0,1,0,0,0,1,2,1,0
William Carvalho,POR,MF,Betis,31,1992,3.4,6,4,1,4,1,2,5,40.0,3,6,3,3,3,9,5,0
Cristian Cásseres Jr.,VEN,MF,Toulouse,23,2000,5.4,20,9,14,5,1,8,13,61.5,5,7,0,7,9,29,14,0
Alessio Castro-Montes,BEL,"DF,MF",Union SG,26,1997,5.2,15,8,4,10,1,6,12,50.0,6,6,1,5,8,23,7,0
Geny Catamo,MOZ,"MF,DF",Sporting CP,22,2001,3.7,2,0,2,0,0,0,2,0.0,2,1,0,1,2,4,2,0
Marcin Cebula,POL,"FW,MF",RKS Raków,27,1995,3.3,4,1,2,1,1,2,4,50.0,2,1,0,1,1,5,2,0
Zeki Çelik,TUR,DF,Roma,26,1997,9.0,22,15,9,8,5,12,21,57.1,9,15,2,13,11,33,27,2
Luke Chambers,ENG,DF,Liverpool,19,2004,1.5,2,1,1,1,0,1,2,50.0,1,0,0,0,2,4,4,0
Jhoanner Chávez,ECU,DF,Lens,21,2002,1.2,0,0,0,0,0,0,1,0.0,1,1,0,1,2,2,1,0
Luigi Cherubini,ITA,MF,Roma,19,2004,0.0,0,0,0,0,0,0,0,,0,0,0,0,0,0,0,0
Tjaronn Chery,SUR,"MF,FW",Maccabi Haifa,35,1988,2.9,2,2,0,2,0,0,2,0.0,2,0,0,0,0,2,0,0
Edward Chilufya,ZAM,FW,Häcken,23,1999,5.1,9,6,3,2,4,5,11,45.5,6,2,0,2,1,10,0,0
Samuel Chukwueze,NGA,FW,Milan,24,1999,1.3,1,1,0,1,0,0,2,0.0,2,0,0,0,1,2,1,0
Mojmir Chytil,CZE,FW,Slavia Prague,24,1999,4.4,4,2,0,1,3,2,2,100.0,0,8,2,6,0,4,0,0
José Cifuentes,ECU,MF,Rangers,24,1999,2.7,5,3,3,2,0,3,8,37.5,5,0,0,0,4,9,5,0
Aleksandar Ćirković,SRB,"FW,MF",TSC Bačka Top,21,2001,2.5,2,1,0,1,1,2,3,66.7,1,1,0,1,1,3,1,0
Moustapha Cissé,GUI,FW,Atalanta,19,2003,0.0,0,0,0,0,0,0,0,,0,0,0,0,0,0,0,0
Ibrahim Cissoko,NED,MF,Toulouse,20,2003,0.7,1,0,1,0,0,0,1,0.0,1,0,0,0,0,1,0,0
Bobby Clark,ENG,MF,Liverpool,18,2005,1.1,6,3,0,3,3,3,3,100.0,0,1,0,1,1,7,0,0
Jonathan Clauss,FRA,"DF,MF",Marseille,30,1992,11.1,21,15,11,8,2,9,18,50.0,9,9,3,6,14,35,22,1
Sebastián Coates,URU,DF,Sporting CP,32,1990,5.6,12,6,7,5,0,8,10,80.0,2,4,2,2,4,16,29,0
Timothé Cognat,FRA,MF,Servette FC,25,1998,3.7,11,3,1,7,3,4,5,80.0,1,5,0,5,5,16,1,0
Ebrima Colley,GAM,FW,Young Boys,23,2000,0.7,0,0,0,0,0,0,0,,0,1,0,1,0,0,0,0
Santi Comesaña,ESP,MF,Villarreal,26,1996,3.6,3,3,1,2,0,3,7,42.9,4,8,0,8,1,4,4,0
Francis Coquelin,FRA,MF,Villarreal,32,1991,2.1,3,2,0,0,3,1,3,33.3,2,1,0,1,3,6,2,0
Maxwel Cornet,CIV,"FW,MF",West Ham,26,1996,0.7,0,0,0,0,0,0,1,0.0,1,2,0,2,0,0,0,0
Pierre Cornud,FRA,DF,Maccabi Haifa,26,1996,4.2,14,11,13,1,0,9,17,52.9,8,4,2,2,2,16,16,0
Joaquín Correa,ARG,"MF,FW",Marseille,28,1994,2.8,4,3,2,1,1,2,5,40.0,3,2,0,2,0,4,1,0
David Costa,POR,MF,Lens,22,2001,1.7,0,0,0,0,0,0,1,0.0,1,1,0,1,2,2,1,0
João Costa,BRA,"MF,FW",Roma,18,2005,0.1,3,2,3,0,0,1,1,100.0,0,0,0,0,0,3,0,0
Logan Costa,CPV,DF,Toulouse,22,2001,7.0,14,14,10,3,1,4,6,66.7,2,9,7,2,5,19,36,0
Vladimír Coufal,CZE,DF,West Ham,30,1992,6.9,4,3,3,1,0,3,8,37.5,5,4,1,3,5,9,24,0
Aaron Cresswell,ENG,DF,West Ham,33,1989,4.6,4,3,2,2,0,2,3,66.7,1,2,0,2,2,6,10,1
Bryan Cristante,ITA,"MF,DF",Roma,28,1995,11.9,24,12,15,8,1,11,18,61.1,7,15,5,10,12,36,15,0
Enzo Crivelli,FRA,"FW,DF",Servette FC,28,1995,2.1,0,0,0,0,0,0,1,0.0,1,2,0,2,0,0,3,0
Ante Crnac,CRO,FW,RKS Raków,19,2003,3.2,3,3,3,0,0,1,5,20.0,4,2,0,2,0,3,4,0
Jorge Cuenca,ESP,DF,Villarreal,23,1999,4.1,2,1,2,0,0,2,2,100.0,0,3,1,2,4,6,19,0
Miloš Cvetković,SRB,DF,TSC Bačka Top,33,1990,5.1,12,5,5,6,1,7,12,58.3,5,4,0,4,3,15,6,0
Elvin Cəfərquliyev,AZE,DF,Qarabağ,22,2000,8.3,15,8,9,5,1,10,18,55.6,8,11,3,8,5,20,23,0
Francesco D'Alessio,ITA,MF,Roma,19,2004,0.2,2,0,2,0,0,0,0,,0,1,1,0,1,3,0,0
Pontus Dahbo,SWE,MF,Häcken,17,2005,1.5,1,0,0,0,1,1,7,14.3,6,4,1,3,2,3,0,0
Mahmoud Dahoud,GER,"MF,FW",Brighton,27,1996,1.8,3,1,0,2,1,0,3,0.0,3,1,1,0,1,4,2,0
Thijs Dallinga,NED,FW,Toulouse,22,2000,7.3,7,6,1,3,3,3,3,100.0,0,4,0,4,1,8,11,0
Danilo,BRA,FW,Rangers,24,1999,2.1,1,1,0,0,1,0,4,0.0,4,3,1,2,0,1,0,0
Jayden Danns,ENG,DF,Liverpool,17,2006,0.1,1,0,1,0,0,0,0,,0,0,0,0,0,1,0,0
Kevin Danso,AUT,DF,Lens,24,1998,1.0,1,1,1,0,0,0,0,,0,6,5,1,1,2,1,1
Amadou Dante,MLI,DF,Sturm Graz,22,2000,3.1,8,6,4,4,0,6,9,66.7,3,3,0,3,10,18,13,0
Raimane Daou,COM,DF,Marseille,18,2004,0.2,1,1,0,1,0,0,1,0.0,1,0,0,0,1,2,0,0
Ebrima Darboe,GAM,"MF,DF",LASK,22,2001,0.4,3,0,0,2,1,2,3,66.7,1,1,0,1,0,3,1,0
Dean David,ISR,"FW,MF",Maccabi Haifa,27,1996,4.3,1,0,0,0,1,1,2,50.0,1,1,0,1,2,3,2,0
Ben Davies,ENG,DF,Rangers,27,1995,6.0,11,7,7,4,0,8,11,72.7,3,10,5,5,3,14,27,1
Charles De Ketelaere,BEL,"FW,MF",Atalanta,22,2001,6.8,11,5,2,4,5,4,10,40.0,6,12,1,11,5,16,6,0
Tommaso De Nipoti,ITA,FW,Atalanta,20,2003,0.0,0,0,0,0,0,0,0,,0,0,0,0,0,0,0,0
Tommaso Del Lungo,ITA,DF,Atalanta,19,2003,1.0,5,3,2,2,1,2,6,33.3,4,1,0,1,1,6,6,0
Kerem Demirbay,GER,MF,Galatasaray,30,1993,1.7,2,2,1,1,0,1,3,33.3,2,1,0,1,5,7,2,1
Branco van den Boomen,NED,MF,Ajax,28,1995,0.5,3,3,2,1,0,2,2,100.0,0,0,0,0,0,3,0,0
Mikkel Desler,DEN,DF,Toulouse,28,1995,6.1,19,11,12,5,2,7,14,50.0,7,14,6,8,13,32,11,0
Cyriel Dessers,NGA,FW,Rangers,28,1994,4.3,3,3,1,1,1,1,4,25.0,3,1,0,1,0,3,0,0
Ángel Di María,ARG,FW,Benfica,35,1988,6.3,11,9,4,3,4,6,16,37.5,10,6,0,6,2,13,3,1
Assane Diao,ESP,FW,Betis,17,2005,2.8,3,1,1,1,1,1,3,33.3,2,5,0,5,1,4,3,0
Moussa Diarra,MLI,DF,Toulouse,22,2000,6.1,9,5,2,6,1,3,7,42.9,4,15,4,11,12,21,11,0
Luis Díaz,COL,FW,Liverpool,26,1997,4.9,5,4,0,3,2,3,4,75.0,1,3,0,3,1,6,0,0
Mohamed Diomandé,CIV,MF,Rangers,21,2001,1.9,3,2,3,0,0,3,6,50.0,3,2,0,2,2,5,4,0
Ousmane Diomande,CIV,DF,Sporting CP,19,2003,6.7,10,5,7,3,0,6,7,85.7,1,11,2,9,8,18,16,0
Andy Diouf,FRA,"MF,DF",Lens,20,2003,0.9,1,0,1,0,0,1,3,33.3,2,1,0,1,1,2,1,0
Álvaro djaló,ESP,MF,Braga,23,1999,1.4,6,3,1,4,1,1,2,50.0,1,1,0,1,0,6,0,0
Berat Djimsiti,ALB,DF,Atalanta,30,1993,11.6,19,12,8,10,1,6,14,42.9,8,14,7,7,22,41,45,1
Ben Doak,SCO,FW,Liverpool,17,2005,1.9,2,0,1,1,0,2,3,66.7,1,1,0,1,0,2,2,0
Ritsu Doan,JPN,"MF,FW",Freiburg,25,1998,8.8,22,14,5,13,4,7,14,50.0,7,13,1,12,3,25,9,0
Oscar Dorley,LBR,MF,Slavia Prague,25,1998,7.4,8,4,2,6,0,2,7,28.6,5,10,1,9,7,15,7,0
David Doudera,CZE,"DF,MF",Slavia Prague,25,1998,7.3,11,5,2,6,3,5,12,41.7,7,7,0,7,3,14,3,0
Désiré Doué,FRA,MF,Rennes,18,2005,3.8,9,6,1,3,5,6,13,46.2,7,7,0,7,6,15,0,0
Guela Doué,CIV,DF,Rennes,20,2002,3.4,8,5,5,2,1,6,8,75.0,2,5,1,4,2,10,4,0
David Douline,FRA,"MF,FW",Servette FC,30,1993,1.9,14,6,4,9,1,6,6,100.0,0,5,1,4,2,16,4,0
Josh Duffus,ENG,FW,Brighton,18,2004,0.0,0,0,0,0,0,0,0,,0,0,0,0,0,0,0,0
Andres Dumitrescu,ROU,"DF,MF",Slavia Prague,22,2001,3.7,6,2,4,2,0,2,4,50.0,2,2,0,2,4,10,7,0
Lewis Dunk,ENG,DF,Brighton,31,1991,6.5,7,6,2,5,0,4,8,50.0,4,9,6,3,3,10,9,2
Paulo Dybala,ARG,FW,Roma,29,1993,6.7,5,3,1,2,2,3,9,33.3,6,3,0,3,2,7,2,0
Aron Dønnum,NOR,"MF,FW",Toulouse,25,1998,6.9,12,7,6,5,1,5,9,55.6,4,11,1,10,2,14,0,0
George Earthy,ENG,MF,West Ham,18,2004,0.1,0,0,0,0,0,0,0,,0,0,0,0,0,0,0,0
Dennis Eckert,GER,FW,Union SG,26,1997,0.8,0,0,0,0,0,0,0,,0,0,0,0,0,0,0,0
Éderson,BRA,MF,Atalanta,24,1999,10.2,21,15,8,11,2,8,12,66.7,4,11,0,11,18,39,13,0
Marcus Edwards,ENG,"MF,FW",Sporting CP,24,1998,6.6,2,1,0,2,0,2,4,50.0,2,4,0,4,4,6,0,0
Maximilian Eggestein,GER,MF,Freiburg,26,1996,9.7,13,4,7,4,2,4,11,36.4,7,10,4,6,7,20,6,0
Eguinaldo,BRA,"MF,FW",Shakhtar,18,2004,2.0,2,1,1,1,0,2,2,100.0,0,2,0,2,1,3,3,0
Meschak Elia,COD,FW,Young Boys,25,1997,1.1,2,2,0,1,1,1,1,100.0,0,0,0,0,0,2,0,0
Niclas Eliasson,SWE,"FW,MF",AEK Athens,27,1995,1.9,0,0,0,0,0,0,1,0.0,1,0,0,0,1,1,1,0
Martin Ellingsen,NOR,"DF,MF",Molde,28,1995,5.7,10,8,6,4,0,6,9,66.7,3,7,1,6,12,22,14,2
Harvey Elliott,ENG,"MF,FW",Liverpool,20,2003,8.3,13,9,4,7,2,5,19,26.3,14,11,0,11,6,19,2,0
Julio Enciso,PAR,"FW,MF",Brighton,19,2004,1.1,1,1,0,0,1,0,0,,0,1,0,1,0,1,1,0
Wataru Endo,JPN,MF,Liverpool,30,1993,6.5,13,6,2,6,5,5,16,31.3,11,9,0,9,9,22,9,0
Enrique,ESP,DF,Betis,19,2003,0.1,0,0,0,0,0,0,0,,0,0,0,0,1,1,0,0
Kristian Eriksen,NOR,"MF,FW",Molde,28,1995,4.2,1,0,0,0,1,1,4,25.0,3,9,1,8,3,4,2,0
Ricardo Esgaio,POR,"DF,MF",Sporting CP,30,1993,5.8,12,9,5,3,4,10,14,71.4,4,7,2,5,6,18,8,0
Dario Essugo,POR,DF,Sporting CP,18,2005,0.4,1,1,1,0,0,0,0,,0,0,0,0,0,1,0,0
Pervis Estupiñán,ECU,DF,Brighton,25,1998,2.0,3,2,2,1,0,1,1,100.0,0,2,1,1,0,3,4,0
Abde Ezzalzouli,MAR,FW,Betis,21,2001,4.3,6,2,1,4,1,3,5,60.0,2,4,0,4,1,7,1,0
Łukasz Fabiański,POL,GK,West Ham,38,1985,9.0,0,0,0,0,0,0,0,,0,0,0,0,0,0,3,0
Ansu Fati,ESP,"MF,FW",Brighton,20,2002,4.1,3,3,0,0,3,0,1,0.0,1,5,0,5,2,5,2,0
Ilay Feingold,ISR,DF,Maccabi Haifa,18,2004,0.8,1,0,0,1,0,0,0,,0,1,1,0,1,2,3,0
Nabil Fekir,FRA,"MF,FW",Betis,30,1993,0.7,0,0,0,0,0,0,0,,0,0,0,0,0,0,0,0
Kiko Femenía,ESP,DF,Villarreal,32,1991,3.2,3,2,0,3,0,2,2,100.0,0,4,0,4,5,8,7,0
Evan Ferguson,IRL,"MF,FW",Brighton,18,2004,2.3,4,2,2,2,0,2,2,100.0,0,3,0,3,2,6,1,0
Roger Fernandes,GNB,"MF,DF",Braga,17,2005,1.7,6,5,1,4,1,2,3,66.7,1,3,0,3,0,6,0,0
Tiago Ferreira,POR,FW,Sporting CP,21,2002,0.2,1,1,0,1,0,1,2,50.0,1,0,0,0,0,1,0,0
Florian Flecker,AUT,"MF,DF",LASK,27,1995,2.9,8,4,1,5,2,5,9,55.6,4,0,0,0,7,15,3,0
Alessandro Florenzi,ITA,DF,Milan,32,1991,2.5,1,0,0,1,0,0,1,0.0,1,3,2,1,1,2,4,0
Carlos Forbs,POR,"FW,DF",Ajax,19,2004,4.0,6,3,3,2,1,3,11,27.3,8,5,0,5,3,9,1,1
Pablo Fornals,ESP,"FW,MF",West Ham,27,1996,3.5,1,0,1,0,0,1,2,50.0,1,3,0,3,8,9,0,0
Kostas Fortounis,GRE,FW,Olympiacos,30,1992,5.4,10,7,2,5,3,4,8,50.0,4,7,0,7,3,13,1,0
Juan Foyth,ARG,DF,Villarreal,25,1998,2.0,3,2,3,0,0,1,1,100.0,0,2,1,1,2,5,4,0
Lassina Franck Traoré,BFA,"DF,FW",Shakhtar,22,2001,0.1,0,0,0,0,0,0,0,,0,0,0,0,0,0,0,0
Przemysław Frankowski,POL,DF,Lens,28,1995,1.8,3,0,3,0,0,1,4,25.0,3,2,1,1,1,4,4,0
Nicolás Freire,ARG,DF,Olympiacos,29,1994,1.0,0,0,0,0,0,0,0,,0,2,1,1,2,2,7,1
Iván Fresneda,ESP,MF,Sporting CP,18,2004,1.4,1,1,1,0,0,1,5,20.0,4,2,1,1,0,1,1,0
Jérémy Frick,SUI,GK,Servette FC,30,1993,6.0,0,0,0,0,0,0,1,0.0,1,0,0,0,0,0,2,0
Jeremie Frimpong,NED,"DF,MF",Leverkusen,22,2000,7.1,9,4,2,5,2,3,11,27.3,8,10,0,10,2,11,3,0
Angelo Fulgini,FRA,MF,Lens,26,1996,0.7,2,1,0,1,1,1,1,100.0,0,2,0,2,0,2,0,0
Mohammed Fuseini,GHA,"DF,MF",Sturm Graz,21,2002,0.2,0,0,0,0,0,0,0,,0,0,0,0,0,0,0,0
Anton Gaaei,DEN,DF,Ajax,20,2002,3.9,7,2,5,2,0,4,6,66.7,2,2,0,2,6,13,7,0
Matteo Gabbia,ITA,DF,Villarreal,23,1999,5.5,3,1,2,1,0,2,4,50.0,2,5,5,0,6,9,18,0
Matteo Gabbia,ITA,DF,Milan,23,1999,5.5,9,5,5,3,1,4,5,80.0,1,6,3,3,0,9,15,1
Mijat Gaćinović,SRB,MF,AEK Athens,28,1995,3.1,2,0,2,0,0,1,2,50.0,1,5,0,5,0,2,1,0
Cody Gakpo,NED,FW,Liverpool,24,1999,7.1,5,4,1,2,2,2,7,28.6,5,6,0,6,1,6,5,0
Konstantinos Galanopoulos,GRE,MF,AEK Athens,25,1997,0.4,0,0,0,0,0,0,3,0.0,3,0,0,0,0,0,1,0
Gauthier Gallon,FRA,GK,Rennes,30,1993,1.0,0,0,0,0,0,0,0,,0,0,0,0,0,0,1,0
Silvère Ganvoula M'Boussy,CGO,FW,Young Boys,27,1996,0.7,1,0,0,0,1,0,0,,0,0,0,0,0,1,0,0
Munashe Garan'anga,ZIM,DF,Sheriff Tiraspol,22,2001,4.4,7,6,5,2,0,3,3,100.0,0,9,7,2,9,16,23,1
Levi Garcia,TRI,FW,AEK Athens,25,1997,2.3,0,0,0,0,0,0,0,,0,0,0,0,0,0,2,0
Jusuf Gazibegović,BIH,DF,Sturm Graz,23,2000,5.9,12,11,4,4,4,6,8,75.0,2,9,1,8,10,22,8,0
Yann Gboho,FRA,MF,Toulouse,22,2001,1.8,3,2,0,2,1,2,7,28.6,5,4,0,4,1,4,0,0
Lutsharel Geertruida,NED,DF,Feyenoord,23,2000,1.3,2,2,1,1,0,1,3,33.3,2,2,0,2,1,3,3,0
Gelabert,ESP,"MF,FW",Toulouse,22,2000,2.2,3,1,0,1,2,0,2,0.0,2,0,0,0,0,3,2,0
Denis Genreau,AUS,"FW,MF",Toulouse,24,1999,0.7,1,0,0,0,1,0,1,0.0,1,0,0,0,0,1,2,0
Rami Gershon,ISR,DF,Maccabi Haifa,34,1988,3.0,2,0,1,1,0,0,1,0.0,1,0,0,0,3,5,17,0
Samuel Gigot,FRA,DF,Marseille,29,1993,7.1,13,7,5,6,2,5,6,83.3,1,9,4,5,12,25,21,0
Billy Gilmour,SCO,MF,Brighton,22,2001,6.6,5,2,1,2,2,3,9,33.3,6,2,0,2,4,9,5,0
Santiago Giménez,MEX,FW,Feyenoord,22,2001,1.2,1,1,0,0,1,0,0,,0,1,0,1,0,1,2,0
Matthias Ginter,GER,DF,Freiburg,29,1994,8.4,9,4,4,4,1,2,3,66.7,1,5,2,3,3,12,26,0
Olivier Giroud,FRA,FW,Milan,36,1986,4.9,2,2,0,1,1,0,1,0.0,1,0,0,0,1,3,4,0
Adam Gnezda Čerin,SVN,MF,Panathinaikos,24,1999,4.0,10,5,2,5,3,5,10,50.0,5,5,0,5,2,12,1,0
Giorgi Gocholeishvili,GEO,DF,Shakhtar,22,2001,0.2,0,0,0,0,0,0,3,0.0,3,0,0,0,1,1,0,0
Mika Godts,BEL,"FW,MF",Ajax,18,2005,0.3,1,0,0,0,1,0,0,,0,0,0,0,0,1,0,0
Thomas Goiginger,AUT,FW,LASK,30,1993,0.6,2,1,1,0,1,2,5,40.0,3,0,0,0,0,2,0,0
Sean Goldberg,ISR,DF,Maccabi Haifa,28,1995,0.8,0,0,0,0,0,0,0,,0,1,1,0,1,1,6,0
Connor Goldson,ENG,DF,Rangers,30,1992,7.0,10,7,7,3,0,6,12,50.0,6,9,3,6,8,18,46,0
James Gomez,GAM,DF,Sparta Prague,21,2001,0.5,1,1,0,1,0,0,1,0.0,1,2,0,2,0,1,1,1
Joe Gomez,ENG,DF,Liverpool,26,1997,6.4,15,11,11,4,0,9,14,64.3,5,8,3,5,12,27,13,0
Victor Gomez,ESP,DF,Braga,23,2000,1.5,1,1,1,0,0,1,1,100.0,0,2,0,2,1,2,4,0
Yannick Gomis,SEN,"MF,FW",Aris Limassol FC,31,1992,4.3,1,1,1,0,0,1,1,100.0,0,0,0,0,0,1,3,0
Pedro Gonçalves,POR,"MF,FW",Sporting CP,25,1998,5.3,7,4,3,1,3,3,9,33.3,6,8,0,8,2,9,0,0
Tristan Gooijer,NED,DF,Ajax,18,2004,0.2,0,0,0,0,0,0,1,0.0,1,0,0,0,3,3,1,0
Kaide Gordon,ENG,FW,Liverpool,18,2004,0.8,0,0,0,0,0,0,0,,0,0,0,0,0,0,0,0
Jon Gorenc Stanković,SVN,MF,Sturm Graz,27,1996,6.0,17,11,8,8,1,9,15,60.0,6,16,4,12,8,25,13,0
Jay Gorter,NED,GK,Ajax,23,2000,2.0,0,0,0,0,0,0,0,,0,0,0,0,0,0,0,0
Amine Gouiri,ALG,"FW,MF",Rennes,23,2000,3.6,6,3,1,3,2,4,7,57.1,3,3,1,2,0,6,0,0
Tiago Gouveia,POR,"FW,MF",Benfica,22,2001,0.1,1,1,1,0,0,0,0,,0,0,0,0,0,1,0,0
Jonathan Gradit,FRA,DF,Lens,30,1992,2.1,1,0,0,1,0,0,0,,0,3,2,1,2,3,13,0
Ryan Gravenberch,NED,MF,Liverpool,21,2002,3.8,9,5,1,5,3,2,2,100.0,0,10,0,10,3,12,3,0
Michael Gregoritsch,AUT,FW,Freiburg,29,1994,3.8,5,3,1,3,1,1,4,25.0,3,0,0,0,1,6,3,0
Leon Grgic,AUT,MF,Sturm Graz,17,2006,0.0,0,0,0,0,0,0,0,,0,0,0,0,0,0,0,0
Vincenzo Grifo,ITA,"MF,FW",Freiburg,30,1993,6.9,8,8,3,4,1,4,13,30.8,9,4,1,3,4,12,5,1
Álex Grimaldo,ESP,DF,Leverkusen,27,1995,9.3,18,10,10,6,2,8,15,53.3,7,7,1,6,7,25,9,1
Pascal Groß,GER,"MF,DF",Brighton,32,1991,8.0,10,7,3,5,2,8,15,53.3,7,6,1,5,0,10,2,0
Magnus Grødem,NOR,MF,Molde,24,1998,1.6,0,0,0,0,0,0,3,0.0,3,0,0,0,1,1,1,0
Andrés Guardado,MEX,MF,Betis,36,1986,3.0,4,2,0,4,0,2,9,22.2,7,3,0,3,4,8,1,0
Gonçalo Guedes,POR,"FW,MF",Villarreal,26,1996,2.0,2,2,1,1,0,1,3,33.3,2,1,0,1,0,2,0,0
Luka Gugeshashvili,GEO,GK,Qarabağ,24,1999,0.1,0,0,0,0,0,0,0,,0,0,0,0,0,0,0,0
Morgan Guilavogui,GUI,FW,Lens,25,1998,0.5,0,0,0,0,0,0,0,,0,0,0,0,0,0,1,0
Jérémy Guillemenot,SUI,"FW,MF",Servette FC,25,1998,1.7,3,0,0,1,2,1,2,50.0,1,0,0,0,0,3,0,0
Fredrik Gulbrandsen,NOR,FW,Molde,30,1992,3.0,2,2,0,1,1,0,1,0.0,1,1,0,1,4,6,0,0
Manuel Gulde,GER,DF,Freiburg,32,1991,6.9,9,6,5,4,0,3,7,42.9,4,3,2,1,7,16,19,0
Christian Günter,GER,DF,Freiburg,30,1993,2.2,0,0,0,0,0,0,1,0.0,1,1,0,1,0,0,8,0
Samuel Gustafson,SWE,MF,Häcken,28,1995,5.9,8,3,4,4,0,6,14,42.9,8,8,3,5,2,10,6,0
Simon Gustafson,SWE,"MF,FW",Häcken,28,1995,2.2,1,1,0,0,1,0,5,0.0,5,2,1,1,1,2,1,1
Viktor Gyökeres,SWE,FW,Sporting CP,25,1998,6.9,4,3,0,3,1,0,0,,0,2,0,2,1,5,2,0
Jaouen Hadjam,ALG,DF,Young Boys,20,2003,1.7,3,2,1,1,1,1,1,100.0,0,5,1,4,2,5,3,0
El Hadji Diouf,SEN,DF,Slavia Prague,18,2004,0.3,0,0,0,0,0,0,0,,0,0,0,0,1,1,0,0
Anders Hagelskjær,DEN,DF,Molde,26,1997,4.0,8,5,6,2,0,5,10,50.0,5,3,2,1,3,11,19,0
Massadio Haïdara,MLI,DF,Lens,30,1992,1.4,0,0,0,0,0,0,0,,0,3,1,2,3,3,5,0
Ilay Hajaj,ISR,"FW,DF",Maccabi Haifa,21,2001,2.7,6,4,4,2,0,4,14,28.6,10,3,1,2,3,9,8,0
Ehsan Hajsafi,IRN,DF,AEK Athens,33,1990,5.0,8,4,4,4,0,5,8,62.5,3,4,0,4,5,13,7,0
Johan Hammar,SWE,DF,Häcken,29,1994,1.7,2,1,2,0,0,1,2,50.0,1,4,4,0,2,4,2,0
Dávid Hancko,SVK,DF,Feyenoord,25,1997,2.3,1,0,1,0,0,0,1,0.0,1,3,3,0,2,3,15,0
Lukáš Haraslín,SVK,"MF,FW",Sparta Prague,27,1996,5.8,3,3,0,3,0,1,2,50.0,1,7,0,7,1,4,0,1
Amine Harit,MAR,"MF,FW",Marseille,26,1997,12.9,12,9,4,5,3,5,13,38.5,8,9,0,9,6,18,2,0
Quilindschy Hartman,NED,DF,Feyenoord,21,2001,2.3,4,4,1,2,1,2,2,100.0,0,0,0,0,4,8,5,0
Hans Hateboer,NED,DF,Atalanta,29,1994,3.1,4,4,2,2,0,1,3,33.3,2,2,1,1,5,9,7,0
Jorrel Hato,NED,DF,Ajax,17,2006,6.0,9,6,7,1,1,5,9,55.6,4,10,6,4,4,13,20,0
Eirik Haugan,NOR,DF,Molde,25,1997,3.0,11,4,6,5,0,7,11,63.6,4,4,3,1,1,12,10,1
Kristoffer Haugen,NOR,DF,Molde,29,1994,5.2,7,3,5,1,1,4,6,66.7,2,4,1,3,5,12,14,1
Elias Havel,AUT,"FW,DF",LASK,20,2003,1.5,0,0,0,0,0,0,2,0.0,2,2,0,2,1,1,2,0
Jan Paul van Hecke,NED,DF,Brighton,23,2000,6.9,7,5,3,3,1,5,7,71.4,2,9,5,4,6,13,19,0
Luis Henrique,BRA,"DF,FW",Marseille,21,2001,4.0,6,5,5,1,0,3,4,75.0,1,3,0,3,6,12,3,0
Luiz Henrique,BRA,FW,Betis,22,2001,2.7,10,4,7,2,1,6,8,75.0,2,3,1,2,1,11,1,0
Theo Hernández,FRA,DF,Milan,25,1997,6.0,5,4,3,1,1,1,4,25.0,3,2,0,2,5,10,13,0
Eirik Hestad,NOR,MF,Molde,28,1995,1.5,3,2,1,2,0,1,1,100.0,0,1,0,1,1,4,1,0
Santiago Hezze,ARG,MF,Olympiacos,21,2001,5.0,9,6,5,4,0,3,10,30.0,7,5,1,4,7,16,3,1
Isak Hien,SWE,DF,Atalanta,24,1999,5.5,13,7,5,8,0,8,10,80.0,2,4,2,2,1,14,21,1
Stefan Hierländer,AUT,MF,Sturm Graz,32,1991,2.8,8,5,4,4,0,6,10,60.0,4,4,0,4,6,14,2,0
Piero Hincapié,ECU,DF,Leverkusen,21,2002,10.1,19,14,13,5,1,5,13,38.5,8,11,7,4,17,36,29,1
Jack Hinshelwood,ENG,DF,Brighton,18,2005,1.8,4,1,2,2,0,4,5,80.0,1,1,1,0,1,5,3,0
Morten Hjulmand,DEN,MF,Sporting CP,24,1999,6.9,16,10,5,9,2,7,15,46.7,8,6,3,3,9,25,11,0
Adam Hložek,CZE,"FW,MF",Leverkusen,21,2002,4.9,2,1,0,1,1,1,2,50.0,1,5,1,4,2,4,2,0
Nicolas Höfler,GER,MF,Freiburg,33,1990,9.9,24,15,10,13,1,13,23,56.5,10,18,4,14,12,36,11,2
Jonas Hofmann,GER,"MF,FW",Leverkusen,31,1992,3.2,4,3,2,1,1,1,4,25.0,3,3,0,3,2,6,4,0
Lucas Höler,GER,"FW,MF",Freiburg,29,1994,8.3,12,8,2,7,3,5,9,55.6,4,10,2,8,0,12,6,0
Tomáš Holeš,CZE,DF,Slavia Prague,30,1993,6.2,14,11,6,8,0,7,11,63.6,4,7,4,3,15,29,14,1
Emil Holm,SWE,"MF,DF",Atalanta,23,2000,3.4,8,3,7,1,0,2,6,33.3,4,9,2,7,1,9,5,0
Tomi Horvat,SVN,"MF,FW",Sturm Graz,24,1999,2.4,8,7,3,3,2,4,7,57.1,3,2,0,2,1,9,3,0
Sascha Horvath,AUT,MF,LASK,26,1996,5.0,15,9,8,6,1,4,9,44.4,5,5,2,3,1,16,5,1
Even Hovland,NOR,DF,Häcken,34,1989,5.0,5,2,2,3,0,3,5,60.0,2,6,2,4,5,10,10,1
Jakub Hromada,SVK,MF,Slavia Prague,27,1996,0.6,1,0,1,0,0,1,1,100.0,0,2,1,1,2,3,1,0
Srđan Hrstić,SRB,FW,Häcken,20,2003,1.6,1,1,0,1,0,0,0,,0,1,0,1,1,2,0,0
Badavi Huseynov,AZE,DF,Qarabağ,32,1991,6.3,5,5,4,1,0,4,6,66.7,2,10,6,4,1,6,33,0
Vicente Iborra,ESP,MF,Olympiacos,35,1988,1.2,0,0,0,0,0,0,1,0.0,1,1,0,1,1,1,5,0
Mauro Icardi,ARG,FW,Galatasaray,30,1993,2.0,0,0,0,0,0,0,0,,0,2,1,1,0,0,2,0
Borja Iglesias,ESP,FW,Leverkusen,30,1993,1.5,4,2,1,2,1,1,3,33.3,2,0,0,0,0,4,0,0
Borja Iglesias,ESP,FW,Betis,30,1993,4.2,1,1,0,1,0,0,1,0.0,1,3,0,3,1,2,1,0
Ogbu Igoh,NGA,DF,Slavia Prague,23,2000,7.0,8,5,8,0,0,7,9,77.8,2,5,2,3,18,26,20,0
Igor,BRA,DF,Brighton,25,1998,4.7,3,2,1,2,0,2,4,50.0,2,6,1,5,3,6,11,0
Veljko Ilic,SRB,GK,TSC Bačka Top,20,2003,5.0,0,0,0,0,0,0,0,,0,0,0,0,0,0,0,1
Gonçalo Inácio,POR,DF,Sporting CP,21,2001,7.6,11,7,9,1,1,5,10,50.0,5,15,6,9,9,20,22,0
Danny Ings,ENG,FW,West Ham,31,1992,2.0,0,0,0,0,0,0,1,0.0,1,0,0,0,0,0,1,0
Fotis Ioannidis,GRE,FW,Panathinaikos,23,2000,4.8,1,1,0,0,1,1,3,33.3,2,5,1,4,0,1,2,0
Aleksei Isayev,AZE,MF,Qarabağ,27,1995,0.1,0,0,0,0,0,0,0,,0,0,0,0,0,0,0,0
Isco,ESP,MF,Betis,31,1992,4.0,4,4,0,3,1,3,6,50.0,3,2,0,2,2,6,0,0
Abdulrazaq Ishaq,NGA,DF,Häcken,21,2002,2.5,10,7,4,4,2,4,11,36.4,7,7,0,7,0,10,3,0
Franco Israel,URU,GK,Sporting CP,23,2000,4.0,0,0,0,0,0,0,0,,0,0,0,0,0,0,1,0
Cedric Itten,SUI,FW,Young Boys,26,1996,1.3,2,1,0,1,1,1,1,100.0,0,1,0,1,0,2,1,0
Luka Ivanušec,CRO,FW,Feyenoord,24,1998,0.9,0,0,0,0,0,0,0,,0,0,0,0,2,2,0,0
Ken Izekor,GER,DF,Leverkusen,16,2007,0.2,0,0,0,0,0,0,0,,0,0,0,0,0,0,0,0
Mahmoud Jaber,ISR,MF,Maccabi Haifa,23,1999,4.4,21,13,2,15,4,7,15,46.7,8,8,2,6,3,24,9,1
Ryan Jack,SCO,MF,Rangers,31,1992,1.3,7,5,3,3,1,4,5,80.0,1,1,0,1,1,8,2,0
Alireza Jahanbakhsh,IRN,MF,Feyenoord,29,1993,0.0,0,0,0,0,0,0,0,,0,0,0,0,0,0,0,0
Saidy Janko,GAM,DF,Young Boys,27,1995,0.7,2,0,0,2,0,2,2,100.0,0,0,0,0,0,2,2,0
Marko Janković,MNE,MF,Qarabağ,28,1995,10.0,19,11,8,8,3,10,25,40.0,15,12,4,8,20,39,8,0
Seedy Jatta,NOR,FW,Sturm Graz,20,2003,1.5,1,1,0,0,1,1,1,100.0,0,0,0,0,0,1,2,0
Tin Jedvaj,CRO,DF,Panathinaikos,27,1995,4.0,7,3,6,1,0,2,4,50.0,2,3,2,1,6,13,6,0
João Pedro,BRA,FW,Brighton,21,2001,4.8,2,1,1,0,1,2,5,40.0,3,4,0,4,0,2,2,0
Ben Johnson,ENG,"DF,MF",West Ham,23,2000,1.1,1,1,1,0,0,0,1,0.0,1,3,2,1,1,2,2,0
Max Johnston,SCO,DF,Sturm Graz,19,2003,0.1,0,0,0,0,0,0,0,,0,0,0,0,0,0,0,0
Curtis Jones,ENG,MF,Liverpool,22,2001,4.4,8,5,2,4,2,4,10,40.0,6,6,1,5,3,11,2,0
Willian José,BRA,FW,Betis,31,1991,1.5,1,1,0,1,0,0,0,,0,0,0,0,1,2,1,0
Diogo Jota,POR,FW,Liverpool,26,1996,2.6,3,2,0,2,1,0,1,0.0,1,1,0,1,0,3,0,0
Saša Jovanović,SRB,FW,TSC Bačka Top,31,1991,3.5,2,1,2,0,0,2,5,40.0,3,2,0,2,1,3,2,0
Stevan Jovetić,MNE,"FW,MF",Olympiacos,33,1989,1.3,0,0,0,0,0,0,2,0.0,2,1,0,1,0,0,2,0
Luka Jović,SRB,"FW,MF",Milan,25,1997,1.8,0,0,0,0,0,0,0,,0,1,0,1,0,0,2,0
Branko Jovičić,SRB,MF,LASK,30,1993,1.8,5,3,3,0,2,5,7,71.4,2,2,0,2,0,5,5,0
Juankar,ESP,DF,Panathinaikos,33,1990,1.9,1,0,1,0,0,0,0,,0,0,0,0,0,1,3,1
Leon-Robin Juberg-Hovland,NOR,MF,Molde,19,2004,0.1,0,0,0,0,0,0,0,,0,0,0,0,0,0,0,0
Juninho,BRA,FW,Qarabağ,26,1996,8.7,8,6,4,2,2,2,9,22.2,7,5,0,5,3,11,5,0
Armel Junior Zohouri,CIV,DF,Sheriff Tiraspol,22,2001,4.6,11,7,10,1,0,7,12,58.3,5,5,2,3,5,16,8,0
Matěj Jurásek,CZE,MF,Slavia Prague,19,2003,0.8,1,0,0,1,0,1,2,50.0,1,0,0,0,0,1,1,0
Václav Jurečka,CZE,"FW,MF",Slavia Prague,29,1994,3.0,5,4,2,3,0,4,4,100.0,0,0,0,0,1,6,4,0
Jens Jønsson,DEN,MF,AEK Athens,30,1993,2.4,5,2,1,4,0,3,7,42.9,4,1,0,1,5,10,2,0
Filip Jørgensen,DEN,GK,Villarreal,21,2002,1.0,0,0,0,0,0,0,0,,0,0,0,0,0,0,2,0
Ayoub El Kaabi,MAR,FW,Olympiacos,30,1993,4.8,2,1,1,1,0,2,3,66.7,1,2,1,1,4,6,4,0
Kaan Kairinen,FIN,MF,Sparta Prague,24,1998,9.1,14,8,4,7,3,5,13,38.5,8,11,3,8,11,25,7,0
Arnaud Kalimuendo,FRA,FW,Rennes,21,2002,3.4,2,2,0,1,1,1,1,100.0,0,1,0,1,0,2,3,0
Pierre Kalulu,FRA,DF,Milan,23,2000,0.5,0,0,0,0,0,0,0,,0,0,0,0,0,0,0,0
Waren Kamanzi,NOR,"DF,FW",Toulouse,22,2000,1.4,5,4,1,3,1,4,4,100.0,0,1,0,1,1,6,4,0
Ola Kamara,NOR,FW,Häcken,33,1989,0.1,0,0,0,0,0,0,0,,0,0,0,0,0,0,0,0
Maor Kandil,ISR,"DF,MF",Maccabi Haifa,29,1993,2.3,8,5,5,3,0,3,4,75.0,1,4,2,2,2,10,8,0
Adam Karabec,CZE,"FW,MF",Sparta Prague,20,2003,2.3,2,1,0,1,1,1,4,25.0,3,4,0,4,0,2,0,0
Jacob Karlstrom,NOR,GK,Molde,26,1997,1.4,0,0,0,0,0,0,0,,0,0,0,0,0,0,0,0
Rick Karsdorp,NED,"DF,FW",Roma,28,1995,5.3,4,3,3,0,1,3,5,60.0,2,3,0,3,7,11,9,1
Kévin Keben Biakolo,CMR,DF,Toulouse,19,2004,0.8,2,2,0,2,0,1,1,100.0,0,0,0,0,2,4,0,0
Thilo Kehrer,GER,DF,West Ham,26,1996,2.9,3,2,2,1,0,1,2,50.0,1,2,0,2,3,6,4,0
Yannik Keitel,GER,DF,Freiburg,23,2000,1.0,0,0,0,0,0,0,0,,0,1,1,0,4,4,7,0
Caoimhín Kelleher,IRL,GK,Liverpool,24,1998,8.0,0,0,0,0,0,0,1,0.0,1,0,0,0,0,0,3,2
Shareef Keouf,ISR,GK,Maccabi Haifa,22,2001,5.0,0,0,0,0,0,0,0,,0,0,0,0,0,0,7,0
Kevin,BRA,MF,Shakhtar,20,2003,0.2,0,0,0,0,0,0,0,,0,0,0,0,0,0,0,0
Hamidou Keyta,FRA,"FW,MF",Qarabağ,28,1994,0.9,1,1,1,0,0,0,3,0.0,3,1,0,1,1,2,2,0
Anan Khalaili,ISR,"FW,MF",Maccabi Haifa,18,2004,4.0,5,2,4,1,0,3,11,27.3,8,5,3,2,6,11,11,0
Abdukodir Khusanov,UZB,DF,Lens,19,2004,1.4,2,1,2,0,0,0,0,,0,2,2,0,3,5,6,1
Gaby Kiki,CMR,DF,Sheriff Tiraspol,28,1995,4.0,14,8,10,4,0,10,12,83.3,2,9,4,5,6,20,39,0
Otar Kiteishvili,GEO,MF,Sturm Graz,27,1996,3.3,8,6,0,4,4,1,2,50.0,1,3,1,2,2,10,3,0
Eric Kitolano,NOR,"FW,MF",Molde,25,1997,1.8,3,2,1,2,0,3,6,50.0,3,4,0,4,0,3,2,0
Sonny Kittel,GER,"FW,MF",RKS Raków,30,1993,1.5,0,0,0,0,0,0,0,,0,1,0,1,0,0,2,0
Simon Kjær,DEN,DF,Milan,34,1989,2.7,4,1,3,1,0,2,2,100.0,0,4,3,1,2,6,15,1
Vladyslav Kocherhin,UKR,"MF,FW",RKS Raków,27,1996,4.8,2,0,2,0,0,1,8,12.5,7,5,1,4,4,6,4,1
Koba Koindredi,FRA,MF,Sporting CP,21,2001,0.9,0,0,0,0,0,0,1,0.0,1,0,0,0,3,3,0,0
Orkun Kökçü,TUR,"FW,MF",Benfica,22,2000,2.0,2,2,2,0,0,0,1,0.0,1,1,0,1,0,2,0,0
Aleksandr Kokorin,RUS,"FW,MF",Aris Limassol FC,32,1991,3.2,2,1,0,0,2,1,4,25.0,3,0,0,0,1,3,3,0
Sead Kolašinac,BIH,DF,Atalanta,30,1993,7.6,21,15,8,12,1,12,20,60.0,8,3,1,2,15,36,20,0
Ibrahima Konaté,FRA,DF,Liverpool,24,1999,5.6,15,9,10,5,0,6,11,54.5,5,8,3,5,10,25,21,0
Geoffrey Kondogbia,CTA,MF,Marseille,30,1993,12.2,32,22,11,17,4,14,23,60.9,9,19,6,13,28,60,13,1
Moussa Koné,SEN,FW,LASK,26,1996,0.7,1,1,0,1,0,0,1,0.0,1,0,0,0,0,1,0,0
Yukhym Konoplia,UKR,DF,Shakhtar,23,1999,1.8,6,4,3,2,1,4,5,80.0,1,1,1,0,4,10,3,0
Teun Koopmeiners,NED,MF,Atalanta,25,1998,10.2,21,12,3,11,7,12,24,50.0,12,15,1,14,6,27,12,0
Odilon Kossounou,CIV,DF,Leverkusen,22,2001,3.2,5,3,3,1,1,4,8,50.0,4,4,1,3,2,7,8,0
Giannis Kotsiras,GRE,DF,Panathinaikos,30,1992,2.0,4,1,3,1,0,1,1,100.0,0,1,0,1,1,5,6,0
Adnan Kovačević,BIH,DF,RKS Raków,29,1993,4.6,9,7,6,2,1,4,8,50.0,4,7,4,3,6,15,26,2
Vladen Kovačević,BIH,GK,RKS Raków,25,1998,6.0,1,1,1,0,0,1,1,100.0,0,0,0,0,0,1,3,0
Maksym Koval,UKR,GK,Sheriff Tiraspol,30,1992,6.0,0,0,0,0,0,0,0,,0,0,0,0,0,0,4,0
Matej Kovar,CZE,GK,Leverkusen,23,2000,12.0,0,0,0,0,0,0,1,0.0,1,0,0,0,0,0,3,1
Ladislav Krejčí,CZE,DF,Sparta Prague,24,1999,7.0,13,9,6,7,0,9,11,81.8,2,6,5,1,17,30,27,2
Vukašin Krstić,SRB,DF,TSC Bačka Top,20,2003,1.2,2,2,1,1,0,1,1,100.0,0,3,1,2,1,3,6,0
Dmytro Kryskiv,UKR,MF,Shakhtar,22,2000,0.1,0,0,0,0,0,0,0,,0,0,0,0,0,0,0,0
Lukas Kübler,GER,DF,Freiburg,30,1992,4.8,9,8,2,6,1,3,10,30.0,7,1,1,0,11,20,11,1
Jan Kuchta,CZE,"FW,MF",Sparta Prague,26,1997,8.4,2,1,0,2,0,2,11,18.2,9,6,0,6,2,4,5,1
Mohammed Kudus,GHA,"FW,MF",West Ham,22,2000,8.5,23,17,14,8,1,6,15,40.0,9,16,0,16,6,29,3,0
Dereck Kutesa,SUI,"FW,MF",Servette FC,25,1997,3.8,5,3,0,5,0,2,2,100.0,0,4,0,4,2,7,1,0
Berkan Kutlu,TUR,DF,Galatasaray,25,1998,2.0,3,2,3,0,0,2,5,40.0,3,1,0,1,1,4,6,0
Nikola Kuveljić,SRB,MF,TSC Bačka Top,26,1997,2.9,3,2,2,1,0,1,3,33.3,2,5,2,3,8,11,6,0
Qazim Laçi,ALB,MF,Sparta Prague,27,1996,7.5,17,11,7,8,2,6,23,26.1,17,18,8,10,10,27,15,0
Gael Lafont,FRA,MF,Marseille,17,2006,0.1,0,0,0,0,0,0,0,,0,0,0,0,0,0,1,0
Adam Lallana,ENG,MF,Brighton,35,1988,0.8,2,1,0,1,1,1,1,100.0,0,0,0,0,1,3,0,0
Mathis Lambourde,FRA,FW,Rennes,17,2006,0.1,2,2,0,2,0,2,3,66.7,1,0,0,0,0,2,0,0
Sam Lammers,NED,MF,Rangers,26,1997,4.7,7,5,1,3,3,3,10,30.0,7,7,1,6,4,11,2,0
Tariq Lamptey,GHA,DF,Brighton,22,2000,3.1,4,3,3,1,0,3,6,50.0,3,3,2,1,8,12,1,0
Loïc Lapoussin,MAD,"DF,MF",Union SG,27,1996,5.2,8,5,6,0,2,6,13,46.2,7,11,0,11,5,13,4,0
Sandro Lauper,SUI,MF,Young Boys,26,1996,1.9,6,4,2,4,0,4,5,80.0,1,0,0,0,1,7,2,0
Dimitri Lavalée,BEL,"MF,DF",Sturm Graz,26,1997,3.3,7,6,4,3,0,3,8,37.5,5,7,4,3,3,10,10,0
Tobias Lawal,AUT,GK,LASK,23,2000,6.0,0,0,0,0,0,0,0,,0,0,0,0,0,0,3,0
Tom Lawrence,WAL,MF,Rangers,29,1994,2.8,5,3,3,2,0,1,5,20.0,4,1,0,1,3,8,2,0
Amor Layouni,TUN,FW,Häcken,30,1992,4.7,8,6,1,3,4,3,5,60.0,2,3,0,3,4,12,0,0
Enzo Le Fée,FRA,MF,Rennes,23,2000,3.6,6,4,1,3,2,1,6,16.7,5,2,0,2,1,7,2,0
Rafael Leão,POR,FW,Milan,24,1999,5.2,3,3,2,0,1,3,6,50.0,3,1,0,1,2,5,1,0
Ben Lederman,POL,MF,RKS Raków,23,2000,1.0,1,0,0,1,0,0,0,,0,2,0,2,0,1,0,0
Marcos Leonardo,BRA,FW,Benfica,20,2003,1.1,0,0,0,0,0,0,0,,0,0,0,0,0,0,0,0
Fedde Leysen,BEL,DF,Union SG,20,2003,1.0,2,2,2,0,0,1,1,100.0,0,1,0,1,2,4,3,0
Samba Lélé Diba,SEN,MF,Servette FC,19,2003,0.9,3,2,1,1,1,2,3,66.7,1,2,1,1,2,5,3,1
Philipp Lienhart,AUT,DF,Freiburg,27,1996,4.6,0,0,0,0,0,0,2,0.0,2,3,3,0,3,3,14,0
Ondřej Lingr,CZE,FW,Feyenoord,24,1998,0.3,0,0,0,0,0,0,0,,0,0,0,0,0,0,0,0
Martin Linnes,NOR,DF,Molde,31,1991,0.2,0,0,0,0,0,0,1,0.0,1,0,0,0,0,0,0,0
Ivan Ljubic,AUT,MF,LASK,27,1996,5.0,14,3,8,5,1,9,18,50.0,9,7,0,7,5,19,9,0
Marin Ljubicic,CRO,FW,LASK,21,2002,4.1,2,1,1,0,1,1,3,33.3,2,4,1,3,1,3,4,0
Diego Llorente,ESP,DF,Roma,29,1993,7.3,11,7,8,3,0,9,10,90.0,1,8,3,5,12,23,32,0
Renan Lodi,BRA,"DF,MF",Marseille,25,1998,4.6,6,3,5,1,0,4,8,50.0,4,4,1,3,8,14,8,0
Yuri Lodygin,RUS,GK,Panathinaikos,33,1990,1.0,0,0,0,0,0,0,0,,0,0,0,0,0,0,1,1
Ruben Loftus-Cheek,ENG,MF,Milan,27,1996,4.2,3,2,2,1,0,2,2,100.0,0,1,1,0,2,5,0,0
Niklas Lomb,GER,GK,Leverkusen,30,1993,1.0,0,0,0,0,0,0,0,,0,0,0,0,0,0,0,0
Ademola Lookman,NGA,"MF,FW",Atalanta,25,1997,8.0,8,6,2,4,2,4,8,50.0,4,10,0,10,3,11,0,0
Rony Lopes,POR,"MF,DF",Braga,27,1995,0.6,1,1,0,1,0,1,1,100.0,0,0,0,0,0,1,1,0
Pau López,ESP,GK,Marseille,28,1994,13.3,0,0,0,0,0,0,1,0.0,1,1,0,1,0,0,3,0
Felix Luckeneder,AUT,DF,LASK,29,1994,1.9,7,6,5,2,0,5,6,83.3,1,4,1,3,4,11,6,0
Florentino Luís,POR,MF,Benfica,23,1999,4.3,13,9,6,6,1,8,14,57.1,6,11,2,9,10,23,3,0
José Luis Morales,ESP,FW,Villarreal,36,1987,2.7,2,1,0,0,2,1,1,100.0,0,1,0,1,0,2,1,0
José Luis Palomino,ARG,DF,Atalanta,33,1990,0.1,1,1,1,0,0,0,0,,0,0,0,0,2,3,1,0
Romelu Lukaku,BEL,FW,Roma,30,1993,12.0,4,2,0,3,1,2,4,50.0,2,4,3,1,2,6,9,0
Valgeir Lunddal Friðriksson,ISL,DF,Häcken,21,2001,1.0,2,1,2,0,0,2,2,100.0,0,0,0,0,2,4,0,0
John Lundstram,ENG,MF,Rangers,29,1994,8.0,14,7,6,7,1,10,26,38.5,16,16,4,12,6,20,10,0
Andrey Lunyov,RUS,GK,Qarabağ,31,1991,10.3,1,1,1,0,0,1,1,100.0,0,0,0,0,0,1,2,1
Fabian Lustenberger,SUI,DF,Young Boys,35,1988,1.0,2,0,2,0,0,2,3,66.7,1,0,0,0,4,6,2,0
Henrique Luvannor,MDA,"FW,MF",Sheriff Tiraspol,33,1990,2.6,2,1,2,0,0,1,5,20.0,4,2,1,1,1,3,2,0
Mathias Løvik,NOR,DF,Molde,19,2003,6.0,8,7,5,1,2,3,12,25.0,9,9,2,7,6,14,8,0
Alexis Mac Allister,ARG,MF,Liverpool,24,1998,4.5,8,4,3,4,1,6,12,50.0,6,13,1,12,8,16,5,1
Kevin Mac Allister,ARG,DF,Union SG,25,1997,5.9,18,12,12,4,2,11,14,78.6,3,8,3,5,9,27,13,0
Koki Machida,JPN,DF,Union SG,25,1997,5.0,10,8,7,2,1,10,13,76.9,3,4,0,4,2,12,11,0
Théo Magnin,SUI,DF,Servette FC,19,2003,1.6,3,1,1,1,1,1,1,100.0,0,1,0,1,2,5,1,0
Hörður Magnússon,ISL,DF,Panathinaikos,30,1993,1.0,0,0,0,0,0,0,0,,0,0,0,0,0,0,4,0
Frank Magri,CMR,"FW,MF",Toulouse,23,1999,2.2,8,4,2,3,3,4,5,80.0,1,4,1,3,1,9,2,0
Mike Maignan,FRA,GK,Milan,28,1995,5.2,0,0,0,0,0,0,0,,0,0,0,0,0,0,3,0
Jordy Makengo,FRA,DF,Freiburg,21,2001,3.5,6,5,5,1,0,2,3,66.7,1,6,0,6,5,11,6,0
Darian Males,SUI,MF,Young Boys,22,2001,1.1,1,1,0,1,0,0,1,0.0,1,1,0,1,1,2,1,0
Daniel Mancini,ARG,"FW,MF",Panathinaikos,26,1996,2.4,9,5,5,2,2,2,6,33.3,4,3,0,3,3,12,2,0
Gianluca Mancini,ITA,DF,Roma,27,1996,12.0,16,11,10,5,1,7,12,58.3,5,17,13,4,12,28,27,0
Steve Mandanda,FRA,GK,Rennes,38,1985,7.0,1,1,1,0,0,1,1,100.0,0,0,0,0,0,1,2,0
Aïssa Mandi,ALG,DF,Villarreal,31,1991,4.5,5,3,4,1,0,1,2,50.0,1,2,2,0,8,13,14,0
Aleš Mandous,CZE,GK,Slavia Prague,31,1992,6.0,1,1,1,0,0,1,1,100.0,0,0,0,0,0,1,2,0
Mattia Mannini,ITA,DF,Roma,17,2006,0.1,0,0,0,0,0,0,0,,0,1,0,1,0,0,0,0
Petros Mantalos,GRE,MF,AEK Athens,31,1991,3.8,12,8,6,4,2,3,7,42.9,4,4,1,3,1,13,1,0
Solly March,ENG,FW,Brighton,29,1994,1.8,6,3,1,1,4,2,4,50.0,2,2,0,2,0,6,1,0
João Mário,POR,"FW,MF",Benfica,30,1993,2.5,5,4,3,2,0,3,4,75.0,1,2,0,2,2,7,1,0
Ar'jany Martha,NED,"FW,DF",Ajax,19,2003,0.7,4,1,2,2,0,0,1,0.0,1,2,0,2,0,4,1,0
Lukáš Masopust,CZE,"DF,MF",Slavia Prague,30,1993,5.2,11,7,3,5,3,5,12,41.7,7,4,2,2,1,12,2,0
Giorgos Masouras,GRE,"MF,FW",Olympiacos,29,1994,2.7,5,3,1,3,1,3,4,75.0,1,4,0,4,4,9,0,0
Matheus,BRA,GK,Braga,31,1992,2.3,1,0,1,0,0,1,3,33.3,2,1,0,1,0,1,2,0
Nemanja Matić,SRB,MF,Rennes,34,1988,4.8,4,2,2,2,0,2,2,100.0,0,2,0,2,10,14,3,0
Joël Matip,CMR,DF,Liverpool,31,1991,2.1,0,0,0,0,0,0,0,,0,3,1,2,1,1,6,0
Rabbi Matondo,WAL,FW,Rangers,22,2000,1.6,1,0,0,1,0,1,5,20.0,4,0,0,0,4,5,0,0
Azor Matusiwa,NED,MF,Rennes,25,1998,1.2,2,1,0,2,0,2,3,66.7,1,2,1,1,2,4,2,0
Mykola Matviyenko,UKR,DF,Shakhtar,27,1996,2.0,0,0,0,0,0,0,0,,0,3,2,1,4,4,9,0
Konstantinos Mavropanos,GRE,DF,West Ham,25,1997,8.9,4,2,2,2,0,2,5,40.0,3,11,9,2,16,20,33,0
Christian Mawissa,FRA,DF,Toulouse,18,2005,1.2,3,1,2,0,1,3,4,75.0,1,3,1,2,2,5,5,0
Mihlali Mayambela,RSA,"FW,MF",Aris Limassol FC,26,1996,5.3,11,9,8,2,1,7,18,38.9,11,10,0,10,3,14,4,0
Bradley Mazikou,CGO,DF,Servette FC,27,1996,4.8,9,7,4,4,1,6,9,66.7,3,7,1,6,4,13,8,0
Noah Mbamba,BEL,FW,Leverkusen,18,2005,0.9,0,0,0,0,0,0,1,0.0,1,0,0,0,3,3,1,0
Chancel Mbemba,COD,DF,Marseille,28,1994,11.9,15,11,10,5,0,11,17,64.7,6,16,12,4,16,31,43,2
Ross McCausland,NIR,FW,Rangers,20,2003,1.7,3,3,0,2,1,1,2,50.0,1,1,0,1,0,3,1,0
James McConnell,ENG,"MF,FW",Liverpool,18,2004,0.7,2,2,0,1,1,0,2,0.0,2,0,0,0,1,3,0,0
Cole McKinnon,SCO,FW,Rangers,20,2003,0.2,0,0,0,0,0,0,0,,0,1,1,0,1,1,0,0
Jakov Medić,CRO,MF,Ajax,24,1998,0.0,0,0,0,0,0,0,0,,0,1,1,0,0,0,0,0
Facundo Medina,ARG,DF,Lens,24,1999,1.3,3,3,3,0,0,0,3,0.0,3,1,0,1,0,3,1,0
Kevin Medina,COL,DF,Qarabağ,30,1993,4.9,8,8,6,2,0,5,8,62.5,3,6,2,4,12,20,13,0
Maksim Medvedev,AZE,DF,Qarabağ,33,1989,1.3,0,0,0,0,0,0,1,0.0,1,3,2,1,1,1,2,0
Bamo Meïté,CIV,DF,Marseille,21,2001,3.4,5,2,4,1,0,3,4,75.0,1,7,2,5,4,9,16,0
Joe Mendes,SWE,DF,Braga,20,2002,0.2,0,0,0,0,0,0,0,,0,0,0,0,0,0,0,0
Leonardo Mendicino,ITA,MF,Atalanta,17,2006,0.0,0,0,0,0,0,0,0,,0,0,0,0,0,0,0,0
Quentin Merlin,FRA,DF,Marseille,21,2002,5.5,14,11,10,3,1,10,15,66.7,5,4,0,4,3,17,11,0
Dries Mertens,BEL,"MF,FW",Galatasaray,36,1987,1.7,3,2,1,2,0,0,1,0.0,1,1,0,1,0,3,0,0
Georges Mikautadze,GEO,"DF,MF",Ajax,22,2000,0.2,0,0,0,0,0,0,0,,0,0,0,0,0,0,0,0
Antoni Milambo,NED,MF,Feyenoord,18,2005,0.1,0,0,0,0,0,0,0,,0,0,0,0,0,0,0,0
James Milner,ENG,DF,Brighton,37,1986,2.0,4,2,1,1,2,2,3,66.7,1,2,0,2,0,4,8,0
Uroš Milovanović,SRB,FW,TSC Bačka Top,22,2000,2.4,2,2,0,2,0,0,1,0.0,1,1,0,1,0,2,6,0
Yankuba Minteh,GAM,FW,Feyenoord,19,2004,1.2,2,2,1,1,0,1,1,100.0,0,3,0,3,2,4,3,0
Aleksei Miranchuk,RUS,"FW,MF",Atalanta,27,1995,4.6,7,2,1,2,4,1,8,12.5,7,3,0,3,3,10,2,0
Juan Miranda,ESP,DF,Betis,23,2000,1.6,2,1,2,0,0,2,3,66.7,1,1,0,1,1,3,4,0
Martin Mirchevski,MKD,"MF,FW",TSC Bačka Top,26,1997,0.0,0,0,0,0,0,0,0,,0,0,0,0,0,0,0,0
Gerasimos Mitoglou,GRE,DF,AEK Athens,23,1999,1.0,2,2,1,1,0,2,3,66.7,1,4,0,4,1,3,5,0
Kaoru Mitoma,JPN,"FW,MF",Brighton,26,1997,5.7,3,2,1,1,1,1,5,20.0,4,4,0,4,4,7,6,0
Filip Mladenović,SRB,DF,Panathinaikos,31,1991,4.1,6,3,6,0,0,2,4,50.0,2,2,0,2,3,9,7,0
Ali Mohamed,NIG,MF,Maccabi Haifa,27,1995,2.4,6,5,3,2,1,1,3,33.3,2,6,0,6,6,12,2,1
Milad Mohammadi,IRN,DF,AEK Athens,29,1993,1.0,1,0,1,0,0,0,1,0.0,1,1,1,0,2,3,2,0
Joel Monteiro,SUI,FW,Young Boys,23,1999,1.3,3,2,0,2,1,2,3,66.7,1,7,1,6,2,5,0,0
Jaden Montnor,SUR,"FW,MF",Aris Limassol FC,20,2002,1.1,3,3,0,1,2,0,2,0.0,2,1,0,1,1,4,1,0
Morato,BRA,DF,Benfica,22,2001,0.5,1,0,1,0,0,1,3,33.3,2,0,0,0,0,1,2,0
Alberto Moreno,ESP,DF,Villarreal,31,1992,3.1,4,3,3,1,0,2,7,28.6,5,5,4,1,1,5,4,0
Gerard Moreno,ESP,"FW,MF",Villarreal,31,1992,3.5,5,3,1,3,1,2,4,50.0,2,1,0,1,2,7,3,0
Anthony Moris,LUX,GK,Union SG,33,1990,6.0,0,0,0,0,0,0,0,,0,0,0,0,0,0,9,1
Hidemasa Morita,JPN,MF,Sporting CP,28,1995,4.9,10,8,2,8,0,6,14,42.9,8,7,0,7,6,16,6,0
Yerson Mosquera,COL,DF,Villarreal,22,2001,1.4,1,1,0,0,1,1,4,25.0,3,1,0,1,0,1,5,0
Alex Moucketou,GAB,DF,Aris Limassol FC,22,2000,4.1,11,4,5,6,0,8,16,50.0,8,6,2,4,16,27,19,0
Harold Moukoudi,CMR,DF,AEK Athens,25,1997,4.9,7,3,3,2,2,4,5,80.0,1,5,2,3,13,20,9,0
João Moutinho,POR,MF,Braga,36,1986,1.7,7,2,1,5,1,6,15,40.0,9,2,0,2,2,9,4,0
Divin Mubama,ENG,FW,West Ham,18,2004,1.0,1,0,0,0,1,0,0,,0,2,0,2,0,1,0,0
François Mughe,CMR,FW,Marseille,19,2004,0.1,0,0,0,0,0,0,1,0.0,1,0,0,0,0,0,0,0
Luis Muriel,COL,FW,Atalanta,32,1991,3.0,2,1,1,0,1,1,1,100.0,0,1,0,1,0,2,2,0
Yunus Musah,USA,MF,Milan,20,2002,3.6,5,2,2,3,0,4,6,66.7,2,6,1,5,0,5,8,0
Mateusz Musialowski,POL,MF,Liverpool,19,2003,0.2,0,0,0,0,0,0,1,0.0,1,1,0,1,0,0,0,0
Fernando Muslera,URU,GK,Galatasaray,37,1986,2.0,0,0,0,0,0,0,0,,0,0,0,0,0,0,1,0
Florent Muslija,KVX,MF,Freiburg,25,1998,0.6,1,1,1,0,0,1,1,100.0,0,0,0,0,0,1,0,0
Juan Musso,ARG,GK,Atalanta,29,1994,12.0,0,0,0,0,0,0,0,,0,0,0,0,0,0,3,1
Bəhlul Mustafazadə,AZE,DF,Qarabağ,26,1997,8.3,4,2,1,2,1,2,3,66.7,1,11,9,2,12,16,44,0
Ibrahim Mustapha,GHA,FW,LASK,23,2000,1.5,3,2,3,0,0,0,0,,0,1,0,1,0,3,1,0
Joel Mvuka,NOR,FW,Young Boys,20,2002,0.9,1,0,1,0,0,0,4,0.0,4,0,0,0,0,1,0,0
Obite N'Dicka,CIV,DF,Roma,23,1999,8.4,7,3,5,2,0,3,7,42.9,4,10,4,6,4,11,32,0
Bilal Nadir,FRA,"MF,DF",Marseille,19,2003,0.0,0,0,0,0,0,0,0,,0,1,0,1,0,0,1,0
Mahamadou Nagida,CMR,DF,Rennes,18,2005,1.3,2,2,1,1,0,2,3,66.7,1,3,0,3,3,5,2,0
Goni Naor,ISR,"MF,DF",Maccabi Haifa,24,1999,0.8,0,0,0,0,0,0,0,,0,0,0,0,1,1,1,0
Yehor Nazaryna,UKR,MF,Shakhtar,26,1997,0.2,2,1,1,1,0,1,1,100.0,0,0,0,0,0,2,0,0
Michel Ndary Adopo,FRA,MF,Atalanta,23,2000,1.0,2,0,2,0,0,2,3,66.7,1,1,1,0,1,3,1,0
Iliman Ndiaye,SEN,"FW,MF",Marseille,23,2000,7.9,6,6,3,2,1,2,8,25.0,6,3,0,3,1,7,5,0
Tanguy Ndombele,FRA,MF,Galatasaray,26,1996,0.0,0,0,0,0,0,0,0,,0,0,0,0,0,0,0,0
Cher Ndour,ITA,MF,Braga,19,2004,0.9,2,1,1,0,1,0,1,0.0,1,1,0,1,0,2,1,0
Rafael Nel,POR,FW,Sporting CP,18,2005,0.1,0,0,0,0,0,0,0,,0,0,0,0,0,0,0,0
Victor Nelsson,DEN,DF,Galatasaray,24,1998,0.7,1,1,0,1,0,1,2,50.0,1,1,0,1,0,1,2,0
David Neres,BRA,FW,Benfica,26,1997,4.2,4,3,3,1,0,1,3,33.3,2,8,2,6,1,5,4,0
Luís Neto,POR,DF,Sporting CP,35,1988,1.1,2,2,0,2,0,2,3,66.7,1,1,0,1,2,4,6,0
João Neves,POR,MF,Benfica,18,2004,6.3,22,15,13,8,1,13,20,65.0,7,5,0,5,10,32,12,0
Newerton,BRA,MF,Shakhtar,18,2005,0.1,0,0,0,0,0,0,0,,0,0,0,0,0,0,0,0
Jerome Ngom Mbekeli,CMR,"FW,MF",Sheriff Tiraspol,24,1998,5.4,7,4,2,3,2,2,7,28.6,5,8,0,8,4,11,4,0
Sikou Niakaté,MLI,DF,Braga,24,1999,2.3,4,1,3,1,0,2,2,100.0,0,2,1,1,4,8,9,0
Cheikh Niasse,SEN,MF,Young Boys,23,2000,1.5,3,2,1,2,0,1,2,50.0,1,0,0,0,3,6,1,0
Rasmus Nicolaisen,DEN,DF,Toulouse,26,1997,8.0,9,5,9,0,0,4,9,44.4,5,12,10,2,12,21,52,0
Bart Nieuwkoop,NED,"DF,FW",Feyenoord,27,1996,1.6,2,1,1,0,1,2,6,33.3,4,1,0,1,2,4,6,0
Gustaf Nilsson,SWE,FW,Union SG,26,1997,2.5,2,2,0,2,0,0,3,0.0,3,2,0,2,2,4,5,0
Itamar Nitzan,ISR,GK,Maccabi Haifa,36,1987,1.0,0,0,0,0,0,0,0,,0,0,0,0,0,0,1,0
Kristian Nökkvi Hlynsson,ISL,"MF,FW",Ajax,19,2004,2.6,6,3,1,3,2,0,2,0.0,2,1,0,1,0,6,4,0
Bartosz Nowak,POL,"MF,FW",RKS Raków,29,1993,2.2,0,0,0,0,0,0,2,0.0,2,2,1,1,1,1,0,0
Andreas Ntoi,GRE,DF,Olympiacos,20,2003,2.8,2,1,1,1,0,1,2,50.0,1,3,3,0,2,4,7,0
Darwin Núñez,URU,FW,Liverpool,24,1999,5.1,7,5,1,2,4,2,5,40.0,3,0,0,0,1,8,1,0
Gustav Nyheim,NOR,MF,Molde,17,2006,0.2,0,0,0,0,0,0,1,0.0,1,0,0,0,0,0,0,0
Angelo Ogbonna,ITA,DF,West Ham,35,1988,2.5,2,1,0,2,0,0,1,0.0,1,4,2,2,2,4,2,1
Boluwatife Ogungbayi,NGA,MF,Slavia Prague,19,2004,0.3,0,0,0,0,0,0,0,,0,0,0,0,0,0,0,0
Noah Okafor,SUI,"FW,MF",Milan,23,2000,1.2,1,0,0,0,1,1,2,50.0,1,0,0,0,0,1,1,0
Victor Olatunji,NGA,FW,Sparta Prague,23,1999,3.0,1,0,0,1,0,1,4,25.0,3,4,0,4,0,1,7,0
Paulo Oliveira,POR,DF,Braga,31,1992,2.0,1,1,1,0,0,1,1,100.0,0,5,4,1,2,3,6,0
Sérgio Oliveira,POR,MF,Galatasaray,31,1992,0.3,1,0,1,0,0,0,0,,0,0,0,0,0,1,0,0
Warmed Omari,COM,DF,Rennes,23,2000,6.0,6,2,3,3,0,3,7,42.9,4,7,6,1,4,10,16,0
Gaël Ondoua,CMR,MF,Servette FC,27,1995,5.1,10,8,3,5,2,4,7,57.1,3,6,2,4,5,15,2,0
Francisco Ortega,ARG,DF,Olympiacos,24,1999,4.8,8,6,5,3,0,5,8,62.5,3,6,0,6,7,15,6,1
Nicolás Otamendi,ARG,DF,Benfica,35,1988,6.3,16,7,11,5,0,7,15,46.7,8,7,3,4,9,25,35,0
Azzedine Ounahi,MAR,MF,Marseille,23,2000,7.0,7,3,2,5,0,5,8,62.5,3,9,1,8,5,12,1,0
Aiham Ousou,SYR,DF,Häcken,23,2000,4.8,8,5,6,2,0,5,6,83.3,1,9,5,4,2,10,14,0
Riccardo Pagano,ITA,"MF,FW",Roma,18,2004,0.8,4,2,2,1,1,3,3,100.0,0,0,0,0,1,5,2,0
Vinícius Paiva,BRA,MF,Sheriff Tiraspol,22,2001,0.2,0,0,0,0,0,0,0,,0,1,0,1,0,0,0,0
Igor Paixão,BRA,FW,Feyenoord,23,2000,1.5,0,0,0,0,0,0,0,,0,0,0,0,0,0,3,0
Exequiel Palacios,ARG,MF,Leverkusen,24,1998,6.4,26,17,12,8,6,9,18,50.0,9,4,0,4,7,33,12,0
Sebastián Palacios,ARG,"FW,MF",Panathinaikos,31,1992,4.3,9,5,3,4,2,3,4,75.0,1,2,0,2,4,13,3,0
Marco Palestra,ITA,MF,Atalanta,18,2005,0.1,0,0,0,0,0,0,0,,0,0,0,0,0,0,0,0
Emerson Palmieri,ITA,DF,West Ham,28,1994,5.6,15,13,6,9,0,11,12,91.7,1,6,1,5,1,16,14,0
Filip Panák,CZE,DF,Sparta Prague,27,1995,4.5,3,2,2,1,0,1,2,50.0,1,3,2,1,9,12,22,0
Miloš Pantović,SRB,"FW,MF",TSC Bačka Top,20,2002,0.8,1,1,1,0,0,0,0,,0,0,0,0,0,1,1,0
Giannis Papanikolaou,GRE,MF,RKS Raków,24,1998,1.9,2,2,1,1,0,0,1,0.0,1,2,1,1,1,3,9,0
Lucas Paquetá,BRA,"MF,FW",West Ham,25,1997,7.8,21,13,7,9,5,8,12,66.7,4,5,1,4,3,24,4,1
Leandro Paredes,ARG,MF,Roma,29,1994,11.4,16,11,7,8,1,9,25,36.0,16,16,4,12,20,36,31,0
Daniel Parejo,ESP,MF,Villarreal,34,1989,5.1,8,4,1,6,1,4,10,40.0,6,5,1,4,3,11,4,0
Mario Pašalić,CRO,MF,Atalanta,28,1995,4.9,7,3,4,2,1,4,13,30.8,9,8,1,7,4,11,8,0
Alexandros Paschalakis,GRE,GK,Olympiacos,34,1989,6.0,0,0,0,0,0,0,0,,0,0,0,0,0,0,1,0
Pascu,ESP,MF,Villarreal,20,2003,0.6,0,0,0,0,0,0,0,,0,1,0,1,0,0,0,0
John Paul Dembe,UGA,FW,Häcken,18,2005,0.3,0,0,0,0,0,0,0,,0,0,0,0,0,0,0,0
Paulinho,POR,"FW,MF",Sporting CP,30,1992,4.8,2,0,0,2,0,0,2,0.0,2,7,0,7,1,3,8,0
João Paulo Fernandes,CPV,"MF,FW",Sheriff Tiraspol,25,1998,4.4,3,2,1,2,0,1,2,50.0,1,5,0,5,4,7,4,0
David Pavelka,CZE,MF,Sparta Prague,32,1991,0.2,1,0,0,1,0,0,0,,0,1,0,1,0,1,2,0
Alfonso Pedraza,ESP,"DF,MF",Villarreal,27,1996,1.9,4,3,3,1,0,2,3,66.7,1,1,0,1,2,6,4,0
Pedrinho,BRA,FW,Shakhtar,21,2002,0.1,1,1,0,1,0,1,1,100.0,0,0,0,0,0,1,2,0
Lorenzo Pellegrini,ITA,MF,Roma,27,1996,8.1,11,8,7,4,0,7,21,33.3,14,15,2,13,4,15,12,0
Faris Pemi Moumbagna,CMR,"FW,MF",Marseille,23,2000,3.5,3,1,0,1,2,0,1,0.0,1,2,0,2,1,4,1,0
Ayoze Pérez,ESP,"FW,MF",Betis,30,1993,3.2,5,3,3,1,1,0,4,0.0,4,8,1,7,1,6,0,0
Rubén Pérez,ESP,MF,Panathinaikos,34,1989,2.7,6,2,0,3,3,4,6,66.7,2,4,1,3,3,9,2,0
Noah Persson,SWE,DF,Young Boys,20,2003,0.3,0,0,0,0,0,0,0,,0,1,0,1,0,0,0,0
Jakub Pesek,CZE,"MF,FW",Sparta Prague,30,1993,0.8,1,1,1,0,0,1,1,100.0,0,0,0,0,1,2,2,0
Oliver Petersen,NOR,GK,Molde,21,2001,4.6,0,0,0,0,0,0,0,,0,0,0,0,0,0,5,0
Nemanja Petrović,SRB,DF,TSC Bačka Top,31,1992,5.4,5,3,3,1,1,3,7,42.9,4,6,1,5,2,7,20,0
Germán Pezzella,ARG,DF,Betis,32,1991,5.9,8,5,6,1,1,4,5,80.0,1,9,5,4,8,16,20,0
Maximilian Philipp,GER,"FW,MF",Freiburg,29,1994,1.1,0,0,0,0,0,0,1,0.0,1,2,0,2,3,3,0,0
Kalvin Phillips,ENG,MF,West Ham,27,1995,0.2,1,0,0,1,0,1,1,100.0,0,0,0,0,0,1,0,0
Fabian Piasecki,POL,FW,RKS Raków,28,1995,1.6,0,0,0,0,0,0,0,,0,0,0,0,0,0,4,0
Frantzdy Pierrot,HAI,FW,Maccabi Haifa,28,1995,3.9,3,3,1,2,0,0,3,0.0,3,4,1,3,0,3,10,0
Samuel Pikolon,CZE,MF,Slavia Prague,17,2006,0.1,0,0,0,0,0,0,0,,0,0,0,0,0,0,0,0
Orbelín Pineda,MEX,"MF,DF",AEK Athens,27,1996,4.2,12,7,5,5,2,6,9,66.7,3,6,0,6,3,15,5,0
Yeremi Pino,ESP,FW,Villarreal,20,2002,1.6,2,1,1,1,0,1,2,50.0,1,4,0,4,2,4,1,0
Niccolò Pisilli,ITA,FW,Roma,18,2004,0.2,1,0,0,0,1,0,0,,0,0,0,0,1,2,0,0
Rodolfo Pizarro,MEX,"FW,MF",AEK Athens,29,1994,0.4,2,1,2,0,0,0,0,,0,2,0,2,0,2,0,0
Pizzi,POR,MF,Braga,33,1989,0.8,2,2,2,0,0,1,1,100.0,0,0,0,0,0,2,0,0
Srđan Plavšić,SRB,"MF,DF",RKS Raków,27,1995,4.9,8,7,3,5,0,4,12,33.3,8,6,1,5,6,14,5,1
Daniel Podence,POR,"FW,MF",Olympiacos,27,1995,4.5,5,2,1,2,2,2,7,28.6,5,1,0,1,1,6,2,0
Suf Podgoreanu,ISR,"DF,MF",Maccabi Haifa,21,2002,1.1,2,1,2,0,0,2,4,50.0,2,1,1,0,0,2,9,0
Ezequiel Ponce,ARG,FW,AEK Athens,26,1997,2.0,1,0,0,0,1,1,3,33.3,2,0,0,0,1,2,1,0
Jackson Porozo,ECU,DF,Olympiacos,22,2000,2.2,2,2,1,1,0,0,0,,0,1,1,0,2,4,14,0
Alexander Prass,AUT,"MF,FW",Sturm Graz,22,2001,5.7,12,11,5,6,1,6,25,24.0,19,12,0,12,5,17,2,0
Ángelo Preciado,ECU,"DF,MF",Sparta Prague,25,1998,7.8,23,13,9,13,1,7,12,58.3,5,13,2,11,5,28,7,1
Lukáš Provod,CZE,"MF,FW",Slavia Prague,26,1996,4.6,4,2,1,2,1,1,5,20.0,4,1,0,1,1,5,3,0
Gustavo Puerta,COL,MF,Leverkusen,20,2003,2.1,3,2,0,2,1,0,2,0.0,2,3,0,3,2,5,2,0
Cameron Puertas,SUI,"MF,FW",Union SG,24,1998,5.7,11,7,7,3,1,3,14,21.4,11,6,0,6,2,13,2,0
Christian Pulisic,USA,FW,Milan,24,1998,4.9,9,4,2,5,2,3,6,50.0,3,6,0,6,0,9,4,0
Jarell Quansah,ENG,DF,Liverpool,20,2003,6.0,12,9,8,4,0,9,12,75.0,3,6,2,4,6,18,17,0
Eduardo Quaresma,POR,DF,Sporting CP,21,2002,3.1,10,6,6,4,0,4,7,57.1,3,4,3,1,9,19,9,1
Quini,ESP,DF,Olympiacos,33,1989,1.4,0,0,0,0,0,0,2,0.0,2,7,0,7,4,4,2,0
Bogdan Racovitan,ROU,DF,RKS Raków,23,2000,4.1,7,5,7,0,0,6,9,66.7,3,7,2,5,7,14,11,0
Milan Radin,SRB,MF,TSC Bačka Top,32,1991,4.7,9,9,3,6,0,2,5,40.0,3,4,1,3,3,12,3,0
Yaroslav Rakitskiy,UKR,DF,Shakhtar,33,1989,1.0,0,0,0,0,0,0,0,,0,3,1,2,5,5,6,0
Marko Rakonjac,MNE,FW,TSC Bačka Top,23,2000,2.5,0,0,0,0,0,0,1,0.0,1,0,0,0,2,2,2,0
Diant Ramaj,GER,GK,Ajax,21,2001,4.0,0,0,0,0,0,0,0,,0,0,0,0,0,0,1,2
Nicolas Raskin,BEL,MF,Rangers,22,2001,1.9,8,3,5,3,0,3,8,37.5,5,4,0,4,2,10,1,0
Mathias Rasmussen,NOR,MF,Union SG,25,1997,1.4,4,2,1,2,1,2,5,40.0,3,3,0,3,0,4,2,0
Givairo Read,NED,DF,Feyenoord,17,2006,0.1,0,0,0,0,0,0,0,,0,0,0,0,0,0,0,0
Lior Refaelov,ISR,"FW,MF",Maccabi Haifa,37,1986,2.6,2,1,2,0,0,1,4,25.0,3,1,0,1,0,2,1,0
Tijjani Reijnders,NED,MF,Milan,25,1998,4.6,3,2,3,0,0,1,2,50.0,1,5,3,2,5,8,2,0
Pepe Reina,ESP,GK,Villarreal,40,1982,7.0,0,0,0,0,0,0,0,,0,0,0,0,0,0,0,0
Matheus Reis,BRA,"DF,MF",Sporting CP,28,1995,8.2,8,7,3,5,0,5,11,45.5,6,6,0,6,3,11,30,0
René Renner,AUT,"MF,DF",LASK,29,1993,1.5,7,5,4,2,1,3,8,37.5,5,3,1,2,1,8,5,0
Devyne Rensch,NED,"DF,MF",Ajax,20,2003,3.7,9,6,4,5,0,5,8,62.5,3,3,2,1,7,16,9,0
Guillaume Restes,FRA,GK,Toulouse,18,2005,8.0,0,0,0,0,0,0,1,0.0,1,0,0,0,0,0,4,0
Panagiotis Retsos,GRE,DF,Olympiacos,24,1998,6.0,10,6,4,6,0,7,11,63.6,4,12,4,8,6,16,22,0
Ricardinho,BRA,"MF,FW",Sheriff Tiraspol,33,1989,4.3,7,3,2,4,1,1,2,50.0,1,4,1,3,4,11,6,0
Omar Richards,ENG,MF,Olympiacos,25,1998,0.1,0,0,0,0,0,0,0,,0,0,0,0,0,0,0,0
Fabian Rieder,SUI,"MF,FW",Rennes,21,2002,1.7,5,3,2,1,2,1,4,25.0,3,3,0,3,1,6,1,0
Dmytro Riznyk,UKR,GK,Shakhtar,24,1999,2.0,0,0,0,0,0,0,0,,0,0,0,0,0,0,2,0
Andrew Robertson,SCO,DF,Liverpool,29,1994,3.4,5,3,4,1,0,3,5,60.0,2,2,0,2,0,5,6,0
Marc Roca,ESP,"DF,MF",Betis,26,1996,6.0,11,8,6,4,1,8,14,57.1,6,4,3,1,8,19,11,0
Jean Carlos Silva Rocha,BRA,"MF,DF",RKS Raków,27,1996,3.9,9,7,6,2,1,5,12,41.7,7,3,2,1,2,11,6,0
Ronny Rodelin,FRA,DF,Servette FC,33,1989,0.1,0,0,0,0,0,0,0,,0,0,0,0,0,0,0,0
Rodinei,BRA,DF,Olympiacos,31,1992,5.7,14,8,6,7,1,7,8,87.5,1,8,2,6,5,19,17,0
Rodri,ESP,"MF,FW",Betis,23,2000,0.9,2,1,0,0,2,0,1,0.0,1,1,0,1,0,2,0,0
Guido Rodríguez,ARG,MF,Betis,29,1994,4.4,9,5,5,4,0,4,17,23.5,13,9,2,7,8,17,7,0
Kevin Rodríguez,ECU,FW,Union SG,23,2000,2.7,3,1,0,2,1,0,0,,0,4,0,4,1,4,5,0
Merlin Röhl,GER,"MF,FW",Freiburg,21,2002,3.7,13,7,6,6,1,8,11,72.7,3,8,1,7,4,17,2,0
Julio Romão,BRA,MF,Qarabağ,25,1998,8.1,38,24,17,17,4,12,24,50.0,12,11,3,8,9,47,9,1
Valentin Rongier,FRA,MF,Marseille,28,1994,3.0,3,1,0,3,0,0,4,0.0,4,7,0,7,3,6,3,0
Kemar Roofe,JAM,"FW,MF",Rangers,30,1993,1.8,2,1,1,0,1,0,1,0.0,1,1,0,1,0,2,2,0
Marten de Roon,NED,"MF,DF",Atalanta,32,1991,10.7,21,9,9,9,3,12,29,41.4,17,16,3,13,11,32,13,0
Francesco Rossi,ITA,GK,Atalanta,32,1991,0.1,0,0,0,0,0,0,0,,0,0,0,0,0,0,0,0
Llazaros Rota,GRE,DF,AEK Athens,25,1997,2.3,0,0,0,0,0,0,2,0.0,2,2,1,1,1,1,6,0
Steve Rouiller,SUI,DF,Servette FC,33,1990,3.0,8,4,3,4,1,5,6,83.3,1,4,0,4,2,10,11,0
Matteo Ruggeri,ITA,"DF,MF",Atalanta,21,2002,9.7,17,11,7,10,0,12,19,63.2,7,19,1,18,12,29,19,0
Aitor Ruibal,ESP,DF,Betis,27,1996,4.1,7,3,5,1,1,6,9,66.7,3,3,0,3,4,11,4,0
Abel Ruiz,ESP,"FW,MF",Braga,23,2000,2.3,1,0,0,0,1,0,0,,0,2,0,2,0,1,0,0
Milan Rundić,SRB,DF,RKS Raków,31,1992,5.0,5,2,4,1,0,4,5,80.0,1,4,3,1,2,7,9,0
Mikkel Rygaard Jensen,DEN,MF,Häcken,32,1990,5.3,8,6,4,3,1,7,11,63.6,4,5,1,4,6,14,1,0
Matěj Ryneš,CZE,"MF,DF",Sparta Prague,22,2001,3.9,5,4,2,3,0,1,4,25.0,3,6,1,5,3,8,4,0
Serdar Saatçı,TUR,DF,Braga,20,2003,0.3,0,0,0,0,0,0,0,,0,1,1,0,0,0,0,0
Dia Saba,ISR,MF,Maccabi Haifa,30,1992,1.2,2,2,2,0,0,0,1,0.0,1,0,0,0,0,2,0,0
Noah Sadiki,COD,MF,Union SG,18,2004,2.9,8,4,2,4,2,5,10,50.0,5,9,0,9,3,11,3,1
Lukáš Sadílek,CZE,MF,Sparta Prague,27,1996,2.4,3,0,2,1,0,1,1,100.0,0,2,1,1,2,5,2,1
Wesley Saïd,FRA,"FW,MF",Lens,28,1995,0.4,0,0,0,0,0,0,0,,0,0,0,0,0,0,0,0
Ibrahim Salah,MAR,FW,Rennes,21,2001,2.4,5,2,1,3,1,1,2,50.0,1,2,0,2,1,6,0,0
Mohamed Salah,EGY,FW,Liverpool,31,1992,4.4,0,0,0,0,0,0,2,0.0,2,2,0,2,0,0,0,0
Anass Salah-Eddine,NED,FW,Ajax,21,2002,0.0,0,0,0,0,0,0,0,,0,0,0,0,0,0,0,0
Roland Sallai,HUN,"FW,MF",Freiburg,26,1997,6.8,5,5,1,2,2,1,2,50.0,1,2,0,2,3,8,2,0
Brice Samba,FRA,GK,Lens,29,1994,2.3,0,0,0,0,0,0,1,0.0,1,0,0,0,0,0,0,0
Renato Sanches,POR,"MF,DF",Roma,25,1997,1.3,1,0,0,1,0,0,1,0.0,1,3,1,2,1,2,0,0
Davinson Sánchez,COL,DF,Galatasaray,27,1996,2.0,2,2,1,1,0,1,1,100.0,0,1,1,0,4,6,7,0
Simon Sandberg,SWE,DF,Häcken,29,1994,3.9,7,4,2,5,0,5,6,83.3,1,7,2,5,2,9,12,0
Baptiste Santamaria,FRA,MF,Rennes,28,1995,4.0,5,3,3,2,0,4,10,40.0,6,3,1,2,4,9,8,0
Nuno Santos,POR,"MF,DF",Sporting CP,28,1995,4.6,5,3,2,2,1,1,5,20.0,4,1,0,1,2,7,4,0
Manprit Sarkaria,AUT,"FW,MF",Sturm Graz,26,1996,4.7,1,0,0,1,0,1,3,33.3,2,3,0,3,1,2,1,0
Ismaila Sarr,SEN,"FW,MF",Marseille,25,1998,4.9,5,3,3,2,0,1,2,50.0,1,8,2,6,1,6,0,0
Giorgio Scalvini,ITA,DF,Atalanta,19,2003,5.3,21,14,14,7,0,17,20,85.0,3,3,3,0,10,31,17,0
Gianluca Scamacca,ITA,FW,Atalanta,24,1999,7.7,6,5,1,3,2,1,7,14.3,6,7,1,6,1,7,7,0
Calum Scanlon,ENG,DF,Liverpool,18,2005,0.6,1,1,1,0,0,1,1,100.0,0,1,0,1,1,2,1,1
Gustavo Scarpa,BRA,MF,Olympiacos,29,1994,0.2,0,0,0,0,0,0,0,,0,0,0,0,0,0,0,0
Bart Schenkeveld,NED,DF,Panathinaikos,31,1991,6.0,4,1,2,2,0,2,5,40.0,3,9,7,2,5,9,9,0
Kjell Scherpen,NED,GK,Sturm Graz,23,2000,6.0,0,0,0,0,0,0,0,,0,0,0,0,0,0,2,0
Patrik Schick,CZE,"FW,MF",Leverkusen,27,1996,3.4,4,2,1,2,1,2,4,50.0,2,3,0,3,0,4,2,0
Kenneth Schmidt,GER,DF,Freiburg,21,2002,0.6,1,1,0,1,0,1,1,100.0,0,0,0,0,0,1,4,1
Niklas Schmidt,GER,"MF,FW",Toulouse,25,1998,4.6,11,5,4,5,2,7,10,70.0,3,3,1,2,3,14,3,0
David Schnegg,AUT,DF,Sturm Graz,24,1998,2.9,5,3,3,0,2,3,7,42.9,4,10,2,8,7,12,12,0
Ivan Schranz,SVK,"FW,MF",Slavia Prague,29,1993,2.9,1,1,0,1,0,0,6,0.0,6,2,0,2,0,1,2,0
Abdoulaye Seck,SEN,DF,Maccabi Haifa,31,1992,5.0,5,4,4,1,0,2,5,40.0,3,6,5,1,2,7,26,2
Alidu Seidu,GHA,DF,Rennes,23,2000,0.6,3,2,2,0,1,2,2,100.0,0,0,0,0,2,5,0,0
Václav Sejk,CZE,"MF,FW",Sparta Prague,21,2002,0.4,0,0,0,0,0,0,0,,0,0,0,0,0,0,0,0
Javier Serrano,ESP,MF,Sturm Graz,20,2003,0.5,0,0,0,0,0,0,2,0.0,2,1,0,1,1,1,4,0
Petr Ševčík,CZE,MF,Slavia Prague,29,1994,0.7,0,0,0,0,0,0,0,,0,0,0,0,0,0,0,0
Yoan Severin,FRA,DF,Servette FC,26,1997,6.0,4,2,4,0,0,4,9,44.4,5,6,4,2,11,15,14,1
Stephan El Shaarawy,ITA,"FW,DF",Roma,30,1992,10.5,14,8,9,4,1,8,12,66.7,4,13,4,9,10,24,13,0
Hamza Shibli,ISR,FW,Maccabi Haifa,18,2004,0.1,0,0,0,0,0,0,1,0.0,1,0,0,0,1,1,0,0
Show,ANG,MF,Maccabi Haifa,24,1999,4.6,15,8,11,3,1,11,19,57.9,8,11,3,8,4,19,10,0
Erik Shuranov,GER,"FW,MF",Maccabi Haifa,21,2002,0.6,1,0,0,1,0,0,1,0.0,1,2,0,2,1,2,0,0
Maryan Shved,UKR,MF,Shakhtar,26,1997,0.1,0,0,0,0,0,0,1,0.0,1,0,0,0,0,0,0,0
Djibril Sidibé,FRA,DF,AEK Athens,31,1992,3.2,12,8,9,3,0,5,9,55.6,4,3,1,2,5,17,5,0
Vincent Sierro,SUI,MF,Toulouse,27,1995,8.0,24,8,8,13,3,17,33,51.5,16,17,6,11,14,38,11,0
Danylo Sikan,UKR,FW,Shakhtar,22,2001,1.7,1,0,1,0,0,1,1,100.0,0,2,0,2,0,1,3,0
Kiliann Sildillia,FRA,"DF,MF",Freiburg,21,2002,6.7,13,9,4,5,4,6,8,75.0,2,8,0,8,4,17,12,0
António Silva,POR,DF,Benfica,19,2003,6.3,11,5,8,3,0,7,11,63.6,4,10,7,3,4,15,35,1
Fábio Silva,POR,FW,Rangers,21,2002,2.0,5,2,0,3,2,2,4,50.0,2,3,0,3,1,6,1,0
Matheus Silva,BRA,"DF,FW",Qarabağ,25,1997,4.6,7,4,4,2,1,3,7,42.9,4,4,2,2,5,12,5,0
Rafa Silva,POR,MF,Benfica,30,1993,6.1,4,2,3,1,0,3,7,42.9,4,3,0,3,1,5,0,0
Rui Silva,POR,GK,Betis,29,1994,4.0,1,0,1,0,0,1,1,100.0,0,0,0,0,0,1,0,1
Abdallah Sima,SEN,FW,Rangers,22,2001,5.8,14,9,7,3,4,8,13,61.5,5,6,0,6,4,18,14,0
Lorenco Šimić,CRO,DF,Maccabi Haifa,27,1996,3.9,2,0,1,1,0,1,1,100.0,0,9,5,4,8,10,21,0
Nikola Simić,SRB,GK,TSC Bačka Top,26,1996,1.0,0,0,0,0,0,0,0,,0,0,0,0,0,0,0,0
Naatan Skyttä,FIN,MF,Toulouse,21,2002,0.2,0,0,0,0,0,0,1,0.0,1,1,0,1,0,0,1,0
Chris Smalling,ENG,DF,Roma,33,1989,3.1,3,2,3,0,0,0,1,0.0,1,6,5,1,1,4,11,0
Emran Soglo,ENG,DF,Marseille,18,2005,1.0,5,4,2,3,0,4,5,80.0,1,4,0,4,0,5,1,0
Markus Solbakken,NOR,MF,Sparta Prague,23,2000,2.0,6,2,1,3,2,5,7,71.4,2,3,2,1,1,7,1,0
Ola Solbakken,NOR,"FW,MF",Olympiacos,24,1998,0.5,0,0,0,0,0,0,0,,0,2,1,1,0,0,0,0
Momodou Sonko,SWE,FW,Häcken,18,2005,4.0,5,4,4,0,1,2,5,40.0,3,1,0,1,2,7,2,0
Deian Sorescu,ROU,"MF,DF",RKS Raków,25,1997,2.1,4,3,2,2,0,3,4,75.0,1,4,1,3,3,7,8,0
Bence Sós,HUN,"DF,FW",TSC Bačka Top,29,1994,0.6,1,1,1,0,0,1,2,50.0,1,1,0,1,1,2,2,0
Borna Sosa,CRO,DF,Ajax,25,1998,4.2,9,5,7,2,0,5,8,62.5,3,4,1,3,6,15,11,0
Florian Sotoca,FRA,"FW,MF",Lens,32,1990,2.3,6,6,1,4,1,3,4,75.0,1,2,0,2,0,6,3,0
Tomáš Souček,CZE,MF,West Ham,28,1995,7.5,7,4,4,2,1,5,10,50.0,5,7,5,2,14,21,15,0
John Souttar,SCO,DF,Rangers,26,1996,4.0,3,2,2,1,0,1,2,50.0,1,7,3,4,8,11,25,0
Stijn Spierings,NED,MF,Toulouse,27,1996,1.8,9,4,3,4,2,4,6,66.7,2,3,2,1,1,10,5,0
Leonardo Spinazzola,ITA,DF,Roma,30,1993,7.8,12,6,9,3,0,6,12,50.0,6,11,8,3,1,13,10,0
Matija Špoljarić,CYP,"DF,MF",Aris Limassol FC,26,1997,0.3,0,0,0,0,0,0,0,,0,0,0,0,0,0,1,0
Andraž Šporar,SVN,"FW,DF",Panathinaikos,29,1994,1.5,0,0,0,0,0,0,1,0.0,1,0,0,0,0,0,0,0
Marco Sportiello,ITA,GK,Milan,31,1992,0.8,0,0,0,0,0,0,0,,0,0,0,0,0,0,0,0
Jerry St. Juste,NED,DF,Sporting CP,26,1996,3.0,12,7,8,4,0,8,8,100.0,0,6,1,5,4,16,8,1
Jindřich Staněk,CZE,GK,Slavia Prague,27,1996,2.0,0,0,0,0,0,0,0,,0,0,0,0,0,0,0,0
Petar Stanic,SRB,MF,TSC Bačka Top,21,2001,2.2,4,3,2,2,0,2,9,22.2,7,4,0,4,2,6,2,0
Josip Stanišić,CRO,DF,Leverkusen,23,2000,8.7,15,11,10,5,0,7,18,38.9,11,8,2,6,6,21,16,0
Cican Stankovic,AUT,GK,AEK Athens,30,1992,3.6,0,0,0,0,0,0,0,,0,0,0,0,0,0,4,0
Jason Steele,ENG,GK,Brighton,32,1990,5.0,0,0,0,0,0,0,1,0.0,1,0,0,0,0,0,2,1
Calvin Stengs,NED,MF,Feyenoord,24,1998,1.4,0,0,0,0,0,0,0,,0,2,2,0,0,0,0,0
Taras Stepanenko,UKR,MF,Shakhtar,33,1989,1.7,6,4,2,4,0,3,7,42.9,4,2,1,1,1,7,4,1
Mariusz Stępiński,POL,"FW,MF",Aris Limassol FC,28,1995,0.7,1,1,0,0,1,1,2,50.0,1,3,0,3,0,1,1,0
Dujon Sterling,ENG,"FW,MF",Rangers,23,1999,1.4,6,2,3,3,0,3,3,100.0,0,5,2,3,2,8,3,0
Miroslav Stevanović,BIH,"MF,FW",Servette FC,33,1990,5.6,6,4,1,2,3,3,9,33.3,6,7,1,6,3,9,4,0
Nemanja Stojić,SRB,DF,TSC Bačka Top,25,1998,6.0,4,3,3,1,0,2,3,66.7,1,10,9,1,6,10,39,0
Filip Stojković,MNE,"MF,DF",LASK,30,1993,3.0,5,4,3,2,0,3,10,30.0,7,6,1,5,2,7,3,0
Karol Struski,POL,MF,Aris Limassol FC,22,2001,5.2,12,8,11,1,0,9,21,42.9,12,8,0,8,8,20,4,0
Denis Suárez,ESP,FW,Villarreal,29,1994,0.3,0,0,0,0,0,0,0,,0,1,0,1,0,0,0,0
Gabriel Suazo,CHI,"DF,MF",Toulouse,25,1997,6.4,13,8,5,7,1,5,14,35.7,9,9,1,8,4,17,12,0
Heorhiy Sudakov,UKR,MF,Shakhtar,20,2002,2.0,0,0,0,0,0,0,2,0.0,2,3,1,2,1,1,3,1
Daniel Sundgren,SWE,DF,Maccabi Haifa,32,1990,4.2,8,4,4,4,0,5,9,55.6,4,6,2,4,4,12,7,0
Josip Šutalo,CRO,DF,Ajax,23,2000,5.0,2,1,2,0,0,1,3,33.3,2,5,5,0,10,12,19,1
Mile Svilar,SRB,GK,Roma,23,1999,14.3,1,1,1,0,0,1,1,100.0,0,0,0,0,0,1,4,0
Ross Sykes,ENG,DF,Union SG,24,1999,0.1,0,0,0,0,0,0,0,,0,0,0,0,0,0,0,0
Dominik Szoboszlai,HUN,MF,Liverpool,22,2000,3.6,3,2,1,1,1,1,5,20.0,4,5,1,4,4,7,1,2
Július Szöke,SVK,MF,Aris Limassol FC,27,1995,5.4,31,24,12,16,3,14,20,70.0,6,10,3,7,8,39,15,0
Damian Szymański,POL,"MF,DF",AEK Athens,28,1995,5.7,14,7,5,7,2,5,10,50.0,5,11,3,8,11,25,8,0
Asger Sørensen,DEN,DF,Sparta Prague,27,1996,7.2,5,1,3,2,0,5,5,100.0,0,7,4,3,4,9,24,1
Alexander Sørloth,NOR,FW,Villarreal,27,1995,4.1,0,0,0,0,0,0,0,,0,3,0,3,1,1,7,0
Jonathan Tah,GER,DF,Leverkusen,27,1996,10.5,10,7,2,7,1,4,6,66.7,2,6,4,2,7,17,27,1
Benjamin Tahirovic,BIH,MF,Ajax,20,2003,4.3,10,6,5,4,1,3,8,37.5,5,4,2,2,5,15,5,0
Amine Talal,MAR,MF,Sheriff Tiraspol,27,1996,6.0,13,8,8,4,1,8,12,66.7,4,9,1,8,11,24,11,1
Maksym Talovierov,UKR,DF,LASK,23,2000,4.5,7,5,6,1,0,6,8,75.0,2,7,1,6,12,19,26,1
Edmond Tapsoba,BFA,DF,Leverkusen,24,1999,10.9,13,8,8,5,0,6,11,54.5,5,13,7,6,4,17,29,0
James Tavernier,ENG,DF,Rangers,31,1991,8.0,23,11,12,9,2,14,23,60.9,9,13,4,9,10,33,25,0
Kenneth Taylor,NED,MF,Ajax,21,2002,5.3,8,3,4,2,2,0,5,0.0,5,4,1,3,5,13,2,0
Bryan Teixeira,CPV,"FW,MF",Sturm Graz,22,2000,0.6,3,1,1,1,1,1,3,33.3,2,0,0,0,0,3,0,0
Henok Teklab,GER,FW,Union SG,24,1998,0.2,0,0,0,0,0,0,0,,0,0,0,0,0,0,0,0
Nathan Tella,NGA,"DF,FW",Leverkusen,24,1999,6.3,4,3,0,3,1,3,9,33.3,6,9,0,9,4,8,5,0
Casper Tengstedt,DEN,FW,Benfica,23,2000,2.4,2,1,0,1,1,0,1,0.0,1,1,0,1,0,2,4,0
Casper Terho,FIN,"DF,FW",Union SG,20,2003,1.6,4,2,0,3,1,4,5,80.0,1,3,0,3,0,4,0,0
Filippo Terracciano,ITA,DF,Milan,20,2003,0.3,2,2,1,1,0,2,2,100.0,0,0,0,0,0,2,1,0
Ramón Terrats,ESP,"MF,DF",Villarreal,22,2000,1.3,1,1,0,0,1,1,3,33.3,2,3,1,2,1,2,1,0
Martin Terrier,FRA,"FW,MF",Rennes,26,1997,4.5,8,7,1,4,3,5,8,62.5,3,7,0,7,1,9,0,0
Tetê,BRA,"MF,FW",Galatasaray,23,2000,0.3,0,0,0,0,0,0,0,,0,0,0,0,0,0,0,0
Arthur Theate,BEL,DF,Rennes,23,2000,7.1,5,3,2,3,0,2,6,33.3,4,7,5,2,7,12,16,0
Malick Thiaw,GER,DF,Milan,21,2001,1.9,3,1,2,0,1,1,2,50.0,1,2,1,1,1,4,5,0
Jean Thierry Lazare,CIV,"MF,FW",Union SG,25,1998,4.9,13,10,3,7,3,5,11,45.5,6,9,0,9,4,17,4,0
Muhamed Tijani,NGA,FW,Slavia Prague,23,2000,1.0,1,0,0,1,0,1,1,100.0,0,1,1,0,0,1,3,0
Quinten Timber,NED,MF,Feyenoord,22,2001,1.3,2,0,1,0,1,0,1,0.0,1,1,0,1,1,3,2,0
Rafael Tolói,ITA,DF,Atalanta,32,1990,3.3,9,5,3,5,1,5,7,71.4,2,3,1,2,7,16,7,0
Michal Tomič,SVK,"DF,MF",Slavia Prague,24,1999,1.9,5,4,2,3,0,2,3,66.7,1,0,0,0,3,8,1,0
Fikayo Tomori,ENG,DF,Milan,25,1997,2.0,5,1,3,2,0,0,1,0.0,1,2,1,1,1,6,7,0
Lucas Torreira,URU,MF,Galatasaray,27,1996,1.9,2,1,1,1,0,1,3,33.3,2,2,0,2,2,4,4,0
Tomas Totland,NOR,DF,Häcken,24,1998,5.2,8,7,2,5,1,8,11,72.7,3,7,0,7,14,22,11,0
Hussayn Touati,FRA,"FW,MF",Servette FC,21,2001,0.4,3,3,1,1,1,0,1,0.0,1,1,0,1,0,3,1,0
Cristian Tovar,COL,DF,Sheriff Tiraspol,25,1998,5.5,8,5,6,2,0,6,8,75.0,2,12,7,5,1,9,21,0
Manu Trigueros,ESP,MF,Villarreal,31,1991,4.1,8,5,0,6,2,6,10,60.0,4,2,0,2,0,8,1,0
Francisco Trincão,POR,"FW,MF",Sporting CP,23,1999,5.9,10,6,8,2,0,5,10,50.0,5,7,0,7,2,12,2,0
Anatolii Trubin,UKR,GK,Benfica,21,2001,6.3,0,0,0,0,0,0,0,,0,0,0,0,0,0,2,1
Adrien Truffert,FRA,DF,Rennes,21,2001,6.2,6,5,4,2,0,4,9,44.4,5,9,3,6,1,7,10,0
Kostas Tsimikas,GRE,DF,Liverpool,27,1996,4.4,11,9,3,4,4,6,6,100.0,0,5,0,5,6,17,11,1
Keigo Tsunemoto,JPN,"DF,FW",Servette FC,24,1998,2.5,5,4,3,1,1,4,5,80.0,1,12,4,8,3,8,2,0
Indrit Tuci,ALB,FW,Sparta Prague,22,2000,0.7,1,1,0,0,1,0,1,0.0,1,1,0,1,0,1,1,0
Fran Tudor,CRO,"DF,MF",RKS Raków,27,1995,5.0,9,6,3,5,1,6,9,66.7,3,7,3,4,3,12,13,1
Ayase Ueda,JPN,FW,Feyenoord,24,1998,1.2,0,0,0,0,0,0,1,0.0,1,1,1,0,0,0,0,0
Filip Ugrinic,SUI,MF,Young Boys,24,1999,0.5,1,0,1,0,0,1,1,100.0,0,0,0,0,0,1,0,0
Slobodan Urošević,SRB,DF,Aris Limassol FC,29,1994,6.0,13,7,8,4,1,10,17,58.8,7,6,4,2,9,22,22,1
Moses Usor,NGA,FW,LASK,21,2002,4.4,13,9,2,10,1,3,6,50.0,3,11,0,11,3,16,2,0
Georgios Vagiannidis,GRE,DF,Panathinaikos,21,2001,3.9,5,2,2,3,0,0,3,0.0,3,3,1,2,2,7,2,0
Amourrichio Van Axel Dongen,NED,FW,Ajax,18,2004,0.1,0,0,0,0,0,0,0,,0,0,0,0,0,0,0,0
Virgil van Dijk,NED,DF,Liverpool,32,1991,3.7,3,1,3,0,0,1,2,50.0,1,3,3,0,2,5,11,0
Vaná,BRA,GK,Aris Limassol FC,32,1991,6.0,1,1,1,0,0,1,1,100.0,0,0,0,0,0,1,3,1
Charles Vanhoutte,BEL,MF,Union SG,24,1998,4.0,12,7,6,4,2,5,12,41.7,7,4,0,4,5,17,2,0
Berkay Vardar,AZE,MF,Sheriff Tiraspol,20,2003,0.6,2,0,1,1,0,1,2,50.0,1,0,0,0,0,2,0,0
Joël Veltman,NED,DF,Brighton,31,1992,4.2,8,5,4,3,1,6,9,66.7,3,2,1,1,7,15,11,0
Bart Verbruggen,NED,GK,Brighton,20,2002,3.0,0,0,0,0,0,0,0,,0,0,0,0,0,0,0,0
Jordan Veretout,FRA,MF,Marseille,30,1993,11.1,14,10,6,3,5,6,10,60.0,4,9,2,7,7,21,8,0
Marko Vešović,MNE,DF,Qarabağ,31,1991,5.7,13,9,8,5,0,9,15,60.0,6,6,2,4,8,21,23,0
William Vick,DEN,"MF,FW",Sturm Graz,20,2003,3.3,7,2,3,2,2,3,8,37.5,5,2,0,2,1,8,2,0
Domagoj Vida,CRO,DF,AEK Athens,34,1989,5.0,5,2,3,2,0,2,5,40.0,3,5,4,1,10,15,17,1
Tonny Vilhena,NED,MF,Panathinaikos,28,1995,3.5,13,6,2,10,1,3,6,50.0,3,5,0,5,2,15,3,0
Peter Vindahl Jensen,DEN,GK,Sparta Prague,25,1998,10.0,1,1,1,0,0,1,2,50.0,1,1,0,1,0,1,3,1
Carlos Vinícius,BRA,MF,Galatasaray,28,1995,0.1,0,0,0,0,0,0,0,,0,1,0,1,0,0,0,0
Martin Vitík,CZE,DF,Sparta Prague,20,2003,9.0,9,5,4,4,1,4,9,44.4,5,12,6,6,6,15,31,0
Vitinha,POR,FW,Marseille,23,2000,3.0,1,1,0,0,1,0,6,0.0,6,1,0,1,0,1,5,0
Jovan Vlalukin,SRB,"DF,MF",TSC Bačka Top,24,1999,0.9,2,0,1,1,0,2,3,66.7,1,3,1,2,1,3,3,1
Tomáš Vlček,CZE,DF,Slavia Prague,22,2001,3.6,3,2,0,2,1,2,5,40.0,3,3,1,2,5,8,10,0
Silvano Vos,NED,MF,Ajax,18,2005,1.5,2,2,0,1,1,1,2,50.0,1,2,0,2,2,4,1,1
Nicolas Vouilloz,SUI,DF,Servette FC,22,2001,3.0,3,2,1,2,0,2,2,100.0,0,3,3,0,6,9,6,0
Miloš Vulić,SRB,MF,TSC Bačka Top,26,1996,2.5,3,3,1,2,0,0,1,0.0,1,0,0,0,3,6,7,0
Patrik Vydra,CZE,"MF,DF",Sparta Prague,20,2003,0.5,2,1,2,0,0,0,0,,0,5,2,3,1,3,2,0
Elye Wahi,FRA,FW,Lens,20,2003,1.6,0,0,0,0,0,0,0,,0,1,0,1,1,1,1,0
Conrad Wallem,NOR,"MF,FW",Slavia Prague,23,2000,3.9,6,4,1,3,2,3,5,60.0,2,2,0,2,4,10,1,0
James Ward-Prowse,ENG,MF,West Ham,28,1994,9.0,8,4,1,5,2,2,9,22.2,7,7,2,5,7,15,17,0
Adam Webster,ENG,DF,Brighton,28,1995,0.1,0,0,0,0,0,0,0,,0,0,0,0,0,0,0,0
Noah Weißhaupt,GER,"MF,DF",Freiburg,21,2001,3.6,4,2,3,1,0,2,4,50.0,2,0,0,0,1,5,5,0
Danny Welbeck,ENG,FW,Brighton,32,1990,2.8,0,0,0,0,0,0,1,0.0,1,1,0,1,0,0,1,0
Timon Wellenreuther,GER,GK,Feyenoord,27,1995,2.3,0,0,0,0,0,0,0,,0,0,0,0,0,0,0,0
Mats Wieffer,NED,MF,Feyenoord,23,1999,2.3,3,0,1,2,0,0,2,0.0,2,7,0,7,3,6,3,0
Tomáš Wiesner,CZE,"DF,MF",Sparta Prague,26,1997,3.5,4,1,3,1,0,2,6,33.3,4,3,1,2,3,7,5,0
Florian Wirtz,GER,"MF,FW",Leverkusen,20,2003,7.8,6,6,1,2,3,3,14,21.4,11,8,0,8,5,11,1,0
Magnus Wolff Eikrem,NOR,FW,Molde,32,1990,3.9,3,0,0,1,2,3,4,75.0,1,2,0,2,4,7,1,0
Christopher Wooh,CMR,DF,Rennes,21,2001,3.0,2,2,0,2,0,1,3,33.3,2,0,0,0,3,5,13,0
Scott Wright,SCO,FW,Rangers,25,1997,2.0,1,1,1,0,0,1,1,100.0,0,2,1,1,1,2,3,0
Gregory Wüthrich,SUI,DF,Sturm Graz,28,1994,3.7,10,6,7,3,0,6,9,66.7,3,5,0,5,10,20,15,0
Szymon Włodarczyk,POL,FW,Sturm Graz,20,2003,2.9,3,1,0,1,2,1,1,100.0,0,3,0,3,1,4,5,0
Granit Xhaka,SUI,MF,Leverkusen,30,1992,9.9,16,9,7,8,1,7,11,63.6,4,7,3,4,4,20,10,1
Redon Xhixha,ALB,FW,Qarabağ,25,1998,0.7,0,0,0,0,0,0,1,0.0,1,1,0,1,0,0,0,0
Steeve Yago,BFA,DF,Aris Limassol FC,30,1992,5.0,20,13,16,2,2,11,15,73.3,4,7,2,5,11,31,20,0
John Yeboah,ECU,"FW,MF",RKS Raków,23,2000,3.4,8,4,2,4,2,2,4,50.0,2,2,0,2,1,9,1,0
Bertuğ Yıldırım,TUR,FW,Rennes,21,2002,3.1,3,2,0,0,3,2,4,50.0,2,8,2,6,1,4,0,0
Rıdvan Yılmaz,TUR,DF,Rangers,22,2001,2.0,2,2,1,0,1,1,2,50.0,1,9,6,3,4,6,7,0
Ali Youssef,TUN,FW,Häcken,22,2000,1.0,0,0,0,0,0,0,1,0.0,1,0,0,0,0,0,0,0
Christos Zafeiris,GRE,MF,Slavia Prague,20,2003,5.1,7,4,2,3,2,3,10,30.0,7,6,1,5,5,12,5,0
Wilfried Zaha,CIV,FW,Galatasaray,30,1992,0.4,0,0,0,0,0,0,0,,0,0,0,0,1,1,0,0
Rodrigo Zalazar,URU,MF,Braga,23,1999,1.3,4,2,2,1,1,2,5,40.0,3,0,0,0,1,5,0,0
Nicola Zalewski,POL,"DF,FW",Roma,21,2002,5.3,10,6,6,4,0,4,9,44.4,5,1,1,0,6,16,12,0
Davide Zappacosta,ITA,DF,Atalanta,31,1992,8.1,6,4,3,2,1,5,9,55.6,4,8,0,8,2,8,7,0
Jaroslav Zelený,CZE,DF,Sparta Prague,30,1992,6.2,9,3,2,6,1,4,6,66.7,2,1,0,1,3,12,18,1
Ramiz Zerrouki,ALG,MF,Feyenoord,25,1998,1.7,2,0,1,0,1,0,3,0.0,3,3,1,2,1,3,2,0
Philipp Ziereis,GER,DF,LASK,30,1993,6.0,14,12,12,2,0,10,14,71.4,4,11,5,6,6,20,40,0
David Zima,CZE,DF,Slavia Prague,22,2000,2.0,0,0,0,0,0,0,0,,0,1,1,0,4,4,8,0
Ondřej Zmrzlý,CZE,"DF,FW",Slavia Prague,24,1999,1.9,1,1,0,1,0,1,3,33.3,2,0,0,0,0,1,2,0
Nadir Zortea,ITA,MF,Atalanta,24,1999,1.0,1,0,0,0,1,1,1,100.0,0,1,0,1,1,2,2,0
Abdellah Zoubir,FRA,"FW,MF",Qarabağ,31,1991,10.1,9,7,4,4,1,2,8,25.0,6,11,0,11,5,14,6,1
Kurt Zouma,FRA,DF,West Ham,28,1994,4.0,4,2,3,1,0,2,2,100.0,0,4,3,1,4,8,23,0
Steven Zuber,SUI,"FW,MF",AEK Athens,31,1991,3.4,2,1,0,0,2,2,4,50.0,2,2,0,2,1,3,4,0
Oleksandr Zubkov,UKR,MF,Shakhtar,26,1996,1.9,3,3,1,1,1,1,2,50.0,1,0,0,0,0,3,4,0
Robert Žulj,AUT,"FW,MF",LASK,31,1992,6.0,15,9,3,7,5,7,9,77.8,2,7,0,7,1,16,6,0
Łukasz Zwoliński,POL,FW,RKS Raków,30,1993,1.7,1,1,1,0,0,0,2,0.0,2,1,0,1,2,3,0,0
Niklas Ødegård,NOR,"MF,FW",Molde,19,2004,0.6,0,0,0,0,0,0,2,0.0,2,0,0,0,0,0,1,0
Casper Øyvann,NOR,DF,Molde,23,1999,5.0,8,6,6,2,0,6,8,75.0,2,6,4,2,1,9,19,0
Ifet Đakovac,SRB,"MF,FW",TSC Bačka Top,25,1997,5.5,6,4,3,2,1,0,6,0.0,6,7,2,5,3,9,3,0
Mateja Đorđević,SRB,DF,TSC Bačka Top,20,2003,1.8,2,0,2,0,0,1,4,25.0,3,4,2,2,2,4,9,0
Filip Đuričić,SRB,MF,Panathinaikos,31,1992,2.1,2,0,0,2,0,0,2,0.0,2,5,0,5,0,2,1,0
Łukasz Łakomy,POL,MF,Young Boys,22,2001,1.0,1,0,0,1,0,0,3,0.0,3,1,1,0,2,3,2,0
