Player,Nation,Pos,Squad,Age,Born,90s,Tackles,TacklesWon,TacklesDef3rd,TacklesMid3rd,TacklesAtt3rd,DribTkl,DribTklAtt,DribTkl%,ChallengesLost,Blocks,ShotsBlocked,PassesBlocked,Int,Tkl+Int,Clr,ErrorsLeadingToShot
Rodrigo Abascal,URU,DF,Boavista,29,1994,27.5,46,26,33,13,0,26,40,65.0,14,59,32,27,34,80,110,3
Antonio Adán,ESP,GK,Sporting CP,36,1987,22.0,0,0,0,0,0,0,1,0.0,1,0,0,0,0,0,3,1
Dennis Adeniran,ENG,MF,Portimonense,24,1999,0.1,0,0,0,0,0,0,0,,0,0,0,0,2,2,0,0
Martin Agirregabiria,ESP,DF,Famalicão,27,1996,13.4,21,18,15,4,2,17,24,70.8,7,12,2,10,11,32,31,1
Salvador Agra,POR,"FW,DF",Boavista,31,1991,27.3,21,9,14,5,2,9,31,29.0,22,8,1,7,16,37,19,0
Matheus Aiás,BRA,"FW,MF",Moreirense,26,1996,5.3,4,2,2,0,2,1,10,10.0,9,7,4,3,4,8,2,0
Alan,BRA,MF,Moreirense,23,2000,27.3,44,32,7,25,12,9,29,31.0,20,24,2,22,7,51,5,0
Rafael Alcobia,POR,DF,Portimonense,20,2003,2.3,3,3,2,1,0,1,1,100.0,0,4,1,3,1,4,4,0
Alemão,BRA,DF,Portimonense,20,2002,26.3,49,34,39,10,0,27,39,69.2,12,49,33,16,30,79,137,1
Ali Alipour,IRN,FW,Gil Vicente FC,27,1995,8.9,9,4,0,3,6,2,5,40.0,3,6,0,6,0,9,4,0
Almeida,BRA,DF,Estrela,23,2000,5.4,6,5,3,3,0,3,7,42.9,4,6,4,2,3,9,19,0
Pedro Álvaro,POR,DF,Estoril,23,2000,19.9,11,7,11,0,0,7,12,58.3,5,21,15,6,23,34,96,0
Pedro Amador,POR,DF,Moreirense,24,1998,12.6,28,19,16,10,2,16,31,51.6,15,17,3,14,15,43,32,0
Artur Jorge Marques Amorim,POR,DF,Farense,28,1994,5.5,7,4,5,2,0,4,5,80.0,1,10,8,2,7,14,37,0
André André,POR,MF,Vitória,33,1989,7.3,9,4,3,5,1,6,10,60.0,4,9,1,8,4,13,7,0
Andrew,BRA,GK,Gil Vicente FC,22,2001,32.0,0,0,0,0,0,0,0,,0,0,0,0,0,0,14,2
Jeremy Antonisse,CUW,FW,Moreirense,21,2002,6.1,13,8,8,5,0,8,20,40.0,12,8,1,7,5,18,9,0
Pedro Aparício,POR,"MF,FW",Moreirense,27,1995,3.7,2,1,1,1,0,1,6,16.7,5,0,0,0,1,3,3,0
Óscar Aranda,ESP,"FW,MF",Famalicão,21,2002,8.0,7,4,1,4,2,2,10,20.0,8,6,2,4,1,8,1,0
Henrique Araújo,POR,FW,Famalicão,21,2002,7.6,3,1,0,3,0,1,3,33.3,2,3,1,2,1,4,3,0
Tiago Araújo,POR,"DF,MF",Estoril,22,2001,25.0,34,22,17,14,3,21,48,43.8,27,23,0,23,27,61,67,1
Tomás Araújo,POR,DF,Benfica,21,2002,5.4,12,9,4,3,5,5,8,62.5,3,10,4,6,8,20,18,0
Gustavo Assuncao,POR,MF,Famalicão,23,2000,7.0,17,12,11,6,0,10,20,50.0,10,8,2,6,9,26,16,1
Otavio Ataide,BRA,DF,Famalicão,21,2002,15.4,31,21,24,5,2,20,31,64.5,11,33,21,12,25,56,66,0
Otavio Ataide,BRA,DF,Porto,21,2002,12.0,11,6,9,1,1,9,15,60.0,6,10,6,4,7,18,29,0
Fredrik Aursnes,NOR,DF,Benfica,27,1995,31.0,73,43,32,32,9,49,84,58.3,35,41,8,33,18,91,43,0
Chidozie Awaziem,NGA,DF,Boavista,26,1997,21.7,23,18,18,3,2,13,21,61.9,8,27,17,10,18,41,98,2
Abdul Awudu,GHA,"FW,MF",Vizela,22,2001,2.1,4,3,1,1,2,2,7,28.6,5,2,1,1,0,4,1,0
Amadou Ba-Sy,FRA,"FW,MF",Vizela,22,2001,1.3,1,1,0,1,0,0,1,0.0,1,2,1,1,1,2,0,0
Alexander Bah,DEN,DF,Benfica,25,1997,16.9,52,35,23,19,10,30,44,68.2,14,24,4,20,32,84,28,1
Elves Baldé,GNB,"FW,MF",Farense,23,1999,10.8,9,5,6,2,1,6,17,35.3,11,11,2,9,1,10,12,0
Robson Bambu,BRA,DF,Arouca,25,1997,9.8,15,12,9,6,0,7,11,63.6,4,12,8,4,9,24,35,0
Daniel Bandeira,POR,MF,Vitória,23,2000,7.8,8,6,3,3,2,3,7,42.9,4,6,0,6,11,19,11,0
Simon Banza,COD,FW,Braga,26,1996,22.2,11,6,4,2,5,1,10,10.0,9,16,1,15,8,19,14,0
Rafael Barbosa,POR,"MF,FW",Farense,27,1996,9.5,12,9,5,4,3,6,11,54.5,5,8,4,4,4,16,3,0
Romário Baró,POR,"MF,FW",Porto,23,2000,2.5,2,2,1,1,0,1,6,16.7,5,0,0,0,1,3,4,0
Afonso Bastardo,POR,"FW,DF",Gil Vicente FC,18,2005,0.5,1,1,0,0,1,0,1,0.0,1,1,0,1,1,2,0,0
Afonso Bastardo,POR,MF,Sporting CP,18,2005,0.3,1,1,1,0,0,1,2,50.0,1,1,0,1,0,1,1,0
Gilberto Batista,GNB,DF,Moreirense,19,2003,2.5,3,2,3,0,0,2,4,50.0,2,5,5,0,1,4,19,1
Ricardo Batista,POR,GK,Casa Pia,36,1986,30.9,1,0,1,0,0,1,3,33.3,2,0,0,0,0,1,6,1
Roko Baturina,CRO,FW,Gil Vicente FC,23,2000,7.9,1,1,0,0,1,0,3,0.0,3,2,0,2,0,1,5,0
Bachir Belloumi,ALG,"FW,MF",Farense,21,2002,23.0,41,28,19,17,5,17,41,41.5,24,38,6,32,21,62,32,0
Fahem Benaissa Yahia,FRA,MF,Casa Pia,21,2002,0.1,0,0,0,0,0,0,1,0.0,1,0,0,0,0,0,0,0
Beni,ANG,MF,Casa Pia,21,2002,16.3,32,24,17,15,0,13,28,46.4,15,17,2,15,19,51,18,1
Benny,POR,"MF,FW",Chaves,23,2000,14.1,10,3,4,4,2,3,14,21.4,11,18,0,18,6,16,17,0
Berna,ANG,"FW,DF",Boavista,19,2003,3.6,15,11,8,5,2,5,10,50.0,5,5,2,3,5,20,4,0
Juan Bernat,ESP,DF,Benfica,30,1993,0.9,0,0,0,0,0,0,2,0.0,2,2,0,2,0,0,3,0
Emmanuel Boateng,GHA,FW,Rio Ave,27,1996,20.7,12,9,4,6,2,3,7,42.9,4,11,3,8,5,17,16,0
Kiko Bondoso,POR,"FW,MF",Vizela,27,1995,2.1,5,3,1,2,2,4,6,66.7,2,2,0,2,1,6,2,0
Toni Borevkovic,CRO,DF,Vitória,26,1997,22.7,22,14,20,2,0,22,28,78.6,6,25,11,14,36,58,108,0
Gonçalo Borges,POR,"MF,FW",Porto,22,2001,3.2,7,4,6,1,0,4,8,50.0,4,3,0,3,0,7,4,0
Cristian Borja,COL,DF,Braga,30,1993,27.2,61,33,36,23,2,23,42,54.8,19,25,5,20,22,83,55,0
Róbert Boženík,SVK,FW,Boavista,23,1999,28.6,16,10,0,12,4,5,16,31.3,11,12,1,11,4,20,34,0
Daniel Bragança,POR,MF,Sporting CP,24,1999,11.4,33,22,9,15,9,14,26,53.8,12,11,2,9,19,52,4,2
Bruno Brigido,BRA,GK,Estrela,32,1991,26.0,2,2,2,0,0,2,4,50.0,2,1,0,1,0,2,18,0
Rafael Brito,POR,MF,Casa Pia,21,2002,3.8,12,8,4,5,3,4,12,33.3,8,3,1,2,5,17,8,0
Bruma,POR,"FW,MF",Braga,28,1994,19.1,22,12,6,12,4,8,27,29.6,19,13,1,12,6,28,4,0
Jonathan Buatu Mananga,ANG,DF,Gil Vicente FC,29,1993,5.0,8,4,8,0,0,5,5,100.0,0,7,3,4,1,9,23,0
Leonel Bucca,ARG,"MF,FW",Estrela,24,1999,9.1,36,23,15,14,7,21,39,53.8,18,11,2,9,4,40,5,0
André Bukia,COD,"MF,FW",Arouca,28,1995,1.7,5,4,3,1,1,3,6,50.0,3,3,0,3,1,6,1,0
Fabijan Buntić,CRO,GK,Vizela,26,1997,27.7,0,0,0,0,0,0,0,,0,1,0,1,0,0,18,0
Aleksandar Busnić,SRB,"MF,FW",Vizela,25,1997,8.5,21,12,10,9,2,10,20,50.0,10,13,4,9,6,27,23,0
Oriol Busquets,ESP,MF,Arouca,24,1999,4.8,9,5,5,3,1,3,4,75.0,1,5,3,2,2,11,10,0
Rafael Bustamante,COL,MF,Vizela,23,1999,7.9,16,9,10,5,1,7,25,28.0,18,17,3,14,12,28,7,0
Leonardo Buta,POR,DF,Gil Vicente FC,21,2002,24.3,48,30,28,15,5,33,46,71.7,13,21,8,13,28,76,65,1
Adrián Butzke,ESP,FW,Vitória,24,1999,4.1,3,3,0,3,0,1,2,50.0,1,4,1,3,0,3,8,0
Erick Cabaco,URU,DF,Estoril,28,1995,3.7,5,4,3,2,0,1,3,33.3,2,4,3,1,7,12,16,0
Arthur Cabral,BRA,FW,Benfica,25,1998,14.8,11,7,2,5,4,3,9,33.3,6,8,0,8,1,12,7,0
Jhonder Cádiz,VEN,FW,Famalicão,28,1995,25.6,10,7,1,6,3,2,9,22.2,7,4,2,2,1,11,21,0
João Pedro Gomes Camacho,POR,"FW,MF",Moreirense,29,1994,23.1,37,25,13,14,10,15,28,53.6,13,23,2,21,14,51,16,0
Ibrahima Camará,GUI,"MF,DF",Boavista,24,1999,5.3,4,4,2,1,1,3,6,50.0,3,4,1,3,4,8,18,0
Cambila,ANG,GK,Estrela,21,2002,0.2,0,0,0,0,0,0,0,,0,0,0,0,0,0,1,1
Luan Campos,BRA,"FW,MF",Portimonense,21,2002,5.2,7,5,2,4,1,4,8,50.0,4,4,1,3,5,12,6,0
Fábio Cardoso,POR,DF,Porto,29,1994,13.4,5,3,1,4,0,0,2,0.0,2,12,8,4,12,17,37,0
Felippe Cardoso,BRA,FW,Casa Pia,24,1998,17.4,14,8,1,7,6,3,13,23.1,10,7,1,6,1,15,7,0
Carlinhos,BRA,MF,Portimonense,29,1994,31.6,44,27,14,24,6,23,44,52.3,21,12,2,10,8,52,24,2
João Carlos,BRA,"FW,DF",Estoril,28,1995,3.5,2,1,1,1,0,0,2,0.0,2,4,0,4,1,3,2,0
Zé Carlos,POR,"MF,DF",Vitória,21,2001,4.7,10,5,5,5,0,6,18,33.3,12,6,1,5,6,16,7,0
Zé Carlos,POR,DF,Gil Vicente FC,25,1998,21.4,50,34,34,9,7,20,37,54.1,17,21,6,15,30,80,56,2
David Carmo,ANG,DF,Porto,24,1999,6.8,5,4,2,2,1,4,5,80.0,1,11,7,4,2,7,31,1
Marcelo Carné,BRA,GK,Estoril,33,1990,22.0,1,1,1,0,0,1,2,50.0,1,0,0,0,0,1,8,4
Carraça,POR,"DF,MF",Chaves,30,1993,11.1,9,5,3,6,0,6,11,54.5,5,7,0,7,7,16,23,0
Álvaro Carreras,ESP,DF,Benfica,20,2003,6.3,18,10,7,9,2,8,12,66.7,4,8,3,5,10,28,9,0
Ronie Carrillo,ECU,"FW,MF",Portimonense,26,1996,14.6,9,4,1,5,3,2,7,28.6,5,13,1,12,3,12,19,0
António Filipe de Carvalho,POR,GK,Estrela,38,1985,3.0,0,0,0,0,0,0,0,,0,0,0,0,0,0,1,0
Miguel Carvalho,POR,GK,Farense,27,1996,2.0,0,0,0,0,0,0,0,,0,0,0,0,0,0,1,0
Vitor Carvalho,BRA,MF,Braga,26,1997,14.5,41,22,21,19,1,22,37,59.5,15,22,4,18,18,59,29,1
Facundo Cáseres,ARG,MF,Farense,22,2001,12.4,49,25,27,20,2,21,33,63.6,12,35,14,21,11,60,17,0
Midana Cassama,GNB,"FW,MF",Portimonense,20,2002,3.2,4,3,1,2,1,2,3,66.7,1,2,1,1,2,6,2,0
Cassiano,BRA,FW,Estoril,34,1989,17.9,31,20,10,13,8,13,30,43.3,17,16,2,14,0,31,11,0
Jesús Castillo,PER,MF,Gil Vicente FC,22,2001,2.7,6,5,1,4,1,4,9,44.4,5,4,1,3,4,10,8,0
André Castro,POR,MF,Braga,35,1988,0.5,1,0,0,1,0,1,4,25.0,3,4,1,3,1,2,1,0
André Castro,POR,MF,Moreirense,35,1988,6.0,15,10,6,7,2,10,17,58.8,7,6,0,6,6,21,15,0
Cristian Castro,COL,DF,Rio Ave,22,2001,0.8,0,0,0,0,0,0,2,0.0,2,1,1,0,1,1,8,0
Geny Catamo,MOZ,"MF,DF",Sporting CP,22,2001,18.7,25,17,12,5,8,15,33,45.5,18,19,1,18,12,37,15,0
Tidjany Chabrol,FRA,"FW,MF",Gil Vicente FC,21,2002,12.0,13,8,3,9,1,5,17,29.4,12,14,2,12,3,16,8,1
Charles,BRA,GK,Vitória,29,1994,7.5,0,0,0,0,0,0,1,0.0,1,0,0,0,0,0,6,0
Chiquinho,POR,"FW,MF",Famalicão,23,2000,19.3,31,18,13,15,3,12,31,38.7,19,43,4,39,13,44,10,0
Chiquinho,POR,MF,Benfica,28,1995,2.1,5,4,1,4,0,1,3,33.3,2,1,0,1,2,7,3,0
Clayton,BRA,FW,Casa Pia,24,1999,18.8,9,7,1,3,5,1,14,7.1,13,13,2,11,3,12,12,0
Sebastián Coates,URU,DF,Sporting CP,32,1990,25.3,38,19,23,14,1,24,36,66.7,12,28,19,9,24,62,81,1
Fábio Conceição,POR,"MF,FW",Rio Ave,22,2001,28.2,36,24,25,7,4,22,52,42.3,30,35,5,30,17,53,35,0
Francisco Conceição,POR,"FW,MF",Porto,20,2002,21.0,40,31,9,15,16,16,30,53.3,14,14,1,13,2,42,4,1
Leo Cordeiro,BRA,MF,Estrela,27,1995,29.0,60,40,23,30,7,32,64,50.0,32,36,8,28,19,79,20,0
Jeriel Córdova,VEN,FW,Boavista,21,2002,1.7,0,0,0,0,0,0,2,0.0,2,1,0,1,0,0,1,0
Félix Correia,POR,FW,Gil Vicente FC,22,2001,24.1,31,22,11,11,9,21,29,72.4,8,28,2,26,21,52,16,2
João Pedro Araújo Correia,CPV,"DF,MF",Chaves,26,1996,23.3,19,12,10,7,2,12,41,29.3,29,21,8,13,31,50,44,1
Alberto costa,POR,DF,Vitória,19,2003,0.2,0,0,0,0,0,0,0,,0,0,0,0,0,0,0,0
Bruno Xavier Almeida Costa,POR,MF,Vizela,26,1997,6.8,3,1,1,1,1,2,9,22.2,7,4,1,3,10,13,5,0
Diogo Costa,POR,GK,Porto,23,1999,32.7,0,0,0,0,0,0,0,,0,0,0,0,0,0,17,2
Gonçalo Costa,POR,"DF,MF",Portimonense,23,2000,19.0,59,38,32,22,5,33,48,68.8,15,27,3,24,27,86,46,1
Michel Costa,BRA,MF,Estoril,21,2001,3.3,10,4,5,3,2,6,10,60.0,4,4,0,4,2,12,6,0
Murilo Costa,BRA,FW,Gil Vicente FC,28,1994,22.1,21,15,9,12,0,10,20,50.0,10,16,0,16,16,37,13,0
Rui Costa,POR,"FW,MF",Farense,27,1996,7.8,3,2,2,1,0,3,5,60.0,2,7,1,6,0,3,2,0
Tomás Costa Silva,POR,DF,Vizela,23,1999,29.1,74,50,42,24,8,45,79,57.0,34,33,8,25,41,115,102,1
Costinha,POR,"MF,DF",Rio Ave,23,2000,33.9,95,60,41,43,11,55,104,52.9,49,88,12,76,40,135,92,3
Sandro Cruz,ANG,"DF,MF",Chaves,22,2001,18.1,34,23,23,10,1,22,35,62.9,13,23,8,15,20,54,70,2
Florian Danho Seke,FRA,FW,Famalicão,23,2000,2.7,3,3,1,0,2,2,2,100.0,0,5,0,5,0,3,3,0
Ignacio De Arruabarrena,URU,GK,Arouca,26,1997,31.0,3,2,3,0,0,3,6,50.0,3,0,0,0,1,4,23,3
Fran Delgado,ESP,DF,Farense,22,2001,5.5,7,2,3,3,1,4,6,66.7,2,9,2,7,2,9,8,0
Dener,BRA,MF,Portimonense,31,1992,19.6,51,31,26,21,4,22,47,46.8,25,16,4,12,26,77,43,0
Depú,ANG,FW,Gil Vicente FC,23,2000,8.6,5,4,2,1,2,2,5,40.0,3,3,0,3,2,7,4,0
Ángel Di María,ARG,FW,Benfica,35,1988,24.6,20,12,9,8,3,7,32,21.9,25,26,0,26,8,28,3,1
Tiago Dias,POR,"MF,FW",Casa Pia,25,1998,8.8,8,7,4,3,1,4,14,28.6,10,15,1,14,5,13,4,0
Vinicius Dias,BRA,GK,Gil Vicente FC,26,1997,2.0,0,0,0,0,0,0,0,,0,0,0,0,0,0,0,1
Dida,BRA,GK,Estrela,25,1998,4.7,0,0,0,0,0,0,0,,0,1,0,1,0,0,5,0
Ousmane Diomande,CIV,DF,Sporting CP,19,2003,23.5,41,24,23,14,4,17,22,77.3,5,11,7,4,13,54,43,1
Álvaro djaló,ESP,"FW,MF",Braga,23,1999,19.9,27,19,7,14,6,15,45,33.3,30,17,1,16,23,50,15,0
Mihai Dobre,ROU,FW,Famalicão,24,1998,3.9,5,3,4,0,1,3,12,25.0,9,4,0,4,3,8,5,0
Maxime Dominguez,SUI,"MF,FW",Gil Vicente FC,27,1996,25.9,46,26,16,25,5,28,68,41.2,40,51,4,47,28,74,6,2
Bruno Duarte,BRA,FW,Farense,27,1996,25.1,15,9,1,11,3,8,27,29.6,19,24,5,19,7,22,27,0
Jorge Eduardo Sánchez,MEX,DF,Porto,25,1997,6.3,19,13,12,5,2,15,23,65.2,8,5,0,5,7,26,7,0
Marcus Edwards,ENG,"FW,MF",Sporting CP,24,1998,14.9,10,7,2,6,2,1,8,12.5,7,8,0,8,6,16,2,0
Úmaro Embaló,POR,"MF,FW",Rio Ave,22,2001,8.8,10,4,3,6,1,0,7,0.0,7,9,0,9,3,13,9,0
João Escoval,POR,DF,Vizela,26,1997,15.2,25,10,20,4,1,10,17,58.8,7,14,9,5,14,39,55,1
Ricardo Esgaio,POR,"MF,DF",Sporting CP,30,1993,16.6,44,22,19,18,7,22,42,52.4,20,14,2,12,7,51,35,0
Tiago Esgaio,POR,DF,Arouca,27,1995,25.3,61,37,37,20,4,42,68,61.8,26,36,9,27,34,95,72,0
Samuel Essende,COD,FW,Vizela,25,1998,29.6,9,7,1,5,3,4,9,44.4,5,21,8,13,3,12,17,0
Dario Essugo,POR,MF,Chaves,18,2005,12.9,29,19,15,11,3,16,25,64.0,9,21,3,18,21,50,32,0
Dario Essugo,POR,MF,Sporting CP,18,2005,0.4,2,2,0,2,0,1,1,100.0,0,0,0,0,0,2,0,0
Paulo Estrela Moreira,POR,"MF,FW",Portimonense,24,1999,5.9,14,7,6,7,1,4,15,26.7,11,11,1,10,7,21,10,0
Stephen Eustáquio,CAN,MF,Porto,26,1996,17.0,41,27,16,19,6,19,35,54.3,16,28,5,23,18,59,25,0
Evanilson,BRA,FW,Porto,23,1999,22.8,19,11,2,9,8,7,13,53.8,6,15,1,14,3,22,8,0
Fabiano,BRA,DF,Moreirense,23,2000,23.7,45,30,27,11,7,25,35,71.4,10,13,2,11,29,74,60,1
Claudio Falcão,BRA,MF,Farense,29,1994,28.9,78,45,33,44,1,29,82,35.4,53,48,17,31,40,118,128,1
Jean Felipe,BRA,"MF,DF",Estrela,29,1994,12.8,24,18,9,13,2,18,30,60.0,12,11,1,10,10,34,21,0
Volnei Feltes,BRA,DF,Estoril,23,2000,16.4,19,15,10,9,0,8,24,33.3,16,21,14,7,21,40,55,2
Jorge Filipe Oliveira Fernandes,POR,DF,Vitória,26,1997,27.1,52,39,29,22,1,38,68,55.9,30,35,11,24,26,78,115,0
Martim Fernandes,POR,DF,Porto,17,2006,2.8,10,6,6,3,1,6,7,85.7,1,2,0,2,5,15,7,0
Mateus Fernandes,POR,MF,Estoril,19,2004,24.8,79,46,28,40,11,39,78,50.0,39,44,6,38,25,104,16,2
Mateus Fernandes,POR,FW,Sporting CP,19,2004,0.0,0,0,0,0,0,0,0,,0,0,0,0,0,0,0,0
Rafael Fernandes,POR,DF,Arouca,21,2002,8.3,12,8,8,2,2,6,7,85.7,1,6,5,1,9,21,31,0
Roger Fernandes,GNB,"MF,FW",Braga,17,2005,7.5,16,11,3,10,3,9,20,45.0,11,10,0,10,4,20,3,0
Rúben Fernandes,POR,DF,Gil Vicente FC,37,1986,29.0,18,11,15,3,0,9,21,42.9,12,33,19,14,35,53,117,1
Vasco Fernandes,POR,DF,Casa Pia,36,1986,10.0,8,5,7,1,0,5,9,55.6,4,13,6,7,10,18,29,0
Vasco Fernandes,POR,DF,Chaves,36,1986,16.8,26,14,18,7,1,17,25,68.0,8,17,9,8,9,35,68,1
Fernando,BRA,"FW,MF",Casa Pia,30,1993,6.0,10,6,4,3,3,3,8,37.5,5,6,0,6,0,10,2,0
Filipe Ferreira,POR,DF,Boavista,32,1990,19.2,31,22,16,15,0,19,26,73.1,7,21,8,13,18,49,47,1
Marcelo dos Santos Ferreira,BRA,DF,Moreirense,34,1989,26.0,36,20,28,8,0,18,31,58.1,13,39,27,12,28,64,142,0
Vitó Ferreira,POR,MF,Estrela,25,1997,6.4,12,7,5,7,0,7,24,29.2,17,6,0,6,4,16,9,0
Daniel Figueira,POR,GK,Estoril,25,1998,12.0,3,2,3,0,0,3,3,100.0,0,0,0,0,0,3,9,0
Diogo Fonseca,POR,DF,Estrela,21,2002,4.8,6,4,3,3,0,2,3,66.7,1,3,1,2,4,10,15,0
Tiago Fonseca Morais,POR,"FW,MF",Boavista,19,2003,15.3,23,17,14,6,3,12,38,31.6,26,21,1,20,10,33,7,0
Théo Fonseca,FRA,FW,Famalicão,23,2000,7.2,10,3,5,3,2,3,6,50.0,3,7,2,5,7,17,7,0
José Fonte,POR,DF,Braga,39,1983,16.8,8,3,6,2,0,3,8,37.5,5,18,13,5,20,28,70,0
Hernâni Fortes,POR,FW,Rio Ave,31,1991,3.8,0,0,0,0,0,0,4,0.0,4,1,1,0,1,1,1,0
André Franco,POR,"MF,FW",Porto,25,1998,4.9,6,5,3,3,0,4,11,36.4,7,1,0,1,4,10,5,0
Gonçalo Franco,POR,MF,Moreirense,22,2000,30.2,81,54,38,33,10,29,75,38.7,46,57,5,52,59,140,52,0
Afonso freitas,POR,"DF,MF",Vitória,23,2000,8.1,16,11,8,5,3,8,12,66.7,4,5,0,5,4,20,15,0
Iván Fresneda,ESP,"MF,DF",Sporting CP,18,2004,0.4,4,2,3,1,0,2,3,66.7,1,1,0,1,0,4,2,0
Godfried Frimpong,NED,DF,Moreirense,24,1999,22.4,35,22,26,7,2,21,29,72.4,8,21,5,16,39,74,81,0
Kanya Fujimoto,JPN,MF,Gil Vicente FC,24,1999,22.2,26,15,7,15,4,9,15,60.0,6,23,4,19,11,37,8,0
Taichi Fukui,JPN,MF,Portimonense,19,2004,6.6,8,5,0,3,5,2,11,18.2,9,4,0,4,5,13,8,0
Galeno,BRA,"FW,MF",Porto,25,1997,24.9,25,18,11,8,6,11,28,39.3,17,22,2,20,15,40,18,0
Nino Galović,CRO,DF,Arouca,31,1992,16.0,10,6,6,2,2,7,17,41.2,10,10,7,3,16,26,68,0
Fabrício Garcia,CPV,"FW,MF",Estoril,22,2001,3.7,13,10,6,4,3,7,10,70.0,3,5,0,5,1,14,3,0
Bruno Gaspar,ANG,"MF,DF",Vitória,30,1993,25.4,37,23,21,10,6,19,32,59.4,13,35,4,31,17,54,32,1
Mory Gbane,CIV,MF,Gil Vicente FC,22,2000,21.2,59,36,28,21,10,32,47,68.1,15,33,15,18,27,86,52,1
André Geraldes,POR,"MF,DF",Casa Pia,32,1991,6.7,7,3,6,1,0,3,4,75.0,1,5,1,4,2,9,15,0
Saviour Godwin,NGA,"FW,MF",Casa Pia,26,1996,3.8,5,3,3,1,1,0,1,0.0,1,7,0,7,4,9,0,0
Eulânio Ângelo Chipela Gomes,GNB,MF,Estrela,29,1994,6.5,8,5,1,2,5,2,4,50.0,2,10,1,9,5,13,6,0
Rodrigo Gomes,POR,"MF,DF",Estoril,20,2003,27.2,47,30,21,19,7,19,49,38.8,30,39,6,33,25,72,53,1
Vítor Gomes,POR,MF,Rio Ave,35,1987,3.6,5,4,2,3,0,2,4,50.0,2,7,3,4,3,8,5,0
Victor Gomez,ESP,DF,Braga,23,2000,22.6,41,27,18,17,6,31,49,63.3,18,22,6,16,26,67,62,1
Nuno Gonçalo Moreira,POR,"FW,MF",Casa Pia,24,1999,11.3,21,12,4,13,4,8,21,38.1,13,12,1,11,9,30,7,0
Nuno Gonçalo Moreira,POR,"FW,MF",Vizela,24,1999,10.7,14,9,6,7,1,4,14,28.6,10,14,2,12,10,24,8,1
João Gonçalves,POR,GK,Boavista,22,2000,34.0,1,1,1,0,0,1,4,25.0,3,0,0,0,0,1,20,2
Jota Gonçalves,POR,DF,Vizela,23,2000,16.1,17,8,11,5,1,9,22,40.9,13,18,11,7,21,38,97,1
Pedro Gonçalves,POR,"FW,MF",Sporting CP,25,1998,28.6,47,30,10,23,14,20,55,36.4,35,31,2,29,10,57,4,0
Vítor Gonçalves,POR,MF,Farense,31,1992,7.7,10,7,2,4,4,2,4,50.0,2,12,3,9,4,14,17,0
Cristo González,ESP,"FW,MF",Arouca,25,1997,30.9,20,15,4,7,9,9,31,29.0,22,9,1,8,6,26,12,0
Nicolás González,ESP,MF,Porto,21,2002,18.9,42,28,13,21,8,22,38,57.9,16,24,3,21,10,52,11,0
Tiago Gouveia,POR,FW,Benfica,22,2001,6.0,12,7,3,4,5,8,14,57.1,6,7,0,7,1,13,0,0
João Graça,POR,MF,Rio Ave,28,1995,13.3,38,25,13,18,7,20,44,45.5,24,8,3,5,9,47,9,0
Marko Grujić,SRB,MF,Porto,27,1996,3.2,17,13,5,11,1,11,13,84.6,2,4,1,3,6,23,4,0
Gonçalo Guedes,POR,"FW,MF",Benfica,26,1996,1.4,1,0,0,1,0,1,3,33.3,2,0,0,0,1,2,0,0
Guga,POR,"DF,MF",Portimonense,19,2003,17.0,56,34,31,20,5,30,60,50.0,30,18,7,11,16,72,29,0
Ricardo Guimarães,MOZ,MF,Chaves,27,1995,13.9,35,19,20,11,4,18,37,48.6,19,16,5,11,18,53,15,1
Rafik Guitane,FRA,"FW,MF",Estoril,24,1999,30.1,18,9,5,10,3,5,18,27.8,13,18,1,17,7,25,3,0
Raphael Guzzo,POR,"MF,FW",Chaves,28,1995,13.2,13,7,7,3,3,2,11,18.2,9,17,6,11,11,24,13,0
Viktor Gyökeres,SWE,FW,Sporting CP,25,1998,32.4,16,11,3,5,8,3,6,50.0,3,13,1,12,5,21,22,0
Justin de Haas,NED,DF,Famalicão,23,2000,17.8,23,16,17,6,0,11,21,52.4,10,16,12,4,24,47,80,1
Yanis Hamache,ALG,DF,Arouca,24,1999,0.5,1,0,1,0,0,0,0,,0,2,1,1,0,1,1,0
Tomás Händel,POR,MF,Vitória,22,2000,28.0,48,31,16,26,6,28,47,59.6,19,21,3,18,23,71,10,0
Héctor,ESP,FW,Chaves,27,1995,28.8,11,8,3,5,3,5,17,29.4,12,14,3,11,5,16,18,0
Gustavo Henrique,BRA,"DF,MF",Estrela,24,1999,1.4,2,2,2,0,0,2,3,66.7,1,2,0,2,0,2,2,0
Morten Hjulmand,DEN,MF,Sporting CP,24,1999,24.3,60,37,24,28,8,25,43,58.1,18,27,5,22,20,80,25,0
Jordan Holsgrove,SCO,MF,Estoril,23,1999,13.0,30,25,9,18,3,14,24,58.3,10,11,7,4,15,45,19,2
André Horta,POR,MF,Braga,26,1996,6.1,12,8,2,4,6,8,15,53.3,7,12,1,11,1,13,5,0
Ricardo Horta,POR,"FW,MF",Braga,28,1994,26.0,23,13,9,11,3,5,37,13.5,32,23,2,21,11,34,12,0
André Inácio,BRA,"FW,MF",Estrela,21,2002,13.3,19,10,6,9,4,9,24,37.5,15,22,1,21,4,23,8,0
Gonçalo Inácio,POR,DF,Sporting CP,21,2001,27.6,48,35,20,26,2,26,42,61.9,16,29,14,15,25,73,64,1
Hernani Infande,POR,"FW,MF",Moreirense,22,2001,0.9,4,2,1,2,1,3,5,60.0,2,2,0,2,1,5,0,0
Fabrício Isidoro,BRA,MF,Farense,31,1992,18.5,25,10,14,8,3,13,37,35.1,24,27,9,18,22,47,19,0
Ismael,POR,MF,Moreirense,24,1999,6.2,6,1,1,4,1,2,8,25.0,6,8,4,4,7,13,14,0
Franco Israel,URU,GK,Sporting CP,23,2000,10.0,0,0,0,0,0,0,0,,0,0,0,0,0,0,5,1
Abass Issah,GHA,"MF,FW",Chaves,24,1998,3.4,1,0,0,0,1,1,4,25.0,3,2,0,2,0,1,0,0
Léo Jabá,BRA,"FW,MF",Estrela,24,1998,24.7,35,23,12,14,9,11,23,47.8,12,23,2,21,12,47,17,0
Ivan Jaime Pajuelo,ESP,"MF,FW",Porto,22,2000,6.3,11,7,2,5,4,3,8,37.5,5,5,1,4,2,13,2,0
Jajá,BRA,"FW,MF",Casa Pia,22,2001,4.8,19,16,4,7,8,9,16,56.3,7,9,0,9,1,20,2,0
Jardel,GNB,"FW,MF",Vizela,25,1997,2.1,2,1,1,1,0,1,2,50.0,1,0,0,0,2,4,2,0
Jason,ESP,"FW,MF",Arouca,29,1994,28.5,22,17,5,10,7,9,39,23.1,30,29,3,26,12,34,8,0
Sylvester Jasper,BUL,"FW,MF",Portimonense,21,2001,18.6,22,12,9,8,5,10,21,47.6,11,17,0,17,15,37,16,0
Anderson Jesus,BRA,DF,Vizela,28,1995,27.7,33,26,29,4,0,19,35,54.3,16,36,28,8,23,56,124,3
Jhonatan,BRA,GK,Rio Ave,32,1991,26.0,0,0,0,0,0,0,0,,0,0,0,0,1,1,16,3
Jo,BRA,"FW,MF",Chaves,28,1995,11.3,10,6,1,5,4,4,11,36.4,7,6,1,5,1,11,13,0
Joca,POR,"FW,MF",Rio Ave,27,1996,19.0,11,5,4,2,5,8,17,47.1,9,13,1,12,13,24,15,0
Nemanja Jović,SRB,MF,Estoril,20,2002,0.2,0,0,0,0,0,0,1,0.0,1,0,0,0,0,0,0,0
Luiz Lúcio Reis Júnior,BRA,GK,Famalicão,22,2001,33.0,1,0,1,0,0,1,3,33.3,2,1,0,1,1,2,28,2
David Jurásek,CZE,DF,Benfica,22,2000,2.9,9,4,7,2,0,6,8,75.0,2,1,0,1,1,10,9,1
Samuel Justo,POR,MF,Casa Pia,19,2004,6.7,9,6,4,4,1,6,14,42.9,8,7,1,6,4,13,13,0
Kaio,BRA,FW,Vitória,19,2004,4.7,10,8,6,3,1,6,13,46.2,7,8,0,8,0,10,1,0
Kazu,BRA,"DF,FW",Gil Vicente FC,23,2000,0.6,2,0,1,0,1,1,4,25.0,3,0,0,0,2,4,0,0
Keliano,ANG,MF,Estrela,20,2003,1.3,5,3,1,4,0,3,4,75.0,1,6,4,2,4,9,6,1
Kewin,BRA,GK,Moreirense,27,1995,29.8,1,1,1,0,0,0,0,,0,0,0,0,0,1,16,2
Kialonda,ANG,DF,Estrela,25,1997,26.1,53,36,29,20,4,32,41,78.0,9,35,19,16,40,93,146,2
Kikas,POR,"FW,MF",Estrela,24,1998,17.3,3,3,0,2,1,1,2,50.0,1,2,0,2,1,4,13,0
Francisco Kiki,POR,MF,Casa Pia,25,1998,0.1,0,0,0,0,0,0,0,,0,0,0,0,0,0,0,0
Kobamelo Kodisang,RSA,FW,Moreirense,23,1999,18.0,10,6,7,3,0,6,17,35.3,11,12,1,11,16,26,10,0
Koba Koindredi,FRA,MF,Estoril,21,2001,6.3,14,5,11,2,1,7,14,50.0,7,5,1,4,11,25,6,0
Koba Koindredi,FRA,MF,Sporting CP,21,2001,0.4,4,3,0,4,0,2,2,100.0,0,0,0,0,2,6,0,0
Orkun Kökçü,TUR,MF,Benfica,22,2000,19.8,32,22,10,18,4,17,35,48.6,18,15,2,13,8,40,7,1
Eboue Kouassi,CIV,MF,Arouca,25,1997,15.0,26,17,12,11,3,14,27,51.9,13,17,7,10,11,37,39,0
Kevin Krygård,NOR,"MF,DF",Casa Pia,23,2000,0.7,4,1,3,1,0,1,6,16.7,5,3,1,2,3,7,0,0
Matías Lacava,VEN,"FW,MF",Vizela,20,2002,14.8,33,19,18,8,7,14,30,46.7,16,15,0,15,6,39,3,0
Tom Lacoux,FRA,MF,Famalicão,21,2002,4.0,12,8,7,4,1,7,11,63.6,4,9,4,5,6,18,2,0
André Lacximicant,POR,"FW,MF",Casa Pia,22,2001,2.4,4,2,0,2,2,0,0,,0,2,0,2,0,4,1,0
Rúben Lameiras,POR,"FW,MF",Casa Pia,28,1994,6.1,7,5,4,1,2,5,9,55.6,4,4,0,4,4,11,4,0
Rúben Lameiras,POR,"FW,MF",Chaves,28,1994,2.3,2,1,0,2,0,0,0,,0,1,0,1,1,3,2,0
Bruno Langa,MOZ,"DF,MF",Chaves,25,1997,11.9,22,14,8,12,2,8,18,44.4,10,9,2,7,18,40,27,1
Larra,ESP,"DF,MF",Casa Pia,25,1997,27.9,46,36,27,14,5,26,45,57.8,19,28,6,22,43,89,69,0
Yusuf Lawal,NGA,"FW,MF",Arouca,25,1998,2.6,4,2,2,2,0,0,2,0.0,2,4,0,4,3,7,2,0
Orest Lebedenko,UKR,DF,Vizela,24,1998,16.1,35,20,18,16,1,18,29,62.1,11,24,7,17,23,58,58,0
Leonardo Lelo,POR,"DF,MF",Casa Pia,23,2000,32.7,53,32,35,13,5,40,74,54.1,34,35,6,29,37,90,70,0
Marcos Leonardo,BRA,FW,Benfica,20,2003,3.7,2,1,0,0,2,0,0,,0,3,0,3,0,2,1,0
Otso Liimatta,FIN,"MF,FW",Famalicão,19,2004,5.2,6,3,3,2,1,3,9,33.3,6,2,0,2,3,9,0,0
Rúben Lima,POR,"DF,MF",Estrela,33,1989,10.3,14,8,7,6,1,4,11,36.4,7,12,1,11,8,22,36,0
Danny Loader,ENG,"FW,MF",Porto,22,2000,2.7,4,2,0,4,0,1,3,33.3,2,5,0,5,0,4,2,0
Jason Lokilo,BEL,"FW,MF",Vizela,24,1998,7.8,4,3,2,2,0,2,6,33.3,4,3,0,3,0,4,7,0
Julien Lomboto,,MF,Rio Ave,21,2002,0.1,0,0,0,0,0,0,0,,0,1,1,0,0,0,2,0
Miguel Lopes,POR,DF,Estrela,36,1986,14.7,34,24,18,16,0,22,30,73.3,8,21,13,8,18,52,45,1
Né lopes,POR,DF,Gil Vicente FC,23,2000,2.9,4,3,2,1,1,3,3,100.0,0,3,1,2,4,8,12,0
Rony Lopes,POR,"FW,MF",Braga,27,1995,4.1,6,6,1,2,3,3,4,75.0,1,3,1,2,2,8,4,0
Bruno Lourenço,POR,"FW,MF",Boavista,25,1998,22.4,30,15,5,18,7,12,38,31.6,26,11,0,11,15,45,15,0
Thomas Luciano,BRA,DF,Gil Vicente FC,21,2002,0.3,3,1,0,1,2,1,1,100.0,0,1,0,1,0,3,1,0
André Luis,BRA,FW,Moreirense,29,1994,14.8,8,6,2,4,2,4,10,40.0,6,11,3,8,6,14,24,0
Florentino Luís,POR,MF,Benfica,23,1999,18.7,79,45,26,43,10,39,75,52.0,36,36,5,31,49,128,13,0
José Luis Rodríguez,PAN,FW,Famalicão,25,1998,16.6,20,14,12,5,3,16,30,53.3,14,13,3,10,10,30,16,0
Zé Luís,CPV,"FW,MF",Farense,32,1991,6.6,3,3,0,1,2,1,3,33.3,2,9,3,6,1,4,4,0
Luismi,EQG,FW,Moreirense,22,2001,10.4,20,11,7,10,3,7,19,36.8,12,22,3,19,4,24,10,0
Wallisson Luiz,BRA,"MF,FW",Moreirense,25,1997,2.2,13,7,4,5,4,6,10,60.0,4,3,1,2,6,19,11,0
Rodrigo Macedo,POR,"FW,MF",Moreirense,20,2003,0.7,4,2,1,2,1,2,3,66.7,1,1,0,1,0,4,0,0
Tiago Machado,POR,"MF,FW",Boavista,19,2004,0.2,0,0,0,0,0,0,0,,0,0,0,0,0,0,0,0
Madson,BRA,"FW,MF",Moreirense,23,1999,14.9,6,4,2,3,1,1,9,11.1,8,17,0,17,11,17,18,0
Miguel Maga,POR,"DF,MF",Vitória,20,2002,9.9,30,19,17,11,2,21,31,67.7,10,10,2,8,14,44,25,1
Magrão,BRA,GK,Rio Ave,23,2000,7.0,2,1,2,0,0,2,2,100.0,0,0,0,0,0,2,2,1
Gaius Makouta,CGO,MF,Boavista,26,1997,25.9,29,22,11,17,1,14,23,60.9,9,21,2,19,20,49,34,0
Pedro Malheiro,POR,"DF,MF",Boavista,22,2001,21.9,58,33,34,21,3,36,57,63.2,21,27,8,19,24,82,48,1
Eliaquim Mangala,FRA,DF,Estoril,32,1991,11.6,15,7,9,5,1,8,11,72.7,3,11,9,2,21,36,40,1
Ricardo Mangas,POR,"MF,DF",Vitória,25,1998,21.2,25,17,16,7,2,14,27,51.9,13,15,3,12,14,39,27,0
Mansur,BRA,DF,Estrela,30,1993,15.6,27,19,23,4,0,14,18,77.8,4,17,10,7,13,40,43,1
Manuel Manu,POR,"DF,MF",Vitória,22,2001,19.7,50,33,37,12,1,27,50,54.0,23,23,13,10,22,72,78,3
Zé Manuel,POR,"FW,MF",Rio Ave,32,1990,6.6,12,8,3,8,1,5,17,29.4,12,9,0,9,4,16,7,0
Maracás,BRA,DF,Moreirense,29,1994,28.5,44,35,35,8,1,24,34,70.6,10,34,28,6,22,66,150,0
Iván Marcano,ESP,DF,Porto,36,1987,4.1,9,4,5,4,0,5,7,71.4,2,1,1,0,4,13,9,0
Adrián Marín,ESP,DF,Braga,26,1997,3.6,7,3,2,3,2,3,5,60.0,2,6,3,3,6,13,7,0
João Mário,POR,"FW,MF",Benfica,30,1993,26.9,39,27,8,21,10,15,34,44.1,19,24,0,24,16,55,8,0
João Mário Lopes,POR,DF,Porto,23,2000,22.9,33,20,13,16,4,22,44,50.0,22,19,4,15,13,46,18,1
Marlon,BRA,"FW,MF",Gil Vicente FC,25,1997,4.8,4,3,1,2,1,3,12,25.0,9,8,0,8,3,7,5,0
Uladzislaŭ Marozaŭ,BLR,"FW,MF",Arouca,22,2000,1.6,0,0,0,0,0,0,2,0.0,2,1,0,1,0,0,1,0
Alejandro Marqués,VEN,FW,Estoril,22,2000,15.1,10,7,1,8,1,2,9,22.2,7,14,4,10,3,13,15,0
Gustavo Marques,BRA,DF,Benfica,21,2001,0.0,0,0,0,0,0,0,0,,0,0,0,0,1,1,0,0
Igor Marques,BRA,"DF,MF",Portimonense,24,1999,16.5,55,34,25,24,6,23,50,46.0,27,35,5,30,41,96,45,1
João Marques,POR,"MF,FW",Estoril,21,2002,21.9,39,25,5,26,8,11,29,37.9,18,20,2,18,11,50,13,0
Toni Martínez,ESP,FW,Porto,26,1997,5.8,2,1,1,0,1,1,6,16.7,5,2,0,2,0,2,0,0
Rafael Martins,BRA,MF,Casa Pia,34,1989,0.3,0,0,0,0,0,0,0,,0,0,0,0,0,0,0,0
Rodrigo Martins,POR,"DF,FW",Estoril,24,1998,0.1,0,0,0,0,0,0,0,,0,0,0,0,1,1,0,0
Rodrigo Martins,POR,FW,Portimonense,24,1998,2.6,4,3,2,1,1,2,6,33.3,4,1,0,1,0,4,6,0
Matheus,BRA,GK,Braga,31,1992,34.0,1,1,1,0,0,0,2,0.0,2,1,0,1,0,1,20,2
Marco Matias,POR,"FW,MF",Farense,34,1989,25.5,40,26,20,12,8,13,32,40.6,19,19,0,19,22,62,20,0
Nuno Matos,POR,DF,Braga,18,2004,0.1,0,0,0,0,0,0,2,0.0,2,0,0,0,0,0,0,0
Maurício,BRA,MF,Portimonense,34,1988,5.0,11,8,3,8,0,8,14,57.1,6,7,3,4,9,20,11,1
Rodrigo Melro,POR,DF,Chaves,19,2004,0.0,0,0,0,0,0,0,1,0.0,1,0,0,0,0,0,0,0
João Mendes,POR,"FW,MF",Vitória,28,1994,16.0,21,9,5,10,6,10,29,34.5,19,19,1,18,9,30,7,1
João Mendes,POR,DF,Porto,23,2000,3.2,3,2,2,1,0,3,5,60.0,2,5,3,2,2,5,2,0
Joe Mendes,SWE,DF,Braga,20,2002,9.9,18,8,10,6,2,8,17,47.1,9,7,3,4,6,24,20,0
Pedro Mendes,POR,DF,Estrela,32,1990,9.0,13,9,10,2,1,7,12,58.3,5,14,10,4,15,28,42,1
Alex Mendez,USA,"MF,FW",Vizela,22,2000,4.1,6,5,1,4,1,3,4,75.0,1,2,0,2,2,8,1,0
Miguel Menino,POR,MF,Sporting CP,20,2003,0.0,0,0,0,0,0,0,0,,0,1,0,1,0,0,0,0
Benji Michel,USA,"FW,MF",Arouca,25,1997,0.5,0,0,0,0,0,0,0,,0,0,0,0,0,0,1,0
Enea Mihaj,ALB,DF,Famalicão,25,1998,17.3,20,15,14,6,0,14,22,63.6,8,25,19,6,23,43,75,0
Mika,POR,GK,Moreirense,32,1991,0.2,0,0,0,0,0,0,0,,0,0,0,0,0,0,0,0
Bogdan Milovanov,UKR,DF,Arouca,25,1998,13.4,49,30,24,21,4,29,51,56.9,22,12,4,8,13,62,33,0
Vinicius Mingotti,BRA,FW,Moreirense,23,2000,5.4,6,3,1,4,1,0,1,0.0,1,4,0,4,0,6,3,0
Miro,ANG,"FW,MF",Gil Vicente FC,20,2003,1.8,2,2,0,1,1,0,2,0.0,2,1,0,1,1,3,1,0
Cezary Miszta,POL,GK,Rio Ave,21,2001,1.0,0,0,0,0,0,0,0,,0,0,0,0,0,0,2,0
Miguel Monteiro,POR,FW,Gil Vicente FC,20,2003,2.5,0,0,0,0,0,0,1,0.0,1,0,0,0,1,1,2,0
Francisco Montero,ESP,DF,Arouca,24,1999,28.7,28,20,24,4,0,14,35,40.0,21,35,19,16,31,59,137,1
Morato,BRA,DF,Benfica,22,2001,16.9,53,33,33,11,9,37,67,55.2,30,20,5,15,17,70,40,0
Hélder Morim,POR,"MF,DF",Chaves,22,2001,7.3,19,8,8,8,3,7,24,29.2,17,18,7,11,8,27,5,0
Hidemasa Morita,JPN,MF,Sporting CP,28,1995,23.8,55,35,16,32,7,28,58,48.3,30,17,1,16,17,72,25,0
Mosquito,BRA,GK,Arouca,27,1996,2.0,0,0,0,0,0,0,0,,0,0,0,0,0,0,0,0
Moura,POR,DF,Famalicão,23,1999,33.0,55,35,29,13,13,29,41,70.7,12,43,7,36,33,88,79,1
Rodrigo Moura,BRA,GK,Chaves,27,1996,7.0,3,0,3,0,0,3,3,100.0,0,0,0,0,0,3,3,0
João Moutinho,POR,MF,Braga,36,1986,23.5,68,42,24,42,2,31,69,44.9,38,27,8,19,30,98,28,1
Rafa Mújica,ESP,FW,Arouca,24,1998,28.1,22,14,5,8,9,2,13,15.4,11,23,3,20,5,27,16,0
Petar Musa,CRO,FW,Benfica,25,1998,5.8,12,8,4,4,4,3,5,60.0,2,8,2,6,0,12,6,0
Zach Muscat,MLT,DF,Farense,29,1993,18.7,11,4,5,6,0,6,14,42.9,8,42,33,9,15,26,103,0
Almoatasem Al Musrati,LBY,MF,Braga,27,1996,8.9,20,14,9,10,1,9,14,64.3,5,4,2,2,14,34,8,1
Steve Mvoué,CMR,MF,Portimonense,21,2002,0.8,4,1,0,4,0,1,2,50.0,1,1,0,1,0,4,0,0
Kosuke Nakamura,JPN,GK,Portimonense,28,1995,20.0,0,0,0,0,0,0,1,0.0,1,0,0,0,0,0,17,1
Nuno Namora,POR,"DF,MF",Rio Ave,25,1998,0.3,1,0,0,0,1,1,3,33.3,2,0,0,0,0,1,3,0
Davis Nascimento,BRA,MF,Portimonense,20,2002,0.0,0,0,0,0,0,0,1,0.0,1,0,0,0,0,0,0,0
Diogo Nascimento,POR,MF,Vizela,20,2002,24.0,29,19,9,17,3,14,32,43.8,18,17,2,15,10,39,24,0
Nathan,BRA,DF,Famalicão,21,2001,20.5,61,42,39,20,2,27,59,45.8,32,18,1,17,19,80,38,0
Fran Navarro,ESP,"FW,MF",Porto,25,1998,1.9,1,0,1,0,0,0,3,0.0,3,1,0,1,3,4,3,0
Mor Ndiaye,SEN,MF,Estoril,22,2000,2.8,5,3,3,1,1,5,7,71.4,2,2,0,2,1,6,6,0
Alioune Ndour,SEN,"FW,MF",Estrela,22,2001,1.9,4,3,0,2,2,0,1,0.0,1,0,0,0,0,4,2,0
Cher Ndour,ITA,MF,Braga,19,2004,2.3,7,4,4,3,0,1,4,25.0,3,3,1,2,5,12,5,0
Nelson,ANG,"DF,FW",Vitória,25,1998,4.5,10,8,3,4,3,5,11,45.5,6,11,0,11,6,16,4,0
David Neres,BRA,FW,Benfica,26,1997,12.6,12,3,2,8,2,4,11,36.4,7,15,2,13,5,17,2,0
Neto,BRA,MF,Casa Pia,31,1991,25.0,50,32,26,18,6,31,62,50.0,31,37,9,28,22,72,44,0
Luís Neto,POR,DF,Sporting CP,35,1988,1.5,1,0,0,1,0,0,1,0.0,1,2,2,0,1,2,4,0
Martim Neto,POR,MF,Gil Vicente FC,20,2003,20.7,45,23,17,26,2,22,57,38.6,35,25,0,25,18,63,16,1
João Neves,POR,MF,Benfica,18,2004,25.7,65,53,21,26,18,29,63,46.0,34,49,12,37,35,100,38,0
Sikou Niakaté,MLI,DF,Braga,24,1999,16.5,13,9,8,5,0,8,12,66.7,4,13,7,6,16,29,72,2
Miguel Nóbrega,POR,DF,Rio Ave,23,2000,18.0,32,20,17,14,1,20,32,62.5,12,22,12,10,22,54,79,1
Gonçalo Nogueira,POR,MF,Vitória,19,2003,0.1,0,0,0,0,0,0,0,,0,1,0,1,0,0,0,0
Ygor Nogueira,BRA,DF,Chaves,28,1995,18.4,37,25,32,5,0,24,33,72.7,9,22,15,7,27,64,101,0
Nonoca,BRA,MF,Portimonense,25,1998,21.3,82,54,34,41,7,35,49,71.4,14,30,11,19,20,102,30,1
João Nunes,POR,DF,Casa Pia,27,1995,14.7,12,7,8,4,0,8,20,40.0,12,19,11,8,14,26,55,1
Kelechi Nwakali,NGA,MF,Chaves,25,1998,23.0,38,29,7,27,4,20,38,52.6,18,20,2,18,19,57,12,0
Régis N’Do,BFA,"FW,MF",Estrela,22,2001,11.0,16,9,5,8,3,10,25,40.0,15,15,2,13,3,19,4,0
Tashan Oakley-Boothe,ENG,"MF,DF",Estrela,23,2000,0.6,0,0,0,0,0,0,0,,0,0,0,0,1,1,2,0
Lawrence Ofori,GHA,MF,Moreirense,25,1998,27.3,27,13,10,15,2,8,38,21.1,30,22,5,17,17,44,19,1
Hugo Oliveira,POR,"DF,MF",Vizela,21,2002,5.5,8,6,5,2,1,5,8,62.5,3,5,3,2,8,16,15,0
Mattheus Oliveira,BRA,MF,Farense,29,1994,24.8,44,34,24,17,3,19,43,44.2,24,40,8,32,27,71,42,0
Nélson Oliveira,POR,FW,Vitória,31,1991,6.7,4,4,1,3,0,0,1,0.0,1,4,1,3,2,6,3,0
Paulo Oliveira,POR,DF,Braga,31,1992,18.6,34,18,20,13,1,21,31,67.7,10,18,9,9,35,69,79,1
Talys Oliveira,BRA,DF,Farense,24,1999,10.9,18,13,12,5,1,12,23,52.2,11,13,3,10,18,36,43,0
Joneston Omurwa,KEN,DF,Estrela,24,1998,12.7,20,12,13,6,1,12,20,60.0,8,20,12,8,21,41,47,1
Bruno Onyemaechi,NGA,"DF,MF",Boavista,24,1999,21.9,50,37,26,20,4,21,36,58.3,15,28,6,22,24,74,57,0
Jerome Opoku,GHA,DF,Arouca,24,1998,1.5,1,0,0,0,1,0,0,,0,2,0,2,0,1,9,0
Pedro Ortiz,ESP,MF,Vizela,22,2000,10.2,27,15,10,14,3,15,26,57.7,11,9,4,5,7,34,21,0
Nicolás Otamendi,ARG,DF,Benfica,35,1988,30.6,50,36,33,16,1,30,58,51.7,28,30,14,16,53,103,109,3
Otávio,POR,"MF,FW",Porto,28,1995,1.0,0,0,0,0,0,0,3,0.0,3,0,0,0,0,0,0,0
João Othavio Basso,BRA,DF,Estoril,26,1997,13.4,26,18,17,7,2,14,25,56.0,11,16,9,7,16,42,53,0
Amine Oudrhiri,MAR,MF,Rio Ave,30,1992,24.7,34,22,8,21,5,19,34,55.9,15,22,4,18,30,64,20,3
Pablo,BRA,"FW,MF",Famalicão,19,2004,2.2,3,3,3,0,0,2,4,50.0,2,4,1,3,1,4,3,0
Lucas Paes,BRA,GK,Casa Pia,25,1997,3.0,0,0,0,0,0,0,1,0.0,1,0,0,0,0,0,0,0
Renato Pantalon,CRO,DF,Rio Ave,25,1997,14.9,22,10,11,10,1,11,16,68.8,5,15,8,7,9,31,54,0
Raúl Parra,ESP,DF,Estoril,23,1999,6.3,8,5,6,2,0,4,9,44.4,5,3,2,1,2,10,9,0
David Pastor,BRA,DF,Farense,23,2000,27.5,55,34,34,19,2,31,60,51.7,29,32,7,25,50,105,83,0
Patrick,BRA,DF,Rio Ave,26,1997,12.4,18,8,14,4,0,12,21,57.1,9,9,2,7,26,44,44,0
Paulinho,POR,"FW,MF",Portimonense,23,1999,1.9,0,0,0,0,0,0,0,,0,0,0,0,0,0,3,0
Paulinho,POR,"FW,MF",Sporting CP,30,1992,14.5,18,14,1,9,8,5,16,31.3,11,15,1,14,2,20,6,0
Ivan Pavlic,BEL,MF,Estoril,21,2001,2.0,4,2,3,1,0,4,6,66.7,2,1,0,1,1,5,2,0
Pedrão,BRA,DF,Portimonense,26,1997,29.3,48,29,34,12,2,22,38,57.9,16,32,17,15,50,98,136,0
Zé Pedro Figueiredo,POR,DF,Porto,26,1997,10.3,15,7,8,6,1,10,17,58.8,7,5,2,3,9,24,31,0
João Pedro,POR,MF,Chaves,30,1993,4.5,7,4,3,3,1,7,15,46.7,8,3,2,1,3,10,5,0
Pepe,POR,DF,Porto,40,1983,20.9,28,16,16,12,0,16,30,53.3,14,13,8,5,19,47,50,1
Pepê,BRA,"MF,DF",Porto,26,1997,31.7,26,18,8,12,6,9,33,27.3,24,30,2,28,22,48,16,0
André Pereira,POR,FW,Rio Ave,28,1995,6.5,10,7,1,8,1,4,10,40.0,6,9,0,9,2,12,5,0
Gabriel Pereira,BRA,DF,Gil Vicente FC,23,2000,30.9,34,24,25,6,3,26,38,68.4,12,42,30,12,26,60,130,0
Hildeberto Pereira,POR,FW,Portimonense,27,1996,9.4,2,2,2,0,0,0,12,0.0,12,10,1,9,2,4,3,0
Matheus Pereira,BRA,"DF,FW",Vizela,22,2000,23.3,26,16,12,11,3,11,23,47.8,12,29,6,23,20,46,38,0
Sebastián Pérez Cardona,COL,MF,Boavista,30,1993,24.3,74,39,41,30,3,39,68,57.4,29,30,8,22,22,96,26,1
Sava Petrov,SRB,"FW,MF",Vizela,25,1998,5.7,0,0,0,0,0,0,3,0.0,3,5,2,3,0,0,8,0
Thibang Phete,RSA,"DF,MF",Chaves,29,1994,4.9,5,3,2,2,1,3,5,60.0,2,5,3,2,8,13,18,0
Wagner Pina,CPV,"MF,DF",Estoril,20,2002,12.2,34,24,22,10,2,23,29,79.3,6,24,5,19,8,42,29,0
Pedro Pinho,POR,MF,Chaves,23,2000,2.8,9,2,4,3,2,3,7,42.9,4,6,4,2,9,18,7,0
Rodrigo Pinho,BRA,FW,Estrela,32,1991,3.5,2,2,1,1,0,0,1,0.0,1,2,0,2,1,3,1,0
Alexandre Pinto,POR,DF,Gil Vicente FC,25,1998,11.8,25,17,13,10,2,14,24,58.3,10,6,1,5,15,40,57,1
Dinis Pinto,POR,DF,Moreirense,22,2000,10.4,20,12,10,6,4,10,14,71.4,4,10,3,7,8,28,24,0
Diogo Pinto,POR,MF,Casa Pia,24,1999,0.1,0,0,0,0,0,0,0,,0,0,0,0,0,0,0,0
Diogo Pinto,POR,GK,Sporting CP,19,2004,1.9,0,0,0,0,0,0,0,,0,0,0,0,0,0,0,0
Gonçalo Pinto,POR,GK,Chaves,23,2000,1.0,0,0,0,0,0,0,0,,0,0,0,0,0,0,0,0
Junior Pius,NGA,DF,Chaves,27,1995,12.8,45,33,31,12,2,28,42,66.7,14,23,7,16,18,63,53,0
Pizzi,POR,"MF,FW",Braga,33,1989,10.7,6,4,4,1,1,2,8,25.0,6,8,0,8,3,9,6,1
Carlos Ponck,CPV,DF,Moreirense,28,1995,11.5,20,17,12,8,0,14,17,82.4,3,16,10,6,12,32,61,2
Cristian Ponde,POR,"MF,FW",Farense,28,1995,2.5,5,3,2,3,0,1,5,20.0,4,6,1,5,3,8,2,0
Rafael Pontelo,BRA,DF,Sporting CP,20,2003,0.0,0,0,0,0,0,0,0,,0,0,0,0,0,0,0,0
Gianluca Prestianni,ARG,MF,Benfica,17,2006,0.0,0,0,0,0,0,0,1,0.0,1,0,0,0,0,0,0,0
Miguel Puche García,ESP,"FW,MF",Arouca,22,2001,3.4,6,2,5,1,0,4,5,80.0,1,1,0,1,1,7,1,0
Quaresma,BRA,DF,Arouca,26,1996,3.3,8,6,4,3,1,6,13,46.2,7,5,1,4,5,13,6,1
Eduardo Quaresma,POR,DF,Sporting CP,21,2002,10.7,28,18,15,12,1,13,20,65.0,7,11,7,4,9,37,23,0
João Queirós,POR,DF,Chaves,25,1998,2.6,4,2,3,1,0,3,4,75.0,1,2,1,1,4,8,6,1
Domingos Quina,POR,"FW,MF",Vizela,23,1999,8.1,18,9,1,14,3,4,12,33.3,8,11,0,11,4,22,5,0
Cláudio Ramos,POR,GK,Porto,31,1991,1.3,0,0,0,0,0,0,0,,0,0,0,0,1,1,0,0
Osama Rashid,IRQ,"MF,FW",Vizela,31,1992,0.3,0,0,0,0,0,0,1,0.0,1,0,0,0,1,1,2,0
Miguel Rebelo,POR,MF,Moreirense,19,2003,0.0,0,0,0,0,0,0,0,,0,0,0,0,0,0,0,0
João Rêgo,POR,MF,Benfica,18,2005,0.1,0,0,0,0,0,0,0,,0,0,0,0,0,0,0,0
João Reis,POR,"DF,MF",Estrela,31,1992,16.1,40,24,24,13,3,25,51,49.0,26,27,2,25,24,64,45,0
Matheus Reis,BRA,"DF,MF",Sporting CP,28,1995,15.8,20,13,7,11,2,15,24,62.5,9,16,3,13,9,29,27,0
Miguel Reisinho,POR,MF,Boavista,24,1999,23.3,48,30,14,29,5,22,48,45.8,26,22,8,14,21,69,37,2
Filipe Relvas,POR,DF,Portimonense,23,1999,31.1,56,32,43,13,0,28,46,60.9,18,48,25,23,58,114,140,1
Rúben Tiago Rodrigues Ribeiro,POR,"FW,MF",Chaves,35,1987,18.7,23,14,14,7,2,12,20,60.0,8,12,0,12,12,35,11,0
Tomás Ribeiro,POR,DF,Vitória,24,1999,27.0,33,17,16,14,3,19,34,55.9,15,36,17,19,21,54,88,0
Riccieli,BRA,DF,Famalicão,24,1998,19.7,23,14,17,6,0,15,29,51.7,14,26,13,13,13,36,84,0
Rildo,BRA,"FW,MF",Portimonense,23,2000,5.7,5,3,0,5,0,1,3,33.3,2,9,0,9,1,6,3,0
Mihailo Ristić,SRB,DF,Benfica,27,1995,0.0,1,0,1,0,0,0,0,,0,0,0,0,0,1,0,0
Pablo Roberto,BRA,"MF,FW",Casa Pia,23,1999,18.5,25,13,4,19,2,13,33,39.4,20,18,1,17,17,42,9,1
Matí­as Rocha,URU,DF,Arouca,22,2001,6.2,6,4,3,3,0,5,8,62.5,3,2,2,0,6,12,26,0
Afonso Rodrigues,POR,"FW,MF",Famalicão,20,2002,2.6,4,0,0,2,2,2,5,40.0,3,4,0,4,2,6,4,0
Bruno Rodrigues,POR,DF,Chaves,22,2001,15.0,14,8,11,1,2,9,13,69.2,4,15,3,12,18,32,47,0
Gonçalo Rodrigues,POR,MF,Rio Ave,26,1997,13.7,22,12,3,15,4,10,27,37.0,17,8,0,8,4,26,8,0
Benjamín Rollheiser,ARG,FW,Benfica,23,2000,1.7,0,0,0,0,0,0,1,0.0,1,3,1,2,0,0,1,0
Ronald,BRA,"MF,FW",Estrela,22,2001,14.7,14,8,3,7,4,7,18,38.9,11,13,0,13,4,18,6,0
Igor Rossi Branco,BRA,DF,Farense,34,1989,11.3,8,6,7,0,1,6,7,85.7,1,4,4,0,12,20,64,1
Francesco Ruberto,SUI,GK,Vizela,30,1993,6.3,0,0,0,0,0,0,2,0.0,2,0,0,0,0,0,3,1
Abel Ruiz,ESP,"FW,MF",Braga,23,2000,21.1,8,6,1,4,3,4,8,50.0,4,6,1,5,6,14,12,0
Leonardo Ruíz,COL,FW,Rio Ave,27,1996,8.3,6,6,2,3,1,5,12,41.7,7,3,1,2,4,10,13,0
Gustavo sá,POR,MF,Famalicão,18,2004,20.4,37,22,6,22,9,12,40,30.0,28,16,5,11,12,49,31,0
Helder Sá,POR,"DF,MF",Rio Ave,20,2002,0.5,0,0,0,0,0,0,1,0.0,1,2,2,0,0,0,4,0
Josué Sá,POR,DF,Rio Ave,31,1992,21.8,30,20,18,11,1,16,26,61.5,10,24,11,13,23,53,78,0
Pedro Sá,POR,MF,Estrela,29,1993,7.2,9,4,4,5,0,3,10,30.0,7,4,2,2,6,15,7,0
Serdar Saatçı,TUR,DF,Braga,20,2003,16.6,27,17,18,9,0,17,24,70.8,7,17,10,7,38,65,46,3
Safira,BRA,FW,Vitória,28,1995,1.6,4,2,2,2,0,1,1,100.0,0,2,0,2,0,4,3,0
Dylan Saint-Louis,CGO,"FW,MF",Vizela,28,1995,2.9,5,2,3,1,1,3,6,50.0,3,3,1,2,1,6,2,0
Samu,POR,MF,Vizela,27,1996,30.7,70,37,32,27,11,34,78,43.6,44,54,12,42,20,90,48,0
Leandro Sanca,GNB,"FW,MF",Chaves,23,2000,16.3,17,5,5,9,3,6,29,20.7,23,25,1,24,9,26,8,0
Aderlan Santos,BRA,DF,Rio Ave,34,1989,31.6,68,44,50,18,0,34,47,72.3,13,58,40,18,45,113,167,1
Hevertton Santos,BRA,"DF,MF",Estrela,22,2001,21.9,25,18,12,10,3,18,29,62.1,11,27,7,20,20,45,53,0
Luís Santos,POR,"DF,FW",Boavista,23,2000,7.6,17,9,13,3,1,10,16,62.5,6,8,3,5,11,28,23,0
Nuno Santos,POR,"FW,MF",Vitória,24,1999,10.7,10,6,3,7,0,5,26,19.2,21,12,0,12,5,15,5,0
Nuno Santos,POR,"MF,DF",Sporting CP,28,1995,22.9,26,18,8,12,6,9,22,40.9,13,8,1,7,25,51,13,1
Pedro Santos,POR,MF,Arouca,22,2000,16.1,29,20,8,18,3,18,45,40.0,27,19,1,18,11,40,8,0
Zaidu Sanusi,NGA,DF,Porto,26,1997,3.2,3,2,1,2,0,2,3,66.7,1,4,2,2,4,7,4,0
Vincent Sasso,FRA,DF,Boavista,32,1991,14.2,23,10,13,9,1,13,23,56.5,10,20,13,7,14,37,69,3
Savio,BRA,"DF,MF",Rio Ave,28,1995,2.8,4,2,2,2,0,3,8,37.5,5,3,1,2,2,6,6,2
Caio Secco,BRA,GK,Moreirense,32,1990,4.0,0,0,0,0,0,0,0,,0,0,0,0,0,0,1,0
Moustapha Seck,SEN,"DF,MF",Portimonense,27,1996,9.8,29,19,17,9,3,15,19,78.9,4,17,6,11,11,40,28,0
Telasco Segovia,VEN,MF,Casa Pia,20,2003,8.3,29,19,12,16,1,15,31,48.4,16,7,1,6,15,44,6,0
Artur Serobyan,ARM,MF,Casa Pia,20,2003,0.7,1,1,0,1,0,1,2,50.0,1,0,0,0,1,2,1,0
André Seruca,POR,MF,Farense,22,2000,0.4,3,2,3,0,0,2,2,100.0,0,2,0,2,0,3,0,0
Nkanyiso Shinga,RSA,"DF,MF",Estrela,23,2000,5.7,12,11,4,5,3,10,12,83.3,2,12,7,5,7,19,20,1
Adrien Silva,POR,MF,Rio Ave,34,1989,3.8,13,4,4,7,2,4,10,40.0,6,6,0,6,5,18,7,1
André Silva,BRA,FW,Vitória,26,1997,19.7,19,10,3,12,4,8,13,61.5,5,20,1,19,5,24,17,0
António Silva,POR,DF,Benfica,19,2003,29.1,64,43,34,24,6,33,42,78.6,9,47,24,23,23,87,91,0
Francisco Silva,POR,GK,Sporting CP,17,2005,0.1,0,0,0,0,0,0,0,,0,0,0,0,0,0,0,0
Gonçalo Silva,POR,DF,Farense,32,1991,32.0,36,21,29,7,0,22,35,62.9,13,45,32,13,39,75,231,1
Joel silva,POR,MF,Boavista,20,2003,4.1,11,7,3,7,1,5,12,41.7,7,6,1,5,3,14,5,0
Jota Silva,POR,"FW,MF",Vitória,23,1999,30.9,35,18,12,14,9,11,43,25.6,32,34,2,32,17,52,28,0
Felipe Silva Lipe,BRA,DF,Gil Vicente FC,21,2002,3.0,7,2,4,3,0,5,7,71.4,2,3,2,1,2,9,8,0
Pedro Manuel da Silva Moreira,POR,MF,Arouca,34,1989,0.5,1,0,0,0,1,0,0,,0,0,0,0,0,1,0,0
Rafa Silva,POR,"MF,FW",Benfica,30,1993,27.5,23,12,10,7,6,10,32,31.3,22,11,0,11,7,30,4,0
Tiago Silva,POR,MF,Vitória,30,1993,25.9,45,30,14,24,7,22,46,47.8,24,17,1,16,27,72,13,0
Vinicius Silvestre,BRA,GK,Portimonense,29,1994,14.0,0,0,0,0,0,0,3,0.0,3,0,0,0,0,0,10,1
David Simão,POR,MF,Arouca,33,1990,28.4,47,28,22,21,4,28,63,44.4,35,40,9,31,34,81,22,3
André Simões,POR,FW,Gil Vicente FC,19,2003,0.2,0,0,0,0,0,0,1,0.0,1,0,0,0,0,0,0,0
Alexandre Miguel Barros Soares,POR,MF,Estoril,32,1991,2.8,9,4,2,6,1,4,6,66.7,2,2,1,1,3,12,3,0
Filipe Soares,POR,MF,Famalicão,24,1999,1.9,4,2,1,1,2,1,3,33.3,2,0,0,0,0,4,1,0
Samuel Soares,POR,GK,Benfica,21,2002,5.0,0,0,0,0,0,0,0,,0,0,0,0,0,0,2,0
Yuki Soma,JPN,"FW,MF",Casa Pia,26,1997,21.0,21,15,6,11,4,7,21,33.3,14,12,1,11,4,25,11,0
Alberto Soro,ESP,"FW,MF",Vizela,24,1999,10.0,21,13,9,8,4,6,16,37.5,10,10,0,10,1,22,8,0
Gonçalo Sousa,POR,FW,Porto,17,2006,0.1,0,0,0,0,0,0,0,,0,0,0,0,0,0,1,0
Aloísio Souza Genézio,BRA,MF,Estrela,27,1996,16.6,44,30,13,27,4,19,46,41.3,27,16,4,12,24,68,20,0
Hugo Souza,BRA,GK,Chaves,24,1999,26.0,0,0,0,0,0,0,1,0.0,1,0,0,0,0,0,16,2
Jose Souza,POR,MF,Portimonense,22,2001,0.1,0,0,0,0,0,0,1,0.0,1,1,0,1,0,0,0,0
Diogo Spencer,POR,DF,Benfica,19,2004,0.0,0,0,0,0,0,0,0,,0,0,0,0,0,0,0,0
Jerry St. Juste,NED,DF,Sporting CP,26,1996,6.0,13,5,7,5,1,5,9,55.6,4,5,0,5,6,19,8,0
Harouna Sy,FRA,FW,Estoril,27,1996,0.1,0,0,0,0,0,0,0,,0,0,0,0,0,0,1,0
Habib sylla,CIV,DF,Chaves,24,1999,4.5,6,2,3,2,1,2,3,66.7,1,9,2,7,1,7,16,0
Morlaye Sylla,GUI,"MF,FW",Arouca,25,1998,28.7,69,41,24,31,14,38,73,52.1,35,42,3,39,27,96,17,0
Talocha,POR,DF,Farense,33,1989,22.9,36,26,21,13,2,18,25,72.0,7,31,13,18,26,62,87,0
Tamble,POR,FW,Portimonense,22,2000,4.0,0,0,0,0,0,0,2,0.0,2,3,3,0,1,1,3,0
Mateo Tanlongo,ARG,MF,Rio Ave,19,2003,6.8,18,8,6,9,3,5,15,33.3,10,4,1,3,8,26,1,0
Mehdi Taremi,IRN,"FW,MF",Porto,31,1992,16.4,24,15,8,9,7,8,24,33.3,16,14,3,11,7,31,21,0
Heriberto Tavares,POR,"FW,MF",Estoril,26,1997,13.9,14,9,7,5,2,4,18,22.2,14,6,0,6,4,18,5,2
Martim Tavares,POR,"FW,MF",Boavista,19,2003,6.0,4,3,1,3,0,1,4,25.0,3,6,3,3,2,6,4,0
Ronaldo Tavares,POR,FW,Estrela,26,1997,12.8,9,4,2,4,3,2,4,50.0,2,10,1,9,2,11,15,0
Duplexe Tchamba,CMR,DF,Casa Pia,25,1998,13.9,23,14,17,5,1,16,26,61.5,10,14,6,8,18,41,79,1
João Teixeira,POR,"MF,FW",Rio Ave,29,1994,8.0,17,10,9,7,1,9,21,42.9,12,14,2,12,4,21,5,0
Casper Tengstedt,DEN,FW,Benfica,23,2000,7.4,11,5,2,5,4,7,12,58.3,5,6,0,6,0,11,2,0
Pedro Tiba,POR,MF,Gil Vicente FC,34,1988,16.6,46,35,23,15,8,22,44,50.0,22,15,4,11,15,61,17,0
Mirko Topić,SRB,MF,Famalicão,22,2001,26.1,51,39,24,24,3,22,32,68.8,10,27,4,23,47,98,47,1
Alfonso Trezza,URU,"FW,MF",Arouca,24,1999,9.3,17,14,11,6,0,7,24,29.2,17,15,0,15,6,23,8,0
Francisco Trincão,POR,"FW,MF",Sporting CP,23,1999,18.9,28,19,8,16,4,9,24,37.5,15,13,2,11,4,32,8,0
Anatolii Trubin,UKR,GK,Benfica,21,2001,28.0,1,1,1,0,0,1,2,50.0,1,0,0,0,1,2,10,3
Ukra,POR,"FW,MF",Rio Ave,35,1988,0.9,0,0,0,0,0,0,1,0.0,1,0,0,0,0,0,0,0
Iker Unzueta,ESP,FW,Vizela,24,1998,0.3,0,0,0,0,0,0,0,,0,0,0,0,0,0,0,0
João Valido,POR,GK,Arouca,23,2000,1.0,1,1,1,0,0,1,2,50.0,1,0,0,0,0,1,2,0
Alan Varela,ARG,MF,Porto,22,2001,24.7,36,20,11,21,4,15,35,42.9,20,32,8,24,23,59,28,0
Bruno Varela,CPV,GK,Vitória,28,1994,26.5,0,0,0,0,0,0,1,0.0,1,0,0,0,0,0,9,1
Fernando Varela,CPV,DF,Casa Pia,35,1987,23.0,28,20,20,7,1,15,23,65.2,8,33,19,14,17,45,113,0
Gustavo Varela,POR,FW,Benfica,18,2005,0.2,0,0,0,0,0,0,0,,0,0,0,0,0,0,0,0
Hélio Varela,CPV,"FW,MF",Portimonense,21,2002,30.5,35,22,19,10,6,14,39,35.9,25,29,4,25,15,50,31,0
Nilton Varela,POR,"DF,MF",Estrela,22,2001,6.2,20,15,15,5,0,16,22,72.7,6,5,1,4,4,24,9,0
Jhon Velásquez,COL,"FW,MF",Farense,28,1995,0.3,0,0,0,0,0,0,1,0.0,1,0,0,0,0,0,1,0
Ricardo Velho,POR,GK,Farense,24,1998,32.0,0,0,0,0,0,0,1,0.0,1,0,0,0,0,0,21,2
Bruno Ventura,POR,"FW,MF",Rio Ave,22,2001,5.8,3,1,2,0,1,2,7,28.6,5,3,0,3,2,5,7,0
João Victor,BRA,DF,Benfica,25,1998,0.3,0,0,0,0,0,0,0,,0,2,1,1,1,1,0,0
Paulo Victor,BRA,"FW,MF",Chaves,22,2001,9.1,14,8,4,10,0,5,9,55.6,4,15,2,13,6,20,5,0
Kiko Vilas Boas,POR,DF,Gil Vicente FC,23,1999,6.3,18,11,11,7,0,8,11,72.7,3,3,0,3,7,25,26,0
Mikel Villanueva,VEN,DF,Vitória,30,1993,5.1,4,3,1,1,2,3,4,75.0,1,8,5,3,8,12,16,0
Marcos Vinicios Sorriso,BRA,"FW,MF",Famalicão,22,2001,9.5,14,9,4,8,2,8,17,47.1,9,11,0,11,7,21,11,0
Bernardo Vital,POR,DF,Estoril,22,2000,28.3,39,21,24,14,1,23,40,57.5,17,38,24,14,23,62,107,2
Vitinho,BRA,"FW,MF",Arouca,23,2000,1.1,4,4,3,0,1,1,3,33.3,2,2,0,2,2,6,1,0
Steven Vitória,CAN,DF,Chaves,36,1987,15.0,11,8,8,3,0,8,9,88.9,1,17,14,3,4,15,75,3
Odisseas Vlachodimos,GRE,GK,Benfica,29,1994,1.0,0,0,0,0,0,0,0,,0,0,0,0,0,0,0,0
Marious Vrousai,GRE,"MF,DF",Rio Ave,25,1998,7.4,20,13,9,9,2,10,18,55.6,8,15,3,12,6,26,18,0
Ilija Vukotić,MNE,MF,Boavista,24,1999,11.1,22,16,8,10,4,13,25,52.0,12,7,4,3,3,25,27,0
Masaki Watai,JPN,"FW,MF",Boavista,24,1999,4.8,8,4,4,2,2,2,10,20.0,8,4,0,4,5,13,2,0
Wendell,BRA,DF,Porto,30,1993,23.3,40,23,16,23,1,21,37,56.8,16,21,3,18,14,54,42,0
Weverson,BRA,DF,Arouca,23,2000,22.2,53,29,25,24,4,34,48,70.8,14,28,6,22,17,70,46,0
Bruno Wilson,POR,DF,Vizela,26,1996,15.6,15,8,9,5,1,11,14,78.6,3,20,14,6,19,34,62,0
Roan Wilson,CRC,"MF,DF",Gil Vicente FC,21,2002,1.4,8,4,2,6,0,4,6,66.7,2,3,0,3,2,10,3,0
Frederik Winther,DEN,DF,Estoril,22,2001,1.3,0,0,0,0,0,0,1,0.0,1,0,0,0,0,0,9,1
Abdul-Aziz Yakubu,GHA,FW,Rio Ave,24,1998,12.4,2,2,0,2,0,1,8,12.5,7,3,2,1,0,2,17,0
Moses Yaw,GHA,"DF,MF",Arouca,24,1999,0.8,1,1,1,0,0,1,1,100.0,0,1,0,1,0,1,1,0
Zaydou Youssouf,FRA,MF,Famalicão,24,1999,30.7,76,48,34,32,10,28,60,46.7,32,32,2,30,27,103,25,0
Rodrigo Zalazar,URU,MF,Braga,23,1999,20.2,40,27,11,24,5,18,42,42.9,24,33,3,30,9,49,16,3
Vinícius Zanocelo,BRA,MF,Estoril,22,2001,12.4,18,9,9,8,1,8,21,38.1,13,7,2,5,10,28,25,0
Zinho,BRA,"FW,MF",Portimonense,20,2003,1.6,4,3,1,1,2,3,4,75.0,1,2,0,2,1,5,1,0
Ivan Zlobin,RUS,GK,Famalicão,26,1997,1.0,0,0,0,0,0,0,0,,0,0,0,0,0,0,0,0
Nermin Zolotić,BIH,DF,Casa Pia,30,1993,29.7,41,29,26,14,1,32,49,65.3,17,40,22,18,28,69,127,2
