Player,Nation,Pos,Squad,Comp,Age,Born,90s,Tackles,TacklesWon,TacklesDef3rd,TacklesMid3rd,TacklesAtt3rd,DribTkl,DribTklAtt,DribTkl%,ChallengesLost,Blocks,ShotsBlocked,PassesBlocked,Int,Tkl+Int,Clr,ErrorsLeadingToShot
Max Aarons,ENG,DF,Bournemouth,Premier League,23,2000,13.7,29,19,20,7,2,20,34,58.8,14,9,5,4,8,37,27,0
Brenden Aaronson,USA,"MF,FW",Union Berlin,Bundesliga,22,2000,14.1,32,18,13,13,6,16,32,50.0,16,26,1,25,2,34,4,0
Paxten Aaronson,USA,MF,Eint Frankfurt,Bundesliga,19,2003,1.1,2,2,1,1,0,1,1,100.0,0,2,0,2,0,2,0,0
Keyliane Abdallah,FRA,FW,Marseille,Ligue 1,17,2006,0.0,0,0,0,0,0,0,0,,0,0,0,0,0,0,0,0
Yunis Abdelhamid,MAR,DF,Reims,Ligue 1,35,1987,30.9,64,35,36,23,5,26,45,57.8,19,51,32,19,39,103,109,2
Salis Abdul Samed,GHA,MF,Lens,Ligue 1,23,2000,16.9,21,14,8,10,3,8,18,44.4,10,12,1,11,12,33,18,0
Nabil Aberdin,FRA,DF,Getafe,La Liga,20,2002,2.0,0,0,0,0,0,0,1,0.0,1,0,0,0,0,0,4,0
Laurent Abergel,FRA,MF,Lorient,Ligue 1,30,1993,31.8,85,52,43,34,8,38,96,39.6,58,29,6,23,61,146,61,3
Matthis Abline,FRA,FW,Nantes,Ligue 1,20,2003,11.6,9,4,4,3,2,3,8,37.5,5,3,0,3,3,12,5,0
Abner,BRA,DF,Betis,La Liga,23,2000,15.6,25,19,15,9,1,17,34,50.0,17,23,5,18,15,40,62,0
Zakaria Aboukhlal,MAR,"MF,FW",Toulouse,Ligue 1,23,2000,8.4,9,8,1,5,3,3,12,25.0,9,9,1,8,1,10,2,0
Abdel Abqar,MAR,DF,Alavés,La Liga,24,1999,25.7,35,19,28,5,2,21,35,60.0,14,31,26,5,23,58,115,0
Tammy Abraham,ENG,FW,Roma,Serie A,25,1997,2.7,3,1,0,1,2,0,0,,0,1,0,1,0,3,4,0
Francesco Acerbi,ITA,DF,Inter,Serie A,35,1988,26.5,22,13,16,6,0,11,14,78.6,3,20,13,7,32,54,77,1
Joshua Acheampong,ENG,DF,Chelsea,Premier League,17,2006,0.1,0,0,0,0,0,0,0,,0,3,3,0,0,0,0,0
Marcos Acuña,ARG,DF,Sevilla,La Liga,31,1991,14.4,33,21,20,12,1,9,14,64.3,5,12,2,10,4,37,25,0
Akor Adams,NGA,FW,Montpellier,Ligue 1,23,2000,25.0,12,4,3,4,5,3,7,42.9,4,9,2,7,5,17,11,0
Tyler Adams,USA,MF,Bournemouth,Premier League,24,1999,1.3,4,3,1,3,0,2,3,66.7,1,2,0,2,4,8,2,0
Junior Adamu,AUT,"FW,MF",Freiburg,Bundesliga,22,2001,1.2,5,1,1,2,2,1,2,50.0,1,1,0,1,0,5,2,0
Sargis Adamyan,ARM,"FW,MF",Köln,Bundesliga,30,1993,8.9,14,9,2,9,3,6,11,54.5,5,16,1,15,5,19,7,0
Tosin Adarabioyo,ENG,DF,Fulham,Premier League,25,1997,18.0,21,11,16,5,0,12,21,57.1,9,16,11,5,25,46,80,0
Elijah Adebayo,ENG,FW,Luton Town,Premier League,25,1998,15.8,4,1,1,0,3,1,12,8.3,11,13,2,11,6,10,25,0
Karim Adeyemi,GER,"FW,MF",Dortmund,Bundesliga,21,2002,10.1,16,14,9,4,3,8,20,40.0,12,11,0,11,3,19,5,0
Simon Adingra,CIV,FW,Brighton,Premier League,21,2002,24.7,45,20,23,11,11,19,42,45.2,23,31,1,30,19,64,22,0
Nathaniel Adjei,GHA,DF,Lorient,Ligue 1,20,2002,13.8,13,9,8,3,2,6,7,85.7,1,15,8,7,18,31,64,1
Amine Adli,MAR,"MF,FW",Leverkusen,Bundesliga,23,2000,10.0,16,7,2,10,4,7,17,41.2,10,10,2,8,6,22,5,0
Yacine Adli,FRA,MF,Milan,Serie A,23,2000,15.6,34,17,17,13,4,13,35,37.1,22,22,8,14,20,54,15,1
Adryelson,BRA,"DF,FW",Lyon,Ligue 1,25,1998,0.1,0,0,0,0,0,0,0,,0,0,0,0,1,1,3,0
Adson,BRA,"MF,FW",Nantes,Ligue 1,22,2000,2.6,7,6,1,6,0,2,2,100.0,0,5,0,5,2,9,2,0
Michel Aebischer,SUI,MF,Bologna,Serie A,26,1997,24.8,35,20,9,20,6,15,34,44.1,19,28,6,22,12,47,22,0
Emmanuel Agbadou,CIV,DF,Reims,Ligue 1,26,1997,28.8,65,41,38,23,4,44,64,68.8,20,47,25,22,55,120,116,1
Julen Agirrezabala,ESP,GK,Athletic Club,La Liga,22,2000,2.6,0,0,0,0,0,0,0,,0,0,0,0,0,0,0,0
Lucien Agoume,FRA,MF,Inter,Serie A,21,2002,0.1,0,0,0,0,0,0,0,,0,0,0,0,0,0,0,0
Lucien Agoume,FRA,MF,Sevilla,La Liga,21,2002,8.6,23,18,7,14,2,9,12,75.0,3,6,1,5,7,30,8,0
Felix Agu,GER,"DF,MF",Werder Bremen,Bundesliga,23,1999,17.9,45,29,28,13,4,29,41,70.7,12,27,7,20,13,58,41,0
Nayef Aguerd,MAR,DF,West Ham,Premier League,27,1996,20.6,26,14,19,7,0,16,22,72.7,6,33,24,9,17,43,85,2
Ruben Aguilar,FRA,DF,Lens,Ligue 1,30,1993,21.4,53,31,27,23,3,27,45,60.0,18,35,5,30,26,79,46,0
Brandon Aguilera,CRC,FW,Nott'ham Forest,Premier League,20,2003,0.1,0,0,0,0,0,0,0,,0,0,0,0,0,0,0,0
Naouirou Ahamada,FRA,"MF,FW",Crystal Palace,Premier League,21,2002,3.9,13,9,5,6,2,8,17,47.1,9,3,0,3,2,15,4,0
Anel Ahmedhodžić,BIH,DF,Sheffield Utd,Premier League,24,1999,29.4,64,36,48,14,2,30,49,61.2,19,43,26,17,35,99,137,2
Joseph Aidoo,GHA,DF,Celta Vigo,La Liga,27,1995,4.5,8,3,6,2,0,4,8,50.0,4,3,1,2,4,12,28,0
Ola Aina,NGA,DF,Nott'ham Forest,Premier League,26,1996,18.8,47,31,31,12,4,29,41,70.7,12,19,3,16,18,65,51,1
Rayan Aït-Nouri,ALG,"DF,MF",Wolves,Premier League,22,2001,25.9,71,44,41,23,7,28,49,57.1,21,32,6,26,15,86,38,0
Tosin Aiyegun,BEN,"MF,FW",Lorient,Ligue 1,25,1998,10.0,6,4,2,3,1,3,9,33.3,6,4,1,3,2,8,8,0
Kristoffer Ajer,NOR,DF,Brentford,Premier League,25,1998,20.4,38,21,25,9,4,23,36,63.9,13,26,11,15,25,63,79,1
Ludovic Ajorque,FRA,FW,Mainz 05,Bundesliga,29,1994,15.1,3,2,1,2,0,2,11,18.2,9,6,2,4,4,7,11,0
Manuel Akanji,SUI,"DF,MF",Manchester City,Premier League,28,1995,27.9,42,28,16,18,8,22,39,56.4,17,28,12,16,23,65,70,3
Marley Aké,FRA,FW,Udinese,Serie A,22,2001,0.1,0,0,0,0,0,0,0,,0,0,0,0,0,0,0,0
Nathan Aké,NED,DF,Manchester City,Premier League,28,1995,22.7,26,16,15,8,3,13,20,65.0,7,17,2,15,14,40,54,0
Ilias Akhomach,MAR,"MF,FW",Villarreal,La Liga,19,2004,16.8,36,21,11,16,9,10,20,50.0,10,10,2,8,13,49,13,0
Sergio Akieme,ESP,DF,Almería,La Liga,25,1997,18.6,27,15,18,7,2,13,16,81.3,3,14,4,10,10,37,34,0
Sergio Akieme,ESP,DF,Reims,Ligue 1,25,1997,9.1,11,5,6,3,2,8,11,72.7,3,9,3,6,10,21,25,0
Ebenezer Akinsanmiro,NGA,MF,Inter,Serie A,18,2004,0.2,0,0,0,0,0,0,1,0.0,1,0,0,0,0,0,0,0
Maghnes Akliouche,FRA,"MF,FW",Monaco,Ligue 1,21,2002,17.9,37,23,12,20,5,12,36,33.3,24,21,0,21,9,46,3,0
Paul Akouokou,CIV,MF,Betis,La Liga,25,1997,0.3,5,3,0,2,3,3,3,100.0,0,3,1,2,1,6,1,0
Paul Akouokou,CIV,MF,Lyon,Ligue 1,25,1997,3.4,14,9,2,10,2,6,7,85.7,1,5,1,4,6,20,11,0
Jean-Daniel Akpa-Akpro,CIV,MF,Monza,Serie A,30,1992,7.8,20,11,14,4,2,3,9,33.3,6,10,4,6,12,32,15,1
David Akpan Ankeye,NGA,FW,Genoa,Serie A,21,2002,0.6,1,0,0,1,0,0,1,0.0,1,1,0,1,0,1,0,0
Kevin Akpoguma,NGA,DF,Hoffenheim,Bundesliga,28,1995,12.2,35,18,22,12,1,26,35,74.3,9,28,8,20,18,53,32,0
David Alaba,AUT,DF,Real Madrid,La Liga,31,1992,12.8,13,9,7,5,1,4,8,50.0,4,10,7,3,15,28,34,0
Luis Alberto,ESP,MF,Lazio,Serie A,30,1992,25.7,35,20,16,12,7,15,53,28.3,38,34,4,30,7,42,13,0
Raúl Albiol,ESP,DF,Villarreal,La Liga,37,1985,22.6,25,14,15,9,1,18,27,66.7,9,31,24,7,16,41,102,0
Thiago Alcántara,ESP,MF,Liverpool,Premier League,32,1991,0.1,0,0,0,0,0,0,0,,0,0,0,0,0,0,0,0
Carlos Alcaraz,ARG,MF,Juventus,Serie A,20,2002,4.2,6,6,0,6,0,5,10,50.0,5,5,2,3,5,11,4,0
Rubén Alcaraz,ESP,MF,Cádiz,La Liga,32,1991,34.8,97,59,39,52,6,50,121,41.3,71,60,14,46,33,130,55,2
Omar Alderete,PAR,DF,Getafe,La Liga,26,1996,24.4,28,21,15,13,0,19,35,54.3,16,30,18,12,13,41,111,0
Iván Alejo,ESP,MF,Cádiz,La Liga,28,1995,18.8,40,23,23,11,6,17,57,29.8,40,20,0,20,7,47,17,0
Carles Aleñá,ESP,MF,Getafe,La Liga,25,1998,11.3,24,8,7,14,3,10,24,41.7,14,14,3,11,4,28,13,0
Trent Alexander-Arnold,ENG,DF,Liverpool,Premier League,24,1998,23.9,39,26,26,11,2,27,87,31.0,60,22,2,20,31,70,48,5
Aboubacar Ali,FRA,"MF,FW",Strasbourg,Ligue 1,17,2006,1.4,2,0,0,2,0,0,0,,0,1,0,1,1,3,2,0
Mohamed Ali Cho,FRA,"FW,MF",Real Sociedad,La Liga,19,2004,2.8,4,3,3,1,0,2,7,28.6,5,6,0,6,1,5,1,0
Mohamed Ali Cho,FRA,FW,Nice,Ligue 1,19,2004,9.6,12,9,4,7,1,3,11,27.3,8,10,0,10,3,15,6,0
Faride Alidou,GER,"FW,MF",Köln,Bundesliga,22,2001,14.2,10,4,3,6,1,4,18,22.2,14,23,2,21,8,18,15,1
Nabil Alioui,FRA,"MF,FW",Le Havre,Ligue 1,24,1999,11.2,3,2,2,1,0,2,4,50.0,2,6,1,5,3,6,4,0
Alisson,BRA,GK,Liverpool,Premier League,30,1992,28.0,0,0,0,0,0,0,1,0.0,1,0,0,0,0,0,11,4
Tadeo Allende,ARG,"MF,FW",Celta Vigo,La Liga,24,1999,3.7,6,1,3,2,1,4,6,66.7,2,3,0,3,3,9,3,0
Jim Allevinah,GAB,"MF,DF",Clermont Foot,Ligue 1,28,1995,20.7,30,18,11,14,5,14,35,40.0,21,20,3,17,13,43,30,0
Domingos André Ribeiro Almeida,POR,"FW,MF",Valencia,La Liga,23,2000,10.7,25,15,9,12,4,9,19,47.4,10,13,1,12,6,31,5,0
Miguel Almirón,PAR,FW,Newcastle Utd,Premier League,29,1994,21.5,36,24,13,15,8,11,29,37.9,18,29,2,27,10,46,13,0
Pontus Almqvist,SWE,"FW,MF",Lecce,Serie A,24,1999,23.4,45,29,16,22,7,23,51,45.1,28,21,2,19,14,59,10,0
Marcos Alonso,ESP,DF,Barcelona,La Liga,32,1990,2.8,5,3,2,3,0,3,4,75.0,1,2,0,2,4,9,6,0
Adrià Altimira,ESP,"DF,MF",Villarreal,La Liga,22,2001,8.6,16,7,9,6,1,9,24,37.5,15,18,5,13,5,21,18,0
Sergi Altimira,ESP,MF,Betis,La Liga,21,2001,6.3,15,8,8,6,1,11,23,47.8,12,12,1,11,9,24,10,0
Edson Álvarez,MEX,MF,West Ham,Premier League,25,1997,26.4,80,39,47,26,7,31,66,47.0,35,59,20,39,42,122,81,0
Gastón Álvarez,URU,DF,Getafe,La Liga,23,2000,28.2,68,37,43,20,5,37,57,64.9,20,40,11,29,35,103,80,0
Hugo Álvarez,ESP,"MF,DF",Celta Vigo,La Liga,20,2003,8.5,14,9,8,3,3,9,20,45.0,11,4,1,3,5,19,9,0
Julián Álvarez,ARG,"MF,FW",Manchester City,Premier League,23,2000,29.4,24,13,5,8,11,8,32,25.0,24,30,0,30,2,26,14,1
Yeray Álvarez,ESP,DF,Athletic Club,La Liga,28,1995,12.8,18,9,15,3,0,12,19,63.2,7,8,5,3,11,29,34,1
Skelly Alvero,FRA,MF,Lyon,Ligue 1,21,2002,4.7,8,7,5,2,1,2,9,22.2,7,5,1,4,2,10,5,0
Skelly Alvero,FRA,MF,Werder Bremen,Bundesliga,21,2002,1.4,6,4,1,5,0,3,3,100.0,0,3,1,2,1,7,1,0
Papa Amadou Diallo,SEN,FW,Metz,Ligue 1,19,2004,9.9,18,8,10,7,1,7,21,33.3,14,11,1,10,11,29,16,0
Selim Amallah,MAR,"FW,MF",Valencia,La Liga,26,1996,6.7,17,12,7,7,3,3,9,33.3,6,13,0,13,11,28,6,0
Amath,SEN,"FW,MF",Mallorca,La Liga,27,1996,4.4,9,6,7,2,0,2,10,20.0,8,2,0,2,3,12,6,0
Lorenzo Amatucci,ITA,MF,Fiorentina,Serie A,19,2004,0.2,0,0,0,0,0,0,0,,0,0,0,0,0,0,0,0
Jordan Amavi,FRA,DF,Brest,Ligue 1,29,1994,1.0,1,1,0,1,0,1,3,33.3,2,2,1,1,3,4,2,0
Zeki Amdouni,SUI,FW,Burnley,Premier League,22,2000,21.7,27,18,1,15,11,7,25,28.0,18,23,10,13,9,36,10,0
Kelvin Amian,FRA,DF,Nantes,Ligue 1,25,1998,8.9,16,7,12,4,0,11,15,73.3,4,6,0,6,7,23,28,0
Bruno Amione,ARG,DF,Hellas Verona,Serie A,21,2002,6.4,11,3,9,2,0,4,5,80.0,1,4,2,2,9,20,19,2
Michael Amir Murillo,PAN,DF,Marseille,Ligue 1,27,1996,11.1,23,11,13,6,4,15,23,65.2,8,9,2,7,11,34,34,2
Nadiem Amiri,GER,MF,Mainz 05,Bundesliga,26,1996,14.6,22,14,8,10,4,13,19,68.4,6,16,2,14,14,36,18,0
Nadiem Amiri,GER,MF,Leverkusen,Bundesliga,26,1996,1.0,4,2,0,3,1,0,3,0.0,3,0,0,0,0,4,1,0
Kofi Amoako,GER,MF,Wolfsburg,Bundesliga,18,2005,0.0,0,0,0,0,0,0,0,,0,0,0,0,0,0,0,0
Sofyan Amrabat,MAR,"MF,DF",Manchester Utd,Premier League,26,1996,10.4,27,16,17,8,2,17,31,54.8,14,20,7,13,8,35,19,2
Joachim Andersen,DEN,DF,Crystal Palace,Premier League,27,1996,37.9,56,35,33,21,2,29,39,74.4,10,33,18,15,41,97,207,1
Elliot Anderson,ENG,"MF,FW",Newcastle Utd,Premier League,20,2002,11.4,24,18,12,9,3,15,29,51.7,14,23,4,19,8,32,23,0
Felipe Anderson,BRA,"FW,MF",Lazio,Serie A,30,1993,30.8,78,45,32,33,13,34,90,37.8,56,45,3,42,27,105,23,0
Benjamin André,FRA,MF,Lille,Ligue 1,32,1990,28.6,89,49,39,45,5,43,81,53.1,38,34,5,29,35,124,60,0
Komnen Andrić,SRB,FW,Clermont Foot,Ligue 1,28,1995,1.9,2,1,0,1,1,0,4,0.0,4,2,0,2,0,2,1,0
Robert Andrich,GER,"MF,DF",Leverkusen,Bundesliga,28,1994,18.8,30,18,8,14,8,13,24,54.2,11,15,4,11,20,50,17,0
Miguel Ángel Rubio,ESP,DF,Granada,La Liga,25,1998,17.3,20,12,14,6,0,14,21,66.7,7,31,18,13,28,48,74,2
Angeliño,ESP,DF,Roma,Serie A,26,1997,12.7,21,11,12,6,3,11,19,57.9,8,11,5,6,12,33,37,1
Ângelo,BRA,"FW,MF",Strasbourg,Ligue 1,18,2004,12.2,24,11,9,7,8,11,31,35.5,20,18,0,18,9,33,2,0
Fabrizio Angileri,ARG,"DF,MF",Getafe,La Liga,29,1994,1.8,1,1,1,0,0,1,3,33.3,2,0,0,0,4,5,8,0
Jaidon Anthony,ENG,FW,Bournemouth,Premier League,23,1999,1.7,3,1,1,0,2,1,7,14.3,6,3,0,3,1,4,3,0
Waldemar Anton,GER,DF,Stuttgart,Bundesliga,27,1996,32.1,39,25,21,16,2,23,42,54.8,19,33,20,13,40,79,150,1
Michail Antonio,JAM,FW,West Ham,Premier League,33,1990,18.8,15,8,5,6,4,3,11,27.3,8,16,3,13,4,19,4,0
Antony,BRA,FW,Manchester Utd,Premier League,23,2000,14.7,40,21,15,19,6,20,40,50.0,20,29,1,28,12,52,9,0
Christopher Antwi-Adjei,GHA,"FW,MF",Bochum,Bundesliga,29,1994,13.5,21,12,10,6,5,12,22,54.5,10,13,2,11,2,23,11,1
Houssem Aouar,ALG,"MF,FW",Roma,Serie A,25,1998,8.4,16,11,4,10,2,3,12,25.0,9,5,0,5,4,20,2,1
Stredair Appuah,FRA,"FW,MF",Nantes,Ligue 1,19,2004,0.9,0,0,0,0,0,0,3,0.0,3,0,0,0,1,1,1,0
Mauro Arambarri,URU,MF,Getafe,La Liga,27,1995,3.8,6,2,3,2,1,1,6,16.7,5,1,0,1,2,8,7,0
Jon Aramburu,VEN,DF,Real Sociedad,La Liga,21,2002,6.0,24,15,12,10,2,15,25,60.0,10,8,3,5,7,31,17,0
Asaf Arania,ISR,MF,Darmstadt 98,Bundesliga,17,2005,0.1,0,0,0,0,0,0,0,,0,0,0,0,0,0,0,0
Julian Araujo,MEX,DF,Las Palmas,La Liga,21,2001,16.2,41,22,29,7,5,23,33,69.7,10,23,16,7,10,51,52,1
Ronald Araújo,URU,DF,Barcelona,La Liga,24,1999,22.2,27,22,11,15,1,12,17,70.6,5,20,11,9,12,39,66,2
Oliver Arblaster,ENG,MF,Sheffield Utd,Premier League,19,2004,10.5,23,14,11,8,4,7,15,46.7,8,17,7,10,15,38,9,0
Cameron Archer,ENG,"FW,MF",Sheffield Utd,Premier League,22,2001,20.4,18,13,6,6,6,8,18,44.4,10,22,3,19,1,19,11,0
Cameron Archer,ENG,MF,Aston Villa,Premier League,22,2001,0.1,0,0,0,0,0,0,0,,0,0,0,0,0,0,0,0
Alphonse Areola,FRA,GK,West Ham,Premier League,30,1993,30.0,1,1,1,0,0,1,3,33.3,2,0,0,0,1,2,16,0
Adu Ares,ESP,FW,Athletic Club,La Liga,21,2001,2.9,8,4,4,2,2,2,3,66.7,1,1,0,1,1,9,0,0
Jesús Areso,ESP,DF,Osasuna,La Liga,24,1999,29.6,45,24,25,13,7,31,38,81.6,7,36,15,21,18,63,58,0
Simone Aresti,ITA,GK,Cagliari,Serie A,37,1986,0.0,0,0,0,0,0,0,0,,0,0,0,0,0,0,0,0
Matias Arezo,URU,FW,Granada,La Liga,20,2002,4.1,7,3,2,5,0,1,5,20.0,4,4,1,3,1,8,4,0
Iñigo Arguibide,ESP,DF,Osasuna,La Liga,18,2005,0.2,1,0,0,1,0,0,0,,0,0,0,0,0,1,1,0
Yoël Armougom,FRA,"DF,MF",Clermont Foot,Ligue 1,25,1998,2.6,3,3,2,0,1,2,3,66.7,1,1,0,1,1,4,3,0
José Arnaiz,ESP,"FW,MF",Osasuna,La Liga,28,1995,10.3,14,8,6,4,4,6,21,28.6,15,11,2,9,3,17,2,0
Hákon Arnar Haraldsson,ISL,"FW,MF",Lille,Ligue 1,20,2003,14.3,12,8,4,7,1,5,21,23.8,16,7,2,5,3,15,5,0
Marko Arnautović,AUT,FW,Inter,Serie A,34,1989,8.9,10,4,3,5,2,4,7,57.1,3,8,1,7,5,15,5,0
Maximilian Arnold,GER,MF,Wolfsburg,Bundesliga,29,1994,27.8,51,31,15,27,9,28,57,49.1,29,23,4,19,24,75,60,0
Mohamed El Arouch,FRA,FW,Lyon,Ligue 1,19,2004,0.0,0,0,0,0,0,0,0,,0,0,0,0,0,0,0,0
Sergio Arribas,ESP,"MF,FW",Almería,La Liga,21,2001,22.7,34,17,16,17,1,14,31,45.2,17,20,1,19,16,50,8,1
Kepa Arrizabalaga,ESP,GK,Real Madrid,La Liga,28,1994,13.3,0,0,0,0,0,0,1,0.0,1,0,0,0,0,0,4,0
Arthur,BRA,DF,Leverkusen,Bundesliga,20,2003,2.0,4,3,2,0,2,2,2,100.0,0,1,1,0,0,4,7,0
Takuma Asano,JPN,"FW,MF",Bochum,Bundesliga,28,1994,22.1,17,6,2,9,6,7,23,30.4,16,17,3,14,4,21,11,0
Marco Asensio,ESP,"MF,FW",Paris S-G,Ligue 1,27,1996,12.4,12,10,4,7,1,4,13,30.8,9,7,0,7,5,17,2,0
Kristjan Asllani,ALB,MF,Inter,Serie A,21,2002,8.7,7,2,3,4,0,2,11,18.2,9,9,3,6,11,18,8,0
Joel Asoro,SWE,"FW,MF",Metz,Ligue 1,24,1999,9.4,13,9,7,6,0,3,10,30.0,7,7,1,6,6,19,9,0
Jonathan Asp Jensen,DEN,FW,Bayern Munich,Bundesliga,17,2006,0.0,0,0,0,0,0,0,0,,0,0,0,0,0,0,1,0
Iago Aspas,ESP,FW,Celta Vigo,La Liga,35,1987,30.1,11,6,4,6,1,1,15,6.7,14,23,3,20,10,21,8,0
Lorenz Assignon,TOG,DF,Burnley,Premier League,23,2000,13.7,35,17,18,13,4,14,27,51.9,13,22,7,15,19,54,43,1
Lorenz Assignon,TOG,DF,Rennes,Ligue 1,23,2000,11.2,24,12,12,8,4,9,24,37.5,15,9,4,5,9,33,27,1
Youcef Atal,ALG,DF,Nice,Ligue 1,27,1996,4.0,9,3,6,2,1,6,8,75.0,2,7,1,6,4,13,1,0
Valentin Atangana Edoa,FRA,MF,Reims,Ligue 1,17,2005,6.2,19,13,6,9,4,5,13,38.5,8,5,1,4,6,25,9,0
Arthur Atta,FRA,"MF,FW",Metz,Ligue 1,20,2003,10.3,18,14,8,7,3,8,19,42.1,11,13,3,10,10,28,23,0
Noah Atubolu,GER,GK,Freiburg,Bundesliga,21,2002,34.0,0,0,0,0,0,0,1,0.0,1,0,0,0,0,0,8,1
Pierre-Emerick Aubameyang,GAB,FW,Marseille,Ligue 1,34,1989,29.1,22,14,4,11,7,7,26,26.9,19,30,5,25,9,31,26,0
Emil Audero,ITA,GK,Inter,Serie A,26,1997,3.7,0,0,0,0,0,0,0,,0,0,0,0,0,0,1,0
Tommaso Augello,ITA,DF,Cagliari,Serie A,28,1994,26.9,26,19,18,6,2,16,25,64.0,9,21,10,11,17,43,89,0
Carlos Augusto,BRA,DF,Inter,Serie A,24,1999,19.2,29,21,20,9,0,15,22,68.2,7,20,8,12,16,45,52,0
Yann Aurel Bisseck,GER,DF,Inter,Serie A,22,2000,10.0,14,6,10,3,1,6,9,66.7,3,10,7,3,5,19,23,0
Serge Aurier,CIV,"DF,MF",Nott'ham Forest,Premier League,30,1992,9.3,20,14,9,11,0,5,11,45.5,6,10,3,7,9,29,36,1
Ezequiel Ávila,ARG,"FW,MF",Osasuna,La Liga,29,1994,9.6,3,2,1,1,1,3,11,27.3,8,14,0,14,4,7,8,0
Ezequiel Ávila,ARG,FW,Betis,La Liga,29,1994,3.3,2,1,0,2,0,1,3,33.3,2,2,0,2,1,3,4,0
Taiwo Awoniyi,NGA,FW,Nott'ham Forest,Premier League,25,1997,11.6,9,7,1,4,4,1,2,50.0,1,7,2,5,1,10,9,0
André Ayew,GHA,FW,Le Havre,Ligue 1,33,1989,12.3,15,11,7,6,2,6,9,66.7,3,8,3,5,2,17,11,0
Jordan Ayew,GHA,"FW,MF",Crystal Palace,Premier League,31,1991,28.3,65,36,23,28,14,21,42,50.0,21,43,2,41,16,81,15,0
Neil El Aynaoui,FRA,MF,Lens,Ligue 1,22,2001,17.4,37,20,13,20,4,20,46,43.5,26,20,6,14,32,69,21,1
Sardar Azmoun,IRN,"FW,MF",Roma,Serie A,28,1995,6.5,8,5,2,5,1,4,8,50.0,4,4,1,3,3,11,6,1
César Azpilicueta,ESP,DF,Atlético Madrid,La Liga,33,1989,15.8,25,14,15,9,1,12,19,63.2,7,25,6,19,16,41,46,0
Paulo Azzi,BRA,"DF,MF",Cagliari,Serie A,29,1994,10.6,19,11,10,6,3,9,18,50.0,9,11,2,9,16,35,23,0
Oussama El Azzouzi,MAR,MF,Bologna,Serie A,22,2001,6.1,12,7,4,5,3,7,14,50.0,7,8,2,6,6,18,12,0
Abdellah Baallal,MAR,MF,Clermont Foot,Ligue 1,18,2004,0.0,0,0,0,0,0,0,0,,0,1,0,1,0,0,0,0
Iddrisu Baba,GHA,MF,Almería,La Liga,27,1996,15.9,46,26,27,18,1,17,39,43.6,22,20,6,14,11,57,27,2
Srđan Babić,SRB,DF,Almería,La Liga,27,1996,1.0,2,2,0,2,0,1,1,100.0,0,1,1,0,0,2,2,0
Shavy Babicka,GAB,"FW,MF",Toulouse,Ligue 1,23,2000,4.1,11,8,2,7,2,2,5,40.0,3,6,1,5,0,11,2,0
Aliou Badara Baldé,GUI,"FW,DF",Nice,Ligue 1,20,2002,0.8,4,1,0,3,1,1,1,100.0,0,2,1,1,3,7,0,0
Loïc Bade,FRA,DF,Sevilla,La Liga,23,2000,25.3,65,41,53,12,0,30,49,61.2,19,23,15,8,38,103,116,2
Milan Badelj,CRO,MF,Genoa,Serie A,34,1989,28.2,51,27,23,24,4,24,61,39.3,37,45,13,32,50,101,54,1
Matthias Bader,GER,"DF,MF",Darmstadt 98,Bundesliga,26,1997,20.0,51,25,32,11,8,33,65,50.8,32,22,4,18,25,76,20,0
Benoît Badiashile,FRA,DF,Chelsea,Premier League,22,2001,14.9,21,15,12,9,0,9,14,64.3,5,21,14,7,18,39,66,2
Alex Baena,ESP,"MF,FW",Villarreal,La Liga,22,2001,28.7,34,21,10,16,8,20,47,42.6,27,23,2,21,13,47,17,1
Jaime Báez,URU,"FW,MF",Frosinone,Serie A,28,1995,5.6,4,1,0,2,2,0,7,0.0,7,5,0,5,4,8,1,0
Nicola Bagnolini,ITA,GK,Bologna,Serie A,19,2004,0.1,0,0,0,0,0,0,0,,0,0,0,0,0,0,0,0
Leon Bailey,JAM,"MF,FW",Aston Villa,Premier League,25,1997,23.0,13,7,7,4,2,5,20,25.0,15,18,1,17,9,22,6,0
Eric Bailly,CIV,DF,Villarreal,La Liga,29,1994,9.3,5,3,4,1,0,2,2,100.0,0,8,8,0,9,14,38,2
Stefan Bajcetic,ESP,MF,Liverpool,Premier League,18,2004,0.3,4,1,3,1,0,3,5,60.0,2,0,0,0,0,4,0,0
Nedim Bajrami,ALB,"MF,FW",Sassuolo,Serie A,24,1999,14.6,13,6,6,3,4,5,13,38.5,8,5,1,4,6,19,8,0
Cédric Bakambu,COD,FW,Betis,La Liga,32,1991,2.2,1,0,0,1,0,0,0,,0,2,0,2,0,1,0,0
Tiemoué Bakayoko,FRA,MF,Lorient,Ligue 1,28,1994,14.6,34,17,14,17,3,15,28,53.6,13,10,4,6,26,60,15,1
Mitchel Bakker,NED,DF,Atalanta,Serie A,23,2000,4.2,7,3,6,1,0,2,12,16.7,10,5,0,5,3,10,6,0
Ridle Baku,GER,"DF,MF",Wolfsburg,Bundesliga,25,1998,22.4,37,20,24,7,6,21,46,45.7,25,27,1,26,21,58,45,1
Dilane Bakwa,FRA,"FW,MF",Strasbourg,Ligue 1,20,2002,24.2,30,22,12,13,5,11,40,27.5,29,26,1,25,20,50,11,0
Tommaso Baldanzi,ITA,"MF,FW",Empoli,Serie A,20,2003,8.3,4,2,1,1,2,3,10,30.0,7,7,0,7,2,6,0,0
Tommaso Baldanzi,ITA,"FW,MF",Roma,Serie A,20,2003,5.8,9,5,3,4,2,1,1,100.0,0,2,0,2,0,9,4,0
Alejandro Balde,ESP,DF,Barcelona,La Liga,19,2003,15.3,20,11,11,6,3,7,11,63.6,4,14,1,13,5,25,21,1
George Baldock,GRE,DF,Sheffield Utd,Premier League,30,1993,10.8,18,10,10,7,1,6,15,40.0,9,14,8,6,10,28,33,0
Carlos Baleba,CMR,MF,Brighton,Premier League,19,2004,14.7,40,20,17,19,4,23,46,50.0,23,35,7,28,18,58,30,3
Carlos Baleba,CMR,MF,Lille,Ligue 1,19,2004,0.7,6,2,1,4,1,3,4,75.0,1,0,0,0,2,8,0,0
Leonardo Balerdi,ARG,DF,Marseille,Ligue 1,24,1999,25.2,79,50,55,23,1,49,67,73.1,18,38,15,23,51,130,91,0
Iván Balliu,ALB,DF,Rayo Vallecano,La Liga,31,1992,31.9,44,31,20,24,0,22,39,56.4,17,27,11,16,29,73,66,1
Fodé Ballo-Touré,SEN,"DF,MF",Fulham,Premier League,26,1997,0.8,4,2,1,3,0,1,2,50.0,1,1,0,1,3,7,2,0
Folarin Balogun,USA,FW,Monaco,Ligue 1,22,2001,18.8,12,4,3,8,1,5,13,38.5,8,10,0,10,3,15,4,0
Jonathan Bamba,CIV,"MF,FW",Celta Vigo,La Liga,27,1996,22.0,14,9,4,8,2,2,17,11.8,15,20,0,20,18,32,12,0
Mohamed Bamba,CIV,FW,Lorient,Ligue 1,21,2001,12.6,14,9,3,8,3,4,10,40.0,6,7,1,6,2,16,3,0
Samuel Bamba,GER,FW,Dortmund,Bundesliga,19,2004,0.5,1,1,1,0,0,1,2,50.0,1,0,0,0,0,1,1,0
Lameck Banda,ZAM,FW,Lecce,Serie A,22,2001,15.0,27,23,11,12,4,7,21,33.3,14,18,0,18,3,30,7,0
Daniel Bandeira,POR,MF,Hellas Verona,Serie A,23,2000,5.0,6,5,1,4,1,3,7,42.9,4,3,0,3,3,9,9,0
Mamady Bangré,BFA,"FW,MF",Toulouse,Ligue 1,22,2001,1.1,4,2,2,2,0,3,4,75.0,1,0,0,0,4,8,3,0
Mattia Bani,ITA,DF,Genoa,Serie A,29,1993,25.6,26,10,18,7,1,11,22,50.0,11,51,31,20,22,48,116,1
Léo Baptistão,BRA,FW,Almería,La Liga,30,1992,20.4,25,16,12,8,5,9,25,36.0,16,13,1,12,11,36,22,0
Shandon Baptiste,GRN,MF,Brentford,Premier League,25,1998,2.5,4,4,2,2,0,1,5,20.0,4,5,1,4,3,7,6,0
Antonín Barák,CZE,"MF,FW",Fiorentina,Serie A,28,1994,9.0,6,2,1,3,2,3,7,42.9,4,5,0,5,2,8,4,0
Valentín Barco,ARG,"DF,FW",Brighton,Premier League,19,2004,3.4,11,5,4,5,2,6,8,75.0,2,3,0,3,4,15,3,1
Bradley Barcola,FRA,FW,Lyon,Ligue 1,20,2002,3.0,5,2,0,2,3,1,7,14.3,6,4,0,4,2,7,0,0
Bradley Barcola,FRA,"FW,MF",Paris S-G,Ligue 1,20,2002,15.2,34,16,12,13,9,7,25,28.0,18,27,2,25,10,44,13,1
Melvin Bard,FRA,DF,Nice,Ligue 1,22,2000,29.5,69,38,28,30,11,37,63,58.7,26,46,12,34,42,111,46,0
Nicolò Barella,ITA,MF,Inter,Serie A,26,1997,31.6,46,30,17,20,9,19,63,30.2,44,31,1,30,10,56,12,1
Kike Barja,ESP,"FW,MF",Osasuna,La Liga,26,1997,3.4,6,2,2,2,2,3,8,37.5,5,2,1,1,2,8,2,0
Ross Barkley,ENG,MF,Luton Town,Premier League,29,1993,29.1,47,19,16,21,10,11,48,22.9,37,25,9,16,25,72,51,2
Aymen Barkok,MAR,"MF,FW",Mainz 05,Bundesliga,25,1998,3.6,9,5,2,6,1,3,6,50.0,3,7,0,7,2,11,1,0
Harvey Barnes,ENG,"FW,MF",Newcastle Utd,Premier League,25,1997,8.9,6,1,3,2,1,1,2,50.0,1,1,0,1,5,11,3,0
Leandro Barreiro Martins,LUX,MF,Mainz 05,Bundesliga,23,2000,29.0,65,40,19,37,9,30,50,60.0,20,45,16,29,36,101,53,0
Enzo Barrenechea,ARG,MF,Frosinone,Serie A,22,2001,31.2,65,42,28,29,8,28,70,40.0,42,47,12,35,27,92,61,2
Ander Barrenetxea,ESP,"FW,MF",Real Sociedad,La Liga,21,2001,15.9,32,21,7,16,9,10,26,38.5,16,18,1,17,6,38,5,0
Pablo Barrios,ESP,MF,Atlético Madrid,La Liga,20,2003,17.3,45,25,15,29,1,19,40,47.5,21,20,3,17,28,73,24,2
Davide Bartesaghi,ITA,"DF,MF",Milan,Serie A,17,2005,0.9,2,0,1,1,0,2,4,50.0,2,1,1,0,0,2,7,0
Marc Bartra,ESP,DF,Betis,La Liga,32,1991,2.5,4,3,3,1,0,4,5,80.0,1,3,1,2,3,7,10,0
Federico Baschirotto,ITA,DF,Lecce,Serie A,26,1996,36.6,21,12,16,5,0,8,15,53.3,7,42,26,16,23,44,144,1
Steven Baseya,FRA,DF,Strasbourg,Ligue 1,18,2005,0.1,2,1,1,1,0,1,1,100.0,0,0,0,0,0,2,1,0
Chris Basham,ENG,"DF,MF",Sheffield Utd,Premier League,35,1988,3.6,7,2,4,3,0,2,9,22.2,7,9,4,5,5,12,17,0
Toma Bašić,CRO,MF,Salernitana,Serie A,26,1996,12.9,20,13,10,9,1,10,27,37.0,17,18,6,12,14,34,29,0
Calvin Bassey,NGA,DF,Fulham,Premier League,23,1999,25.6,49,29,33,15,1,21,29,72.4,8,32,11,21,28,77,84,4
Alessandro Bastoni,ITA,DF,Inter,Serie A,24,1999,25.2,46,33,31,12,3,26,40,65.0,14,25,11,14,23,69,48,1
Simone Bastoni,ITA,"MF,DF",Empoli,Serie A,26,1996,8.3,22,13,12,7,3,11,22,50.0,11,8,0,8,11,33,18,0
Augusto Batalla,ARG,GK,Granada,La Liga,27,1996,17.0,0,0,0,0,0,0,1,0.0,1,0,0,0,0,0,10,2
Daniel Batz,GER,GK,Mainz 05,Bundesliga,32,1991,4.0,0,0,0,0,0,0,0,,0,0,0,0,0,0,3,0
Maximilian Bauer,GER,DF,Augsburg,Bundesliga,23,2000,9.0,19,12,13,4,2,9,17,52.9,8,14,8,6,11,30,30,1
Elias Baum,GER,"DF,MF",Eint Frankfurt,Bundesliga,17,2005,0.3,1,0,0,0,1,0,0,,0,3,2,1,0,1,1,0
Oliver Baumann,GER,GK,Hoffenheim,Bundesliga,33,1990,34.0,1,1,1,0,0,1,2,50.0,1,0,0,0,0,1,19,2
Christoph Baumgartner,AUT,"MF,FW",RB Leipzig,Bundesliga,23,1999,12.9,26,13,10,12,4,14,38,36.8,24,20,1,19,5,31,14,0
Bebé,CPV,"MF,FW",Rayo Vallecano,La Liga,33,1990,2.4,2,2,1,1,0,1,5,20.0,4,1,0,1,0,2,0,0
Ihlas Bebou,TOG,"FW,DF",Hoffenheim,Bundesliga,29,1994,18.2,22,12,10,8,4,8,16,50.0,8,13,2,11,14,36,15,0
Mohamed Bechikh,FRA,"FW,MF",Strasbourg,Ligue 1,18,2005,0.2,0,0,0,0,0,0,0,,0,0,0,0,0,0,0,0
Adrian Beck,GER,"MF,FW",Heidenheim,Bundesliga,26,1997,10.8,22,13,8,12,2,9,24,37.5,15,17,0,17,4,26,15,0
Owen Beck,WAL,DF,Liverpool,Premier League,20,2002,0.1,2,1,1,1,0,0,0,,0,0,0,0,0,2,1,0
Sheraldo Becker,SUR,"FW,MF",Real Sociedad,La Liga,28,1995,8.6,2,2,0,2,0,0,1,0.0,1,3,0,3,1,3,0,0
Sheraldo Becker,SUR,"FW,MF",Union Berlin,Bundesliga,28,1995,7.2,3,3,0,2,1,0,2,0.0,2,2,0,2,0,3,2,0
Chris Bedia,CIV,"FW,MF",Union Berlin,Bundesliga,27,1996,1.6,2,1,0,2,0,0,1,0.0,1,3,0,3,0,2,2,0
Donny van de Beek,NED,DF,Manchester Utd,Premier League,26,1997,0.0,0,0,0,0,0,0,0,,0,1,0,1,0,0,0,0
Donny van de Beek,NED,"MF,FW",Eint Frankfurt,Bundesliga,26,1997,4.0,8,3,3,3,2,3,7,42.9,4,5,1,4,3,11,1,0
Yanis Begraoui,MAR,"FW,MF",Toulouse,Ligue 1,22,2001,3.3,5,3,1,3,1,3,9,33.3,6,4,0,4,5,10,5,0
Kevin Behrens,GER,FW,Wolfsburg,Bundesliga,32,1991,6.8,2,1,0,1,1,0,2,0.0,2,9,0,9,3,5,6,0
Kevin Behrens,GER,FW,Union Berlin,Bundesliga,32,1991,14.0,13,10,3,7,3,1,4,25.0,3,7,2,5,6,19,19,0
Maximilian Beier,GER,"FW,MF",Hoffenheim,Bundesliga,20,2002,26.9,20,12,5,11,4,4,19,21.1,15,21,1,20,9,29,12,0
Jérémie Bela,ANG,"MF,FW",Clermont Foot,Ligue 1,30,1993,2.3,1,1,0,1,0,1,3,33.3,2,1,0,1,0,1,1,0
Reda Belahyane,MAR,MF,Hellas Verona,Serie A,19,2004,1.0,1,1,0,1,0,1,1,100.0,0,0,0,0,1,2,0,0
Reda Belahyane,MAR,MF,Nice,Ligue 1,19,2004,0.3,1,0,0,1,0,1,1,100.0,0,0,0,0,0,1,0,0
Amari'i Bell,JAM,DF,Luton Town,Premier League,29,1994,19.1,50,33,30,19,1,22,35,62.9,13,33,15,18,25,75,60,1
Stefan Bell,GER,DF,Mainz 05,Bundesliga,31,1991,7.4,8,8,7,1,0,4,8,50.0,4,7,5,2,6,14,30,0
Alaa Bellaarouch,MAR,GK,Strasbourg,Ligue 1,21,2002,15.0,0,0,0,0,0,0,0,,0,0,0,0,1,1,11,2
Raoul Bellanova,ITA,DF,Torino,Serie A,23,2000,33.8,36,26,15,17,4,18,31,58.1,13,21,4,17,15,51,36,3
Jean-Ricner Bellegarde,FRA,"MF,FW",Wolves,Premier League,25,1998,10.6,17,10,9,6,2,7,15,46.7,8,18,2,16,8,25,14,0
Jean-Ricner Bellegarde,FRA,"MF,FW",Strasbourg,Ligue 1,25,1998,3.0,5,3,3,2,0,3,6,50.0,3,4,0,4,4,9,0,0
Héctor Bellerín,ESP,DF,Betis,La Liga,28,1995,19.0,34,22,14,16,4,20,53,37.7,33,13,5,8,22,56,40,1
Jude Bellingham,ENG,MF,Real Madrid,La Liga,20,2003,25.7,42,34,14,18,10,12,36,33.3,24,55,5,50,21,63,17,0
Jeanuël Belocian,FRA,DF,Rennes,Ligue 1,18,2005,16.1,32,22,23,8,1,22,28,78.6,6,18,10,8,13,45,49,0
Andrea Belotti,ITA,FW,Fiorentina,Serie A,29,1993,10.5,8,3,1,5,2,5,12,41.7,7,8,1,7,2,10,3,0
Andrea Belotti,ITA,FW,Roma,Serie A,29,1993,7.5,8,4,2,3,3,3,6,50.0,3,7,0,7,2,10,3,0
Fran Beltrán,ESP,MF,Celta Vigo,La Liga,24,1999,27.0,56,32,22,23,11,24,63,38.1,39,28,2,26,18,74,34,0
Lucas Beltrán,ARG,"FW,MF",Fiorentina,Serie A,22,2001,18.8,27,14,4,18,5,11,20,55.0,9,29,3,26,2,29,11,0
Eliesse Ben Seghir,MAR,"MF,FW",Monaco,Ligue 1,18,2005,4.8,9,6,2,5,2,3,7,42.9,4,6,0,6,2,11,2,0
Anis Ben Slimane,TUN,MF,Sheffield Utd,Premier League,22,2001,4.7,11,6,5,2,4,4,10,40.0,6,7,1,6,5,16,7,0
Wissam Ben Yedder,FRA,FW,Monaco,Ligue 1,32,1990,25.7,4,3,1,2,1,1,11,9.1,10,18,0,18,8,12,1,0
Carlos Benavídez,URU,MF,Alavés,La Liga,25,1998,12.6,56,35,19,26,11,19,34,55.9,15,13,5,8,19,75,31,0
Ismaël Bennacer,ALG,MF,Milan,Serie A,25,1997,12.8,29,19,11,16,2,11,22,50.0,11,12,4,8,12,41,9,2
Saïd Benrahma,ALG,"FW,MF",West Ham,Premier League,27,1995,6.9,8,4,5,3,0,4,15,26.7,11,8,0,8,5,13,7,0
Saïd Benrahma,ALG,"FW,MF",Lyon,Ligue 1,27,1995,8.6,9,7,1,6,2,5,7,71.4,2,7,0,7,1,10,3,0
Ramy Bensebaini,ALG,DF,Dortmund,Bundesliga,28,1995,11.5,34,21,21,11,2,24,34,70.6,10,22,7,15,16,50,37,0
Nabil Bentaleb,ALG,MF,Lille,Ligue 1,28,1994,21.9,49,32,29,18,2,22,43,51.2,21,33,12,21,37,86,33,0
Rodrigo Bentancur,URU,MF,Tottenham,Premier League,26,1997,11.2,23,15,10,11,2,10,24,41.7,14,15,4,11,17,40,16,1
Daniel Bentley,ENG,GK,Wolves,Premier League,30,1993,4.3,0,0,0,0,0,0,1,0.0,1,0,0,0,0,0,1,0
Lucas Beraldo,BRA,DF,Paris S-G,Ligue 1,19,2003,11.2,22,14,14,8,0,10,25,40.0,15,15,6,9,20,42,25,0
Domenico Berardi,ITA,FW,Sassuolo,Serie A,28,1994,15.9,17,8,7,9,1,2,21,9.5,19,17,0,17,13,30,9,0
Yuri Berchiche,ESP,DF,Athletic Club,La Liga,33,1990,21.4,33,25,13,14,6,19,33,57.6,14,28,9,19,20,53,62,0
Álex Berenguer,ESP,FW,Athletic Club,La Liga,28,1995,17.7,23,14,9,9,5,7,24,29.2,17,23,0,23,5,28,13,0
Bartosz Bereszyński,POL,DF,Empoli,Serie A,31,1992,19.6,41,25,25,13,3,24,40,60.0,16,22,10,12,21,62,52,0
Jóhann Berg Guðmundsson,ISL,"MF,FW",Burnley,Premier League,32,1990,13.2,13,4,6,5,2,7,16,43.8,9,14,0,14,16,29,16,0
Sander Berge,NOR,MF,Burnley,Premier League,25,1998,33.4,76,46,35,36,5,34,58,58.6,24,49,20,29,23,99,60,2
Etrit Berisha,ALB,GK,Empoli,Serie A,34,1989,14.0,0,0,0,0,0,0,1,0.0,1,0,0,0,0,0,7,1
Medon Berisha,ALB,"FW,MF",Lecce,Serie A,19,2003,2.3,3,1,3,0,0,0,2,0.0,2,2,2,0,1,4,0,0
Mergim Berisha,GER,FW,Hoffenheim,Bundesliga,25,1998,1.6,0,0,0,0,0,0,0,,0,2,1,1,0,0,0,0
Mergim Berisha,GER,FW,Augsburg,Bundesliga,25,1998,1.4,0,0,0,0,0,0,0,,0,1,0,1,0,0,3,0
Bernardo,BRA,DF,Bochum,Bundesliga,28,1995,32.5,99,58,56,35,8,45,69,65.2,24,66,30,36,55,154,120,1
Victor Bernth Kristiansen,DEN,DF,Bologna,Serie A,20,2002,25.6,52,34,23,22,7,20,35,57.1,15,35,8,27,12,64,45,1
Matúš Bero,SVK,"MF,FW",Bochum,Bundesliga,27,1995,18.5,32,22,13,12,7,13,32,40.6,19,24,3,21,12,44,26,0
Luke Berry,ENG,"MF,DF",Luton Town,Premier League,31,1992,3.6,7,2,2,4,1,2,3,66.7,1,6,1,5,0,7,3,0
Dimitry Bertaud,COD,GK,Montpellier,Ligue 1,25,1998,4.0,0,0,0,0,0,0,0,,0,0,0,0,0,0,0,0
Jan-Niklas Beste,GER,"FW,MF",Heidenheim,Bundesliga,24,1999,28.9,77,49,35,24,18,28,55,50.9,27,48,1,47,18,95,31,0
Beto,GNB,FW,Everton,Premier League,25,1998,10.6,14,6,1,6,7,4,12,33.3,8,11,0,11,1,15,14,0
Beto,GNB,FW,Udinese,Serie A,25,1998,0.8,1,0,0,0,1,0,0,,0,0,0,0,0,1,0,0
Davide Bettella,ITA,MF,Monza,Serie A,23,2000,0.0,0,0,0,0,0,0,0,,0,0,0,0,0,0,0,0
Sam Beukema,NED,DF,Bologna,Serie A,24,1998,28.3,27,11,14,11,2,16,25,64.0,9,35,21,14,15,42,99,2
Jordan Beyer,GER,DF,Burnley,Premier League,23,2000,13.7,35,20,22,12,1,14,24,58.3,10,22,15,7,16,51,68,1
Pep Biel,ESP,"MF,FW",Augsburg,Bundesliga,26,1996,3.2,4,3,0,2,2,1,3,33.3,2,2,1,1,2,6,2,0
Jaka Bijol,SVN,DF,Udinese,Serie A,24,1999,23.2,43,27,34,9,0,22,35,62.9,13,36,21,15,23,66,140,1
El Bilal Touré,MLI,FW,Atalanta,Serie A,21,2001,4.4,1,1,0,1,0,0,1,0.0,1,0,0,0,1,2,2,0
Philip Billing,DEN,MF,Bournemouth,Premier League,27,1996,15.5,33,16,7,22,4,9,27,33.3,18,31,5,26,20,53,28,1
Cristiano Biraghi,ITA,DF,Fiorentina,Serie A,30,1992,26.2,47,28,20,24,3,28,52,53.8,24,30,5,25,14,61,43,0
Davide Biraschi,ITA,DF,Genoa,Serie A,29,1994,1.0,3,3,1,2,0,1,3,33.3,2,0,0,0,2,5,5,0
Samuele Birindelli,ITA,DF,Monza,Serie A,24,1999,22.4,28,19,16,7,5,14,25,56.0,11,30,11,19,18,46,48,0
Tom Bischof,GER,"MF,FW",Hoffenheim,Bundesliga,18,2005,2.0,8,4,6,1,1,2,9,22.2,7,3,0,3,1,9,2,0
Yves Bissouma,MLI,MF,Tottenham,Premier League,26,1996,23.0,80,52,32,36,12,41,61,67.2,20,28,5,23,37,117,43,3
Leonardo Bittencourt,GER,MF,Werder Bremen,Bundesliga,29,1993,17.5,42,18,20,17,5,15,39,38.5,24,18,1,17,13,55,6,0
Marco Bizot,NED,GK,Brest,Ligue 1,32,1991,32.0,0,0,0,0,0,0,1,0.0,1,0,0,0,0,0,18,3
Antonio Blanco,ESP,MF,Alavés,La Liga,23,2000,27.0,61,36,29,27,5,31,86,36.0,55,25,2,23,35,96,30,0
Rubén Blanco,ESP,GK,Marseille,Ligue 1,28,1995,1.3,0,0,0,0,0,0,0,,0,0,0,0,0,0,0,0
Hendry Blank,GER,DF,Dortmund,Bundesliga,18,2004,0.5,1,0,1,0,0,1,1,100.0,0,1,0,1,0,1,4,0
Ludovic Blas,FRA,"FW,MF",Rennes,Ligue 1,25,1997,17.4,30,14,16,13,1,12,28,42.9,16,13,1,12,6,36,9,0
Janis Blaswich,GER,GK,RB Leipzig,Bundesliga,32,1991,21.0,1,1,1,0,0,0,0,,0,0,0,0,0,1,7,3
Alexis Blin,FRA,MF,Lecce,Serie A,26,1996,18.2,33,19,11,19,3,15,43,34.9,28,16,2,14,22,55,39,0
Daley Blind,NED,DF,Girona,La Liga,33,1990,33.0,47,21,33,13,1,29,47,61.7,18,37,19,18,21,68,113,0
Myron Boadu,NED,FW,Monaco,Ligue 1,22,2001,0.9,2,2,0,1,1,1,2,50.0,1,2,0,2,0,2,0,0
Benicio Boaitey,ENG,"FW,DF",Brighton,Premier League,19,2004,0.4,0,0,0,0,0,0,1,0.0,1,1,0,1,0,0,2,0
Jérôme Boateng,GER,DF,Salernitana,Serie A,34,1988,2.6,0,0,0,0,0,0,0,,0,6,5,1,4,4,21,0
Oscar Bobb,NOR,"FW,MF",Manchester City,Premier League,20,2003,3.4,7,3,1,2,4,2,4,50.0,2,4,0,4,5,12,1,0
Sacha Boey,FRA,DF,Bayern Munich,Bundesliga,22,2000,1.2,2,0,2,0,0,1,2,50.0,1,1,0,1,1,3,2,0
Jeremie Boga,CIV,FW,Nice,Ligue 1,26,1997,22.2,18,7,6,10,2,10,20,50.0,10,26,2,24,8,26,4,0
Jayden Bogle,ENG,DF,Sheffield Utd,Premier League,23,2000,31.0,66,36,43,21,2,35,70,50.0,35,42,11,31,32,98,97,0
Emil Bohinen,NOR,MF,Genoa,Serie A,24,1999,0.6,1,1,0,1,0,0,0,,0,1,0,1,0,1,3,0
Emil Bohinen,NOR,MF,Salernitana,Serie A,24,1999,5.9,8,6,5,3,0,2,10,20.0,8,8,2,6,14,22,6,1
Adama Bojang,GAM,FW,Reims,Ligue 1,19,2004,0.9,2,1,1,0,1,0,0,,0,2,1,1,1,3,0,0
Daniel Boloca,ROU,MF,Sassuolo,Serie A,24,1998,22.5,48,33,18,25,5,27,46,58.7,19,23,13,10,14,62,33,2
Willy Boly,CIV,DF,Nott'ham Forest,Premier League,32,1991,16.0,46,29,36,9,1,22,40,55.0,18,32,21,11,25,71,90,0
Giacomo Bonaventura,ITA,MF,Fiorentina,Serie A,33,1989,25.3,26,13,6,10,10,9,21,42.9,12,16,1,15,14,40,10,0
Federico Bonazzoli,ITA,"FW,MF",Hellas Verona,Serie A,26,1997,11.3,4,1,1,3,0,1,8,12.5,7,9,1,8,3,7,3,0
Warren Bondo,FRA,MF,Monza,Serie A,19,2003,16.4,29,22,16,10,3,13,17,76.5,4,13,3,10,6,35,13,0
Giovanni Bonfanti,ITA,DF,Atalanta,Serie A,20,2003,1.0,4,2,2,2,0,2,3,66.7,1,1,1,0,1,5,1,0
Victor Boniface,NGA,FW,Leverkusen,Bundesliga,22,2000,17.2,6,4,0,1,5,1,4,25.0,3,6,1,5,0,6,13,0
Kevin Bonifazi,ITA,DF,Bologna,Serie A,27,1996,1.0,4,0,0,4,0,1,2,50.0,1,0,0,0,0,4,7,1
Kevin Bonifazi,ITA,DF,Frosinone,Serie A,27,1996,3.4,5,3,2,3,0,2,3,66.7,1,1,0,1,3,8,9,0
Leonardo Bonucci,ITA,DF,Union Berlin,Bundesliga,36,1987,5.1,6,5,2,4,0,4,4,100.0,0,5,3,2,7,13,16,0
Neto Borges,BRA,DF,Clermont Foot,Ligue 1,26,1996,28.0,48,24,25,18,5,28,63,44.4,35,28,6,22,57,105,84,0
Yvandro Borges Sanches,LUX,"MF,FW",Gladbach,Bundesliga,19,2004,0.2,0,0,0,0,0,0,0,,0,0,0,0,0,0,0,0
Sebastiaan Bornauw,BEL,DF,Wolfsburg,Bundesliga,24,1999,15.9,26,12,19,7,0,13,19,68.4,6,21,12,9,18,44,81,0
Rafael Borré,COL,FW,Werder Bremen,Bundesliga,27,1995,11.0,10,7,2,4,4,5,16,31.3,11,8,2,6,2,12,10,0
Gennaro Borrelli,ITA,FW,Frosinone,Serie A,23,2000,0.3,0,0,0,0,0,0,0,,0,0,0,0,0,0,0,0
Adri Bosch,ESP,DF,Granada,La Liga,22,2001,0.3,1,1,1,0,0,0,0,,0,0,0,0,0,1,1,0
Erik Botheim,NOR,"FW,MF",Salernitana,Serie A,23,2000,3.5,2,0,2,0,0,0,1,0.0,1,3,0,3,0,2,2,0
Sven Botman,NED,DF,Newcastle Utd,Premier League,23,2000,15.3,20,13,14,6,0,8,13,61.5,5,20,16,4,9,29,61,3
Saïmon Bouabré,FRA,MF,Monaco,Ligue 1,17,2006,0.5,2,2,0,2,0,1,2,50.0,1,1,0,1,0,2,0,0
Ayyoub Bouaddi,FRA,MF,Lille,Ligue 1,15,2007,1.5,6,2,6,0,0,2,5,40.0,3,2,0,2,1,7,3,0
Badredine Bouanani,ALG,FW,Nice,Ligue 1,18,2004,1.8,3,2,1,1,1,3,4,75.0,1,5,0,5,3,6,0,0
Badredine Bouanani,ALG,MF,Lorient,Ligue 1,18,2004,4.9,4,2,1,1,2,2,4,50.0,2,3,0,3,2,6,3,0
Mohamed Bouchenna,FRA,"MF,FW",Clermont Foot,Ligue 1,17,2006,0.3,1,0,1,0,0,0,0,,0,0,0,0,0,1,0,0
Hicham Boudaoui,ALG,MF,Nice,Ligue 1,23,1999,17.9,41,19,16,22,3,21,30,70.0,9,15,1,14,11,52,15,0
Yassine Bounou,MAR,GK,Sevilla,La Liga,32,1991,1.0,0,0,0,0,0,0,0,,0,0,0,0,0,0,0,0
Mehdi Bourabia,MAR,MF,Frosinone,Serie A,31,1991,2.2,5,4,1,4,0,2,4,50.0,2,3,0,3,0,5,4,0
Benjamin Bourigeaud,FRA,"MF,FW",Rennes,Ligue 1,29,1994,26.9,31,18,14,9,8,13,44,29.5,31,31,2,29,22,53,39,2
Bilal Boutobba,FRA,"FW,MF",Clermont Foot,Ligue 1,24,1998,10.3,22,12,6,10,6,10,23,43.5,13,9,0,9,8,30,3,0
Hugo Boutsingkham,FRA,"MF,FW",Nantes,Ligue 1,20,2003,0.1,0,0,0,0,0,0,0,,0,0,0,0,0,0,1,0
Edoardo Bove,ITA,MF,Roma,Serie A,21,2002,19.8,60,31,16,31,13,27,46,58.7,19,21,1,20,11,71,11,1
Jarrod Bowen,ENG,FW,West Ham,Premier League,26,1996,33.5,42,28,14,14,14,13,35,37.1,22,37,5,32,19,61,14,0
Lucas Boyé,ARG,FW,Granada,La Liga,27,1996,28.2,50,25,14,25,11,14,34,41.2,20,35,5,30,10,60,46,0
Domagoj Bradarić,CRO,DF,Salernitana,Serie A,23,1999,30.5,29,20,13,10,6,15,25,60.0,10,22,7,15,32,61,62,1
Conor Bradley,NIR,DF,Liverpool,Premier League,20,2003,8.4,33,25,14,12,7,24,38,63.2,14,17,1,16,10,43,14,0
Bilal Brahimi,ALG,FW,Nice,Ligue 1,23,2000,0.1,0,0,0,0,0,0,1,0.0,1,0,0,0,0,0,0,0
Bilal Brahimi,ALG,"FW,MF",Brest,Ligue 1,23,2000,2.5,0,0,0,0,0,0,3,0.0,3,3,0,3,0,0,0,0
Julian Brandt,GER,"MF,FW",Dortmund,Bundesliga,27,1996,24.7,17,14,8,8,1,10,27,37.0,17,20,3,17,8,25,18,0
Jarrad Branthwaite,ENG,DF,Everton,Premier League,21,2002,34.6,66,32,42,22,2,45,62,72.6,17,51,36,15,50,116,163,2
Darko Brašanac,SRB,MF,Osasuna,La Liga,31,1992,0.5,1,0,1,0,0,1,1,100.0,0,1,0,1,0,1,0,0
Lilian Brassier,FRA,DF,Brest,Ligue 1,23,1999,29.7,31,18,18,13,0,12,24,50.0,12,28,21,7,41,72,93,0
Brau,ESP,DF,Granada,La Liga,21,2001,0.3,1,0,1,0,0,1,1,100.0,0,0,0,0,0,1,2,0
Claudio Bravo,CHI,GK,Betis,La Liga,40,1983,7.0,0,0,0,0,0,0,1,0.0,1,0,0,0,0,0,2,0
Fabian Bredlow,GER,GK,Stuttgart,Bundesliga,28,1995,4.0,0,0,0,0,0,0,1,0.0,1,0,0,0,0,0,3,0
Tim Breithaupt,GER,MF,Augsburg,Bundesliga,21,2002,7.0,20,11,11,9,0,13,21,61.9,8,15,3,12,8,28,10,0
Josip Brekalo,CRO,FW,Fiorentina,Serie A,25,1998,7.2,8,6,6,2,0,2,11,18.2,9,7,0,7,1,9,0,0
Gleison Bremer,BRA,DF,Juventus,Serie A,26,1997,35.9,58,42,32,21,5,21,29,72.4,8,45,27,18,40,98,147,0
Brenner,BRA,"MF,FW",Udinese,Serie A,23,2000,2.1,8,7,1,5,2,4,7,57.1,3,2,0,2,0,8,2,0
Ben Brereton,CHI,"FW,MF",Sheffield Utd,Premier League,24,1999,12.3,9,4,4,4,1,4,10,40.0,6,9,3,6,3,12,12,0
Ben Brereton,CHI,"FW,MF",Villarreal,La Liga,24,1999,3.0,2,2,1,0,1,0,2,0.0,2,0,0,0,0,2,0,0
Marco Brescianini,ITA,MF,Frosinone,Serie A,23,2000,25.8,28,13,13,12,3,9,25,36.0,16,22,5,17,10,38,37,0
Maximilian Breunig,GER,FW,Freiburg,Bundesliga,22,2000,0.1,0,0,0,0,0,0,0,,0,1,0,1,0,0,0,0
Rhian Brewster,ENG,"FW,MF",Sheffield Utd,Premier League,23,2000,3.8,5,1,1,2,2,0,2,0.0,2,2,0,2,1,6,2,0
Bennit Bröger,GER,FW,Wolfsburg,Bundesliga,17,2006,0.1,0,0,0,0,0,0,0,,0,0,0,0,0,0,0,0
Armando Broja,ALB,FW,Chelsea,Premier League,21,2001,5.0,3,0,0,1,2,1,2,50.0,1,5,1,4,0,3,3,0
Armando Broja,ALB,FW,Fulham,Premier League,21,2001,1.0,0,0,0,0,0,0,0,,0,1,0,1,0,0,0,0
Dylan Bronn,TUN,"DF,MF",Salernitana,Serie A,28,1995,0.6,0,0,0,0,0,0,1,0.0,1,2,0,2,0,0,4,0
Andre Brooks,ENG,"MF,DF",Sheffield Utd,Premier League,19,2003,10.4,22,13,7,11,4,9,21,42.9,12,13,1,12,14,36,20,0
David Brooks,WAL,"FW,MF",Bournemouth,Premier League,26,1997,3.1,5,4,2,1,2,2,4,50.0,2,3,0,3,2,7,2,0
John Brooks,USA,DF,Hoffenheim,Bundesliga,30,1993,17.1,28,15,17,10,1,15,30,50.0,15,29,17,12,27,55,109,1
Moritz Broschinski,GER,FW,Bochum,Bundesliga,22,2000,13.9,11,7,2,5,4,2,8,25.0,6,11,2,9,0,11,6,0
Jacob Brown,SCO,"MF,FW",Luton Town,Premier League,25,1998,11.3,19,12,7,7,5,7,18,38.9,11,20,1,19,8,27,22,0
Josh Brownhill,ENG,MF,Burnley,Premier League,27,1995,25.0,61,35,23,28,10,27,37,73.0,10,33,8,25,34,95,40,1
Alexander Brunst,GER,GK,Darmstadt 98,Bundesliga,28,1995,3.0,0,0,0,0,0,0,2,0.0,2,0,0,0,0,0,2,1
Jacob Bruun Larsen,DEN,"MF,FW",Burnley,Premier League,24,1998,13.9,9,4,4,3,2,7,21,33.3,14,16,2,14,7,16,23,0
Tajon Buchanan,CAN,DF,Inter,Serie A,24,1999,1.8,1,1,0,0,1,1,2,50.0,1,1,0,1,0,1,4,0
Ante Budimir,CRO,FW,Osasuna,La Liga,32,1991,27.1,21,15,2,11,8,5,14,35.7,9,19,5,14,5,26,18,0
Hugo Bueno,ESP,"DF,MF",Wolves,Premier League,20,2002,8.2,21,14,12,7,2,12,19,63.2,7,17,4,13,6,27,24,0
Manu Bueno,ESP,MF,Sevilla,La Liga,19,2004,1.3,4,2,4,0,0,3,3,100.0,0,3,0,3,0,4,1,0
Santiago Bueno,URU,DF,Wolves,Premier League,24,1998,9.1,13,7,5,7,1,5,11,45.5,6,22,12,10,6,19,33,0
Marius Bülter,GER,"DF,FW",Hoffenheim,Bundesliga,30,1993,15.0,18,11,9,5,4,12,23,52.2,11,17,3,14,10,28,20,0
Facundo Buonanotte,ARG,"FW,MF",Brighton,Premier League,18,2004,15.2,42,22,13,22,7,14,44,31.8,30,22,3,19,8,50,5,0
Alessandro Buongiorno,ITA,DF,Torino,Serie A,24,1999,28.1,70,39,43,24,3,24,34,70.6,10,20,12,8,69,139,131,0
Jonathan Burkardt,GER,"FW,MF",Mainz 05,Bundesliga,23,2000,17.1,12,8,2,6,4,4,11,36.4,7,16,3,13,3,15,2,0
Oliver Burke,SCO,FW,Werder Bremen,Bundesliga,26,1997,0.4,0,0,0,0,0,0,2,0.0,2,0,0,0,0,0,0,0
Reece Burke,ENG,DF,Luton Town,Premier League,26,1996,18.4,37,23,17,14,6,12,26,46.2,14,25,18,7,18,55,78,1
Dan Burn,ENG,DF,Newcastle Utd,Premier League,31,1992,30.3,61,33,37,20,4,26,61,42.6,35,55,25,30,37,98,124,1
Rareș-Cătălin Burnete,ROU,FW,Lecce,Serie A,19,2004,0.1,0,0,0,0,0,0,0,,0,0,0,0,0,0,0,0
Mason Burstow,ENG,FW,Chelsea,Premier League,19,2003,0.1,0,0,0,0,0,0,0,,0,0,0,0,0,0,0,0
Marnon Busch,GER,DF,Heidenheim,Bundesliga,28,1994,6.6,11,9,6,3,2,7,12,58.3,5,9,2,7,10,21,12,0
Maxime Busi,BEL,"FW,DF",Reims,Ligue 1,23,1999,1.8,2,0,0,1,1,0,2,0.0,2,6,1,5,4,6,5,0
Pablo Busto,ESP,DF,Betis,La Liga,17,2005,0.5,1,1,0,0,1,1,1,100.0,0,0,0,0,1,2,3,0
Aurélio Buta,POR,"DF,MF",Eint Frankfurt,Bundesliga,26,1997,19.4,40,25,19,16,5,21,38,55.3,17,24,5,19,15,55,36,0
Marcin Bułka,POL,GK,Nice,Ligue 1,23,1999,34.0,0,0,0,0,0,0,2,0.0,2,0,0,0,0,0,9,3
Rémy Cabella,FRA,"FW,MF",Lille,Ligue 1,33,1990,16.4,54,36,19,20,15,20,54,37.0,34,32,0,32,5,59,5,0
Jovane Cabral,CPV,"MF,FW",Salernitana,Serie A,25,1998,7.5,13,9,4,7,2,3,9,33.3,6,3,0,3,1,14,4,0
Liberato Cacace,NZL,DF,Empoli,Serie A,22,2000,21.2,40,24,24,13,3,24,38,63.2,14,23,6,17,19,59,56,0
Anthony Caci,FRA,DF,Mainz 05,Bundesliga,26,1997,27.6,56,23,30,25,1,27,44,61.4,17,43,7,36,32,88,45,0
Moisés Caicedo,ECU,MF,Chelsea,Premier League,21,2001,31.8,91,46,38,42,11,36,60,60.0,24,59,25,34,37,128,44,4
Tom Cairney,SCO,MF,Fulham,Premier League,32,1991,16.5,24,16,10,12,2,13,25,52.0,12,16,4,12,13,37,6,0
Jens Cajuste,SWE,MF,Napoli,Serie A,23,1999,11.3,36,24,13,17,6,20,37,54.1,17,20,3,17,4,40,15,0
Davide Calabria,ITA,DF,Milan,Serie A,26,1996,24.3,70,38,38,25,7,44,72,61.1,28,26,7,19,24,94,49,1
Riccardo Calafiori,ITA,DF,Bologna,Serie A,21,2002,26.1,47,32,28,16,3,22,32,68.8,10,38,13,25,50,97,74,3
Mattia Caldara,ITA,DF,Milan,Serie A,29,1994,0.4,1,1,1,0,0,1,1,100.0,0,1,1,0,1,2,1,0
Luca Caldirola,ITA,DF,Monza,Serie A,32,1991,23.8,25,14,19,4,2,13,22,59.1,9,26,17,9,29,54,53,0
Duje Ćaleta-Car,CRO,DF,Lyon,Ligue 1,26,1996,22.1,26,11,19,6,1,18,22,81.8,4,27,14,13,18,44,94,1
Hakan Çalhanoğlu,TUR,MF,Inter,Serie A,29,1994,28.4,66,33,29,29,8,32,49,65.3,17,29,13,16,24,90,22,0
José Callejón,ESP,"MF,FW",Granada,La Liga,36,1987,8.9,13,6,10,3,0,8,22,36.4,14,7,1,6,5,18,10,0
Dominic Calvert-Lewin,ENG,FW,Everton,Premier League,26,1997,24.1,13,6,2,6,5,2,15,13.3,13,14,4,10,4,17,38,0
Lamine Camara,SEN,MF,Metz,Ligue 1,19,2004,25.1,62,42,26,30,6,24,49,49.0,25,35,2,33,28,90,34,0
Mahdi Camara,FRA,MF,Brest,Ligue 1,25,1998,22.4,55,39,8,40,7,20,49,40.8,29,24,1,23,27,82,19,0
Mohamed Camara,MLI,MF,Monaco,Ligue 1,23,2000,11.5,35,21,10,20,5,15,29,51.7,14,8,2,6,11,46,7,0
Francesco Camarda,ITA,FW,Milan,Serie A,15,2008,0.2,0,0,0,0,0,0,2,0.0,2,0,0,0,0,0,0,0
Eduardo Camavinga,FRA,"MF,DF",Real Madrid,La Liga,20,2002,20.2,76,47,39,29,8,23,39,59.0,16,36,8,28,29,105,29,1
Nicolò Cambiaghi,ITA,"FW,MF",Empoli,Serie A,22,2000,28.4,51,39,15,20,16,16,35,45.7,19,26,1,25,14,65,8,0
Andrea Cambiaso,ITA,"DF,FW",Juventus,Serie A,23,2000,26.4,47,30,23,15,9,25,43,58.1,18,28,3,25,11,58,26,1
Axel Camblan,FRA,FW,Brest,Ligue 1,19,2003,1.0,3,1,0,2,1,2,4,50.0,2,2,0,2,0,3,0,0
Sergio Camello,ESP,FW,Rayo Vallecano,La Liga,22,2001,18.5,16,5,3,10,3,6,15,40.0,9,10,2,8,3,19,15,0
José Campaña,ESP,MF,Las Palmas,La Liga,30,1993,1.9,2,2,1,1,0,0,2,0.0,2,3,2,1,2,4,3,0
Emre Can,GER,"MF,DF",Dortmund,Bundesliga,29,1994,21.7,63,45,37,23,3,28,48,58.3,20,30,7,23,22,85,41,2
Matteo Cancellieri,ITA,"FW,MF",Empoli,Serie A,21,2002,19.9,35,22,12,16,7,13,36,36.1,23,19,0,19,6,41,18,0
João Cancelo,POR,DF,Barcelona,La Liga,29,1994,27.8,64,44,35,21,8,38,58,65.5,20,35,6,29,29,93,59,1
Fali Candé,GNB,DF,Metz,Ligue 1,25,1998,20.5,40,19,31,9,0,20,35,57.1,15,41,28,13,20,60,107,1
Antonio Candreva,ITA,"MF,FW",Salernitana,Serie A,36,1987,30.6,18,13,8,8,2,9,25,36.0,16,9,0,9,7,25,23,0
Thomas Cannon,IRL,FW,Everton,Premier League,20,2002,0.0,0,0,0,0,0,0,0,,0,0,0,0,0,0,0,0
Sergi Canós,ESP,"MF,FW",Valencia,La Liga,26,1997,13.7,23,13,7,11,5,10,24,41.7,14,14,2,12,11,34,9,0
Luigi Canotto,ITA,FW,Frosinone,Serie A,29,1994,0.2,0,0,0,0,0,0,0,,0,0,0,0,0,0,0,0
Gino Caoki,FRA,MF,Lorient,Ligue 1,19,2004,0.1,0,0,0,0,0,0,1,0.0,1,0,0,0,0,0,0,0
Étienne Capoue,FRA,MF,Villarreal,La Liga,35,1988,16.2,32,18,17,12,3,15,22,68.2,7,20,4,16,22,54,24,1
Gianluca Caprari,ITA,"MF,FW",Monza,Serie A,30,1993,3.2,2,1,1,1,0,0,1,0.0,1,0,0,0,2,4,0,0
Elia Caprile,ITA,GK,Empoli,Serie A,21,2001,23.0,1,0,1,0,0,1,1,100.0,0,0,0,0,0,1,16,2
Francesco Caputo,ITA,FW,Empoli,Serie A,35,1987,14.1,2,0,0,0,2,0,1,0.0,1,4,0,4,1,3,3,0
Maxence Caqueret,FRA,MF,Lyon,Ligue 1,23,2000,33.6,91,64,39,37,15,38,107,35.5,69,40,9,31,48,139,26,2
Andrea Carboni,ITA,DF,Monza,Serie A,22,2001,16.5,38,22,24,12,2,20,31,64.5,11,23,13,10,17,55,56,1
Valentin Carboni,ARG,"MF,FW",Monza,Serie A,18,2005,13.0,25,15,10,12,3,8,26,30.8,18,12,1,11,7,32,4,0
Isaac Carcelen,ESP,DF,Cádiz,La Liga,30,1993,29.0,50,31,30,15,5,25,45,55.6,20,24,7,17,27,77,87,2
Cárdenas,ESP,GK,Rayo Vallecano,La Liga,26,1997,1.0,0,0,0,0,0,0,0,,0,0,0,0,0,0,1,0
Irvin Cardona,FRA,"MF,DF",Augsburg,Bundesliga,25,1997,0.6,1,1,0,0,1,1,3,33.3,2,1,0,1,0,1,1,0
Marc Cardona,ESP,FW,Las Palmas,La Liga,28,1995,8.2,9,8,3,4,2,1,12,8.3,11,5,0,5,2,11,7,0
Sergi Cardona,ESP,DF,Las Palmas,La Liga,24,1999,31.3,90,55,52,29,9,55,96,57.3,41,45,7,38,46,136,102,0
Johnny Cardoso,USA,MF,Betis,La Liga,21,2001,14.8,48,29,19,24,5,22,33,66.7,11,20,5,15,32,80,31,0
Igor Carioca,BRA,"DF,MF",Lorient,Ligue 1,26,1996,2.9,8,6,6,1,1,4,6,66.7,2,0,0,0,3,11,6,0
Diego Carlos,BRA,DF,Aston Villa,Premier League,30,1993,20.2,27,16,22,4,1,13,21,61.9,8,24,19,5,13,40,78,3
Carmona,ESP,"DF,MF",Getafe,La Liga,21,2002,14.6,30,21,13,14,3,9,28,32.1,19,15,2,13,21,51,25,0
Marco Carnesecchi,ITA,GK,Atalanta,Serie A,23,2000,26.9,0,0,0,0,0,0,0,,0,0,0,0,0,0,22,3
Yannick Carrasco,BEL,DF,Atlético Madrid,La Liga,29,1993,2.5,4,4,3,1,0,2,7,28.6,5,2,0,2,1,5,6,0
Álvaro Carreras,ESP,"MF,FW",Granada,La Liga,20,2003,5.3,13,8,8,4,1,5,11,45.5,6,5,1,4,7,20,9,1
Rasmus Carstensen,DEN,"DF,FW",Köln,Bundesliga,22,2000,18.4,47,22,23,20,4,31,56,55.4,25,38,9,29,20,67,50,2
Antonin Cartillier,FRA,DF,Monaco,Ligue 1,19,2004,0.1,0,0,0,0,0,0,0,,0,1,0,1,0,0,0,0
Dani Carvajal,ESP,DF,Real Madrid,La Liga,31,1992,24.1,47,32,28,15,4,23,42,54.8,19,28,9,19,22,69,54,4
Fabio Carvalho,POR,MF,RB Leipzig,Bundesliga,20,2002,1.8,3,1,0,2,1,1,3,33.3,2,8,0,8,0,3,1,0
William Carvalho,POR,MF,Betis,La Liga,31,1992,7.6,20,12,11,7,2,10,16,62.5,6,8,1,7,8,28,9,1
Cesare Casadei,ITA,"FW,MF",Chelsea,Premier League,20,2003,0.9,5,3,2,1,2,2,5,40.0,3,1,0,1,0,5,4,0
Marc Casado,ESP,MF,Barcelona,La Liga,19,2003,0.2,1,1,1,0,0,1,1,100.0,0,0,0,0,1,2,2,0
Nicolò Casale,ITA,DF,Lazio,Serie A,25,1998,17.3,15,9,13,2,0,6,15,40.0,9,19,16,3,12,27,61,0
Casemiro,BRA,"MF,DF",Manchester Utd,Premier League,31,1992,22.0,83,56,43,32,8,51,106,48.1,55,74,33,41,18,101,71,1
Kaelan Casey,ENG,DF,West Ham,Premier League,18,2004,0.0,0,0,0,0,0,0,0,,0,0,0,0,0,0,1,0
Matty Cash,POL,DF,Aston Villa,Premier League,25,1997,23.8,54,31,24,24,6,29,59,49.2,30,35,14,21,18,72,59,0
Josué Casimir,FRA,"FW,DF",Le Havre,Ligue 1,21,2001,22.4,31,18,14,14,3,7,18,38.9,11,23,2,21,13,44,25,0
Giuseppe Caso,ITA,"FW,MF",Frosinone,Serie A,24,1998,4.6,4,3,2,0,2,2,3,66.7,1,0,0,0,0,4,0,0
Cristian Cásseres Jr.,VEN,MF,Toulouse,Ligue 1,23,2000,21.6,70,34,31,33,6,29,61,47.5,32,34,4,30,27,97,33,1
Timothy Castagne,BEL,DF,Fulham,Premier League,27,1995,29.3,49,24,23,16,10,26,44,59.1,18,38,10,28,38,87,69,1
Koen Casteels,BEL,GK,Wolfsburg,Bundesliga,31,1992,25.0,2,1,2,0,0,2,3,66.7,1,0,0,0,0,2,16,5
Valentín Castellanos,ARG,FW,Lazio,Serie A,24,1998,18.7,22,10,1,12,9,6,20,30.0,14,22,2,20,2,24,18,0
Jean-Charles Castelletto,CMR,DF,Nantes,Ligue 1,28,1995,27.4,34,26,22,10,2,18,29,62.1,11,19,10,9,32,66,81,0
Samu Castillejo,ESP,"FW,MF",Sassuolo,Serie A,28,1995,6.0,12,10,5,5,2,7,19,36.8,12,16,1,15,1,13,3,0
Jonny Castro,ESP,MF,Wolves,Premier League,29,1994,0.1,0,0,0,0,0,0,1,0.0,1,1,1,0,0,0,0,0
Santiago Castro,ARG,FW,Bologna,Serie A,18,2004,2.7,2,1,0,1,1,1,3,33.3,2,1,0,1,1,3,1,0
Gaetano Castrovilli,ITA,"FW,MF",Fiorentina,Serie A,26,1997,4.1,3,2,1,2,0,1,8,12.5,7,4,0,4,2,5,3,0
Danilo Cataldi,ITA,MF,Lazio,Serie A,28,1994,15.1,24,12,7,16,1,8,18,44.4,10,15,7,8,17,41,19,1
Catena,ESP,DF,Osasuna,La Liga,28,1994,28.2,33,18,26,6,1,19,35,54.3,16,24,15,9,15,48,119,3
Maximiliano Caufriez,BEL,DF,Clermont Foot,Ligue 1,26,1997,18.4,38,28,31,5,2,19,29,65.5,10,18,12,6,18,56,69,2
Ivan Cavaleiro,POR,FW,Lille,Ligue 1,29,1993,8.6,10,6,3,4,3,7,20,35.0,13,9,2,7,5,15,6,0
Dani Ceballos,ESP,"MF,FW",Real Madrid,La Liga,26,1996,6.6,10,5,4,5,1,5,14,35.7,9,9,2,7,0,10,4,1
Emil Ceide,NOR,"FW,MF",Sassuolo,Serie A,21,2001,2.0,2,2,1,1,0,1,1,100.0,0,6,1,5,0,2,0,0
Zeki Çelik,TUR,DF,Roma,Serie A,26,1997,7.5,23,16,10,10,3,14,25,56.0,11,12,5,7,8,31,25,0
Álex Centelles,ESP,DF,Almería,La Liga,25,1997,10.9,11,6,9,2,0,8,18,44.4,10,5,2,3,18,29,29,0
Fabien Centonze,FRA,DF,Hellas Verona,Serie A,27,1996,7.5,14,8,10,4,0,5,10,50.0,5,14,2,12,10,24,18,0
Fabien Centonze,FRA,DF,Nantes,Ligue 1,27,1996,1.0,2,1,2,0,0,2,3,66.7,1,2,1,1,0,2,1,0
Václav Černý,CZE,"FW,MF",Wolfsburg,Bundesliga,25,1997,10.2,8,3,3,4,1,2,14,14.3,12,13,0,13,8,16,6,0
Michele Cerofolini,ITA,GK,Frosinone,Serie A,24,1999,7.5,0,0,0,0,0,0,0,,0,0,0,0,0,0,5,1
Alberto Cerri,ITA,FW,Empoli,Serie A,27,1996,6.1,3,3,1,1,1,2,5,40.0,3,3,1,2,3,6,7,0
Leonardo Cerri,ITA,DF,Juventus,Serie A,20,2003,0.1,0,0,0,0,0,0,0,,0,0,0,0,0,0,0,0
Franco Cervi,ARG,"MF,DF",Celta Vigo,La Liga,29,1994,6.1,24,18,13,9,2,13,24,54.2,11,16,0,16,9,33,4,0
Julian Chabot,GER,DF,Köln,Bundesliga,25,1998,30.0,59,42,40,17,2,35,59,59.3,24,66,43,23,45,104,145,0
El Chadaille Bitshiabu,FRA,"DF,MF",RB Leipzig,Bundesliga,18,2005,0.4,1,0,1,0,0,0,0,,0,0,0,0,1,2,4,0
Fares Chaïbi,ALG,"FW,MF",Toulouse,Ligue 1,20,2002,0.6,0,0,0,0,0,0,0,,0,0,0,0,0,0,2,0
Fares Chaïbi,ALG,"MF,FW",Eint Frankfurt,Bundesliga,20,2002,21.2,27,17,7,12,8,8,18,44.4,10,37,1,36,5,32,19,0
Trevoh Chalobah,ENG,DF,Chelsea,Premier League,24,1999,10.6,16,12,10,2,4,10,15,66.7,5,8,7,1,8,24,51,0
Muhammed Cham,AUT,"MF,FW",Clermont Foot,Ligue 1,22,2000,28.4,25,14,10,13,2,11,27,40.7,16,20,2,18,8,33,5,1
Calum Chambers,ENG,"MF,DF",Aston Villa,Premier League,28,1995,1.7,3,0,3,0,0,0,1,0.0,1,2,1,1,2,5,4,0
Timothy Chandler,USA,"MF,DF",Eint Frankfurt,Bundesliga,33,1990,0.2,0,0,0,0,0,0,0,,0,0,0,0,0,0,0,0
Brendan Chardonnet,FRA,DF,Brest,Ligue 1,28,1994,33.0,57,34,33,22,2,32,63,50.8,31,58,34,24,53,110,139,3
Charlys,BRA,MF,Hellas Verona,Serie A,19,2004,0.3,0,0,0,0,0,0,0,,0,0,0,0,1,1,0,0
Pep Chavarría,ESP,"DF,MF",Rayo Vallecano,La Liga,25,1998,13.0,23,18,15,6,2,11,17,64.7,6,15,3,12,6,29,29,1
Jhoanner Chávez,ECU,DF,Lens,Ligue 1,21,2002,5.3,6,5,2,2,2,3,9,33.3,6,2,0,2,5,11,11,0
Walid Cheddira,MAR,FW,Frosinone,Serie A,25,1998,23.6,12,7,1,8,3,4,8,50.0,4,6,1,5,5,17,10,0
Rayan Cherki,FRA,"MF,FW",Lyon,Ligue 1,19,2003,19.1,28,15,4,16,8,17,46,37.0,29,13,3,10,7,35,1,0
Youssef Chermiti,POR,FW,Everton,Premier League,19,2004,2.3,3,2,2,1,0,1,5,20.0,4,4,1,3,1,4,2,0
Lucas Chevalier,FRA,GK,Lille,Ligue 1,21,2001,33.0,3,0,3,0,0,3,4,75.0,1,1,0,1,0,3,11,2
Fabio Chiarodia,ITA,DF,Gladbach,Bundesliga,18,2005,1.7,8,5,5,1,2,5,7,71.4,2,2,1,1,3,11,9,0
Federico Chiesa,ITA,FW,Juventus,Serie A,25,1997,24.4,20,10,7,6,7,3,13,23.1,10,17,1,16,6,26,4,0
Ben Chilwell,ENG,DF,Chelsea,Premier League,26,1996,8.4,15,10,5,9,1,5,8,62.5,3,11,3,8,4,19,19,1
Tawanda Chirewa,ZIM,"MF,FW",Wolves,Premier League,19,2003,1.6,7,3,3,3,1,2,3,66.7,1,0,0,0,1,8,0,0
Pedro Chirivella,ESP,MF,Nantes,Ligue 1,26,1997,28.8,50,28,20,29,1,30,76,39.5,46,22,5,17,31,81,28,0
Leon Chiwome,ENG,FW,Wolves,Premier League,17,2006,1.9,2,1,0,1,1,1,2,50.0,1,3,1,2,0,2,2,0
Tahith Chong,NED,"MF,FW",Luton Town,Premier League,23,1999,22.0,36,22,19,13,4,15,33,45.5,18,30,6,24,8,44,11,1
Joris Chotard,FRA,MF,Montpellier,Ligue 1,21,2001,28.7,81,52,45,25,11,48,96,50.0,48,47,21,26,44,125,60,0
Andreas Christensen,DEN,"DF,MF",Barcelona,La Liga,27,1996,22.0,23,14,7,14,2,16,28,57.1,12,23,10,13,21,44,41,0
Jacob Christensen,DEN,MF,Köln,Bundesliga,22,2001,2.4,10,6,7,3,0,4,7,57.1,3,8,2,6,4,14,4,0
Oliver Christensen,DEN,GK,Fiorentina,Serie A,24,1999,4.0,0,0,0,0,0,0,0,,0,0,0,0,0,0,1,0
Ryan Christie,SCO,MF,Bournemouth,Premier League,28,1995,32.3,86,44,34,35,17,39,92,42.4,53,52,11,41,52,138,53,1
Carney Chukwuemeka,ENG,"MF,FW",Chelsea,Premier League,19,2003,2.5,6,4,3,3,0,1,3,33.3,2,1,1,0,0,6,1,0
Samuel Chukwueze,NGA,FW,Milan,Serie A,24,1999,11.3,18,7,11,5,2,9,17,52.9,8,3,1,2,6,24,3,0
Chumi,ESP,DF,Almería,La Liga,24,1999,27.0,34,22,22,12,0,16,26,61.5,10,38,23,15,14,48,107,3
Víctor Chust,ESP,DF,Cádiz,La Liga,23,2000,20.7,29,18,23,5,1,18,32,56.3,14,27,21,6,11,40,92,1
Pathé Ciss,SEN,MF,Rayo Vallecano,La Liga,29,1994,18.5,44,24,16,26,2,16,29,55.2,13,27,10,17,30,74,54,0
Alphadjo Cissè,ITA,FW,Hellas Verona,Serie A,16,2006,0.1,0,0,0,0,0,0,0,,0,0,0,0,0,0,0,0
Djaoui Cissé,FRA,MF,Rennes,Ligue 1,19,2004,0.0,0,0,0,0,0,0,0,,0,0,0,0,0,0,0,0
Ibrahim Cissoko,NED,"FW,MF",Toulouse,Ligue 1,20,2003,2.7,4,3,3,1,0,1,3,33.3,2,3,0,3,1,5,0,0
Giorgio Cittadini,ITA,DF,Monza,Serie A,21,2002,0.2,1,1,1,0,0,1,1,100.0,0,1,1,0,0,1,0,0
Giorgio Cittadini,ITA,DF,Genoa,Serie A,21,2002,1.2,5,4,4,1,0,3,3,100.0,0,1,0,1,3,8,5,0
Patrick Ciurria,ITA,"DF,MF",Monza,Serie A,28,1995,17.8,30,18,13,13,4,13,21,61.9,8,20,5,15,9,39,28,0
Bobby Clark,ENG,MF,Liverpool,Premier League,18,2005,1.0,2,1,1,1,0,1,5,20.0,4,6,2,4,1,3,1,0
Jordan Clark,ENG,MF,Luton Town,Premier League,29,1993,14.5,30,17,14,11,5,11,39,28.2,28,24,3,21,11,41,15,1
Alexis Claude-Maurice,FRA,MF,Nice,Ligue 1,25,1998,5.6,12,5,3,6,3,1,5,20.0,4,4,1,3,5,17,7,0
Jonathan Clauss,FRA,DF,Marseille,Ligue 1,30,1992,23.0,47,20,22,19,6,26,49,53.1,23,17,3,14,36,83,46,0
Silvi Clúa,ESP,MF,Girona,La Liga,18,2005,0.0,2,0,2,0,0,2,2,100.0,0,1,0,1,0,2,0,0
Nathaniel Clyne,ENG,DF,Crystal Palace,Premier League,32,1991,14.9,24,15,11,11,2,14,21,66.7,7,18,6,12,10,34,33,0
Marcus Coco,FRA,"DF,FW",Nantes,Ligue 1,27,1996,16.5,43,26,29,10,4,28,60,46.7,32,19,1,18,21,64,38,0
Saúl Coco,EQG,DF,Las Palmas,La Liga,24,1999,25.5,32,19,25,7,0,11,18,61.1,7,27,15,12,20,52,120,3
Séamus Coleman,IRL,DF,Everton,Premier League,34,1988,7.4,17,14,10,3,4,11,16,68.8,5,12,4,8,7,24,26,1
Maxime Colin,FRA,DF,Metz,Ligue 1,31,1991,20.4,39,23,25,7,7,16,29,55.2,13,22,7,15,20,59,71,0
Nathan Collins,IRL,DF,Brentford,Premier League,22,2001,29.5,38,20,24,12,2,19,29,65.5,10,46,30,16,44,82,141,4
Nnamdi Collins,GER,DF,Eint Frankfurt,Bundesliga,19,2004,1.0,0,0,0,0,0,0,0,,0,0,0,0,2,2,4,0
Lorenzo Colombo,ITA,FW,Monza,Serie A,21,2002,15.1,17,12,3,9,5,8,14,57.1,6,18,5,13,0,17,14,0
Andrea Colpani,ITA,"MF,FW",Monza,Serie A,24,1999,29.5,25,15,6,13,6,11,20,55.0,9,11,4,7,14,39,14,0
Levi Colwill,ENG,DF,Chelsea,Premier League,20,2003,20.0,48,30,26,17,5,26,34,76.5,8,28,10,18,26,74,66,0
Kingsley Coman,FRA,FW,Bayern Munich,Bundesliga,27,1996,12.4,12,7,5,3,4,9,17,52.9,8,15,1,14,2,14,5,0
Eray Cömert,SUI,DF,Nantes,Ligue 1,25,1998,22.2,42,28,28,13,1,28,38,73.7,10,35,18,17,36,78,77,1
Santi Comesaña,ESP,MF,Villarreal,La Liga,26,1996,18.4,44,26,15,21,8,19,38,50.0,19,33,9,24,22,66,27,1
Pietro Comuzzo,ITA,"DF,FW",Fiorentina,Serie A,18,2005,0.5,1,1,1,0,0,1,1,100.0,0,1,0,1,1,2,2,0
Alois Confais,FRA,"MF,FW",Le Havre,Ligue 1,26,1996,0.1,2,2,1,1,0,1,1,100.0,0,0,0,0,0,2,0,0
Andrea Consigli,ITA,GK,Sassuolo,Serie A,36,1987,35.0,0,0,0,0,0,0,0,,0,1,0,1,1,1,19,1
Bambasé Conté,GER,"MF,FW",Hoffenheim,Bundesliga,20,2003,0.5,3,3,2,0,1,1,1,100.0,0,0,0,0,0,3,0,0
Nikita Contini Baranovsky,ITA,GK,Napoli,Serie A,27,1996,0.2,0,0,0,0,0,0,0,,0,0,0,0,0,0,1,0
Lewis Cook,ENG,MF,Bournemouth,Premier League,26,1997,31.0,61,41,24,30,7,34,63,54.0,29,32,11,21,65,126,46,1
Copete,ESP,DF,Mallorca,La Liga,23,1999,14.8,45,27,27,17,1,30,43,69.8,13,12,6,6,32,77,47,1
Diego Coppola,ITA,DF,Hellas Verona,Serie A,19,2003,18.2,36,22,25,9,2,20,33,60.6,13,26,9,17,27,63,89,1
Francis Coquelin,FRA,MF,Villarreal,La Liga,32,1991,10.1,20,12,8,10,2,5,13,38.5,8,14,4,10,16,36,15,0
Tommaso Corazza,ITA,DF,Bologna,Serie A,19,2004,2.2,10,4,9,1,0,4,9,44.4,5,2,0,2,5,15,3,0
Theo Corbeanu,CAN,"MF,FW",Granada,La Liga,21,2002,2.0,5,2,2,3,0,1,3,33.3,2,3,0,3,3,8,2,0
Jeppe Corfitzen,DEN,FW,Lecce,Serie A,18,2004,0.1,1,0,0,1,0,1,1,100.0,0,0,0,0,0,1,0,0
Jack Cork,ENG,MF,Burnley,Premier League,34,1989,0.3,2,0,0,2,0,1,3,33.3,2,0,0,0,1,3,1,0
Maxwel Cornet,CIV,"MF,FW",West Ham,Premier League,26,1996,1.2,3,2,3,0,0,1,5,20.0,4,2,0,2,2,5,1,0
Giacomo Corona,ITA,FW,Empoli,Serie A,19,2004,0.1,0,0,0,0,0,0,0,,0,0,0,0,0,0,0,0
Jesús Corona,MEX,"MF,DF",Sevilla,La Liga,30,1993,0.2,0,0,0,0,0,0,0,,0,0,0,0,1,1,0,0
Ángel Correa,ARG,"FW,MF",Atlético Madrid,La Liga,28,1995,17.0,22,15,3,11,8,5,17,29.4,12,13,0,13,2,24,6,0
Joaquín Correa,ARG,"FW,MF",Marseille,Ligue 1,28,1994,4.8,7,5,4,2,1,0,8,0.0,8,2,0,2,1,8,1,0
Thierry Correia,POR,DF,Valencia,La Liga,24,1999,23.9,63,35,39,20,4,28,49,57.1,21,39,16,23,33,96,61,0
Oscar Cortés,COL,"FW,MF",Lens,Ligue 1,19,2003,0.5,0,0,0,0,0,0,0,,0,1,0,1,0,0,0,0
Danny da Costa,GER,DF,Mainz 05,Bundesliga,30,1993,9.2,18,9,9,7,2,9,19,47.4,10,17,4,13,16,34,24,0
David Costa,POR,MF,Lens,Ligue 1,22,2001,16.6,18,10,5,12,1,10,23,43.5,13,21,4,17,16,34,8,1
Jaume Costa,ESP,DF,Mallorca,La Liga,35,1988,18.7,38,22,23,10,5,18,29,62.1,11,14,4,10,16,54,35,0
João Costa,BRA,"MF,FW",Roma,Serie A,18,2005,0.2,0,0,0,0,0,0,0,,0,0,0,0,0,0,0,0
Logan Costa,CPV,DF,Toulouse,Ligue 1,22,2001,29.4,40,24,31,9,0,15,24,62.5,9,42,27,15,23,63,120,1
Samu Costa,POR,MF,Mallorca,La Liga,22,2000,25.6,91,50,40,46,5,46,93,49.5,47,28,14,14,39,130,59,3
Benoît Costil,FRA,GK,Salernitana,Serie A,36,1987,13.0,2,1,1,1,0,2,3,66.7,1,0,0,0,0,2,5,1
Grégoire Coudert,FRA,GK,Brest,Ligue 1,24,1999,2.0,0,0,0,0,0,0,0,,0,0,0,0,0,0,0,0
Vladimír Coufal,CZE,DF,West Ham,Premier League,30,1992,34.8,64,41,50,12,2,38,75,50.7,37,49,15,34,43,107,97,0
Lassana Coulibaly,MLI,MF,Salernitana,Serie A,27,1996,23.1,47,32,20,21,6,22,49,44.9,27,23,5,18,16,63,29,0
Mamadou Coulibaly,SEN,DF,Salernitana,Serie A,24,1999,0.0,0,0,0,0,0,0,0,,0,0,0,0,0,0,0,0
Mamadou Coulibaly,FRA,MF,Monaco,Ligue 1,19,2004,1.3,7,4,2,3,2,3,8,37.5,5,4,0,4,0,7,0,0
Tanguy Coulibaly,FRA,"FW,MF",Montpellier,Ligue 1,22,2001,6.9,13,11,8,4,1,4,9,44.4,5,11,1,10,2,15,2,0
Thibaut Courtois,BEL,GK,Real Madrid,La Liga,31,1992,3.7,1,0,1,0,0,0,0,,0,0,0,0,0,1,0,0
Philippe Coutinho,BRA,"MF,FW",Aston Villa,Premier League,31,1992,0.3,0,0,0,0,0,0,1,0.0,1,0,0,0,0,0,0,0
Yan Couto,BRA,"DF,FW",Girona,La Liga,21,2002,24.9,45,34,25,14,6,20,40,50.0,20,14,2,12,10,55,31,1
Nicolas Cozza,FRA,DF,Nantes,Ligue 1,24,1999,9.9,35,23,23,10,2,17,24,70.8,7,7,0,7,14,49,32,0
Nicolas Cozza,FRA,DF,Wolfsburg,Bundesliga,24,1999,3.1,8,6,4,4,0,2,7,28.6,5,3,0,3,4,12,6,0
Alessio Cragno,ITA,GK,Sassuolo,Serie A,29,1994,3.0,0,0,0,0,0,0,0,,0,0,0,0,0,0,3,1
Crespo,POR,MF,Rayo Vallecano,La Liga,26,1996,5.9,16,9,8,6,2,9,17,52.9,8,15,6,9,10,26,7,0
Aaron Cresswell,ENG,"DF,FW",West Ham,Premier League,33,1989,4.8,3,2,1,1,1,2,3,66.7,1,5,3,2,3,6,7,0
Bryan Cristante,ITA,"MF,DF",Roma,Serie A,28,1995,36.5,72,41,33,28,11,28,50,56.0,22,36,6,30,25,97,55,2
Cristian,ESP,GK,Valencia,La Liga,25,1998,0.6,0,0,0,0,0,0,0,,0,0,0,0,0,0,0,0
Juan Cruz Armada,ESP,DF,Osasuna,La Liga,31,1992,18.5,27,15,16,10,1,17,25,68.0,8,14,7,7,12,39,39,1
Juan Cruz,ARG,"FW,MF",Hellas Verona,Serie A,24,1999,1.2,2,2,0,0,2,0,0,,0,1,0,1,1,3,0,0
Juan Cruz,ESP,FW,Betis,La Liga,23,2000,0.8,0,0,0,0,0,0,1,0.0,1,0,0,0,0,0,0,0
Juan Cuadrado,COL,DF,Inter,Serie A,35,1988,3.0,4,3,2,2,0,3,5,60.0,2,6,1,5,1,5,2,0
Pau Cubarsí,ESP,DF,Barcelona,La Liga,16,2007,17.3,22,14,18,3,1,13,18,72.2,5,20,16,4,12,34,65,0
Marc Cucurella,ESP,DF,Chelsea,Premier League,25,1998,19.8,62,38,36,21,5,34,64,53.1,30,36,13,23,22,84,48,0
Iván Cuéllar,ESP,GK,Mallorca,La Liga,39,1984,1.0,0,0,0,0,0,0,0,,0,0,0,0,0,0,0,0
Jorge Cuenca,ESP,DF,Villarreal,La Liga,23,1999,21.8,42,29,26,10,6,19,30,63.3,11,26,15,11,21,63,114,0
Josh Cullen,IRL,MF,Burnley,Premier League,27,1996,22.9,42,29,15,22,5,26,46,56.5,20,31,19,12,15,57,26,1
Matheus Cunha,BRA,"FW,MF",Wolves,Premier League,24,1999,27.1,30,16,8,17,5,13,35,37.1,22,28,7,21,13,43,21,1
Marvin Cuni,ALB,FW,Frosinone,Serie A,22,2001,5.9,8,3,1,3,4,3,4,75.0,1,10,1,9,1,9,0,0
Eric Curbelo,ESP,"DF,MF",Las Palmas,La Liga,29,1994,1.1,4,3,2,2,0,3,4,75.0,1,3,1,2,2,6,5,1
Sam Curtis,IRL,DF,Sheffield Utd,Premier League,17,2005,0.3,1,0,1,0,0,1,2,50.0,1,2,0,2,0,1,0,0
Tomáš Čvančara,CZE,FW,Gladbach,Bundesliga,22,2000,10.0,4,3,0,2,2,1,3,33.3,2,5,1,4,2,6,8,0
Danilo D'Ambrosio,ITA,DF,Monza,Serie A,34,1988,17.1,57,34,34,20,3,28,41,68.3,13,22,13,9,14,71,31,0
Alberto Dadie,ESP,MF,Real Sociedad,La Liga,21,2002,0.3,2,1,2,0,0,0,0,,0,1,0,1,0,2,0,0
Trévis Dago,CIV,"FW,MF",Lille,Ligue 1,18,2005,0.3,0,0,0,0,0,0,0,,0,0,0,0,1,1,0,0
Finn Dahmen,GER,GK,Augsburg,Bundesliga,25,1998,31.0,1,0,1,0,0,1,3,33.3,2,0,0,0,0,1,17,5
Mahmoud Dahoud,GER,MF,Brighton,Premier League,27,1996,5.0,9,4,2,4,3,3,9,33.3,6,4,1,3,1,10,5,0
Mahmoud Dahoud,GER,MF,Stuttgart,Bundesliga,27,1996,2.5,5,1,1,4,0,3,7,42.9,4,4,0,4,0,5,1,0
Ameen Al-Dakhil,BEL,DF,Burnley,Premier League,21,2002,11.7,12,5,4,7,1,1,10,10.0,9,13,6,7,12,24,38,2
Thijs Dallinga,NED,FW,Toulouse,Ligue 1,22,2000,27.9,29,15,6,11,12,9,15,60.0,6,11,4,7,3,32,35,0
Diogo Dalot,POR,DF,Manchester Utd,Premier League,24,1999,35.3,81,51,58,12,11,51,74,68.9,23,44,16,28,37,118,111,0
Mikkel Damsgaard,DEN,MF,Brentford,Premier League,23,2000,9.4,29,17,13,9,7,14,40,35.0,26,23,1,22,11,40,10,1
Flavius Daniliuc,AUT,DF,Salernitana,Serie A,22,2001,8.3,19,11,12,5,2,9,19,47.4,10,13,4,9,8,27,15,0
Danilo,BRA,MF,Nott'ham Forest,Premier League,22,2001,19.9,36,18,22,12,2,21,46,45.7,25,33,8,25,35,71,42,0
Danilo,BRA,DF,Juventus,Serie A,32,1991,27.2,60,36,38,18,4,32,48,66.7,16,34,15,19,37,97,94,0
Arnaut Danjuma,NED,"MF,FW",Everton,Premier League,26,1997,6.6,6,4,2,3,1,1,4,25.0,3,4,0,4,3,9,0,0
Jayden Danns,ENG,FW,Liverpool,Premier League,17,2006,0.1,0,0,0,0,0,0,0,,0,0,0,0,0,0,0,0
Kevin Danso,AUT,DF,Lens,Ligue 1,24,1998,29.5,24,14,12,11,1,15,30,50.0,15,43,30,13,23,47,115,1
Dante,BRA,DF,Nice,Ligue 1,39,1983,31.6,62,30,44,16,2,38,52,73.1,14,43,22,21,37,99,77,2
Raimane Daou,COM,"DF,MF",Marseille,Ligue 1,18,2004,0.3,1,1,1,0,0,1,2,50.0,1,0,0,0,0,1,2,0
Mohammed Daramy,DEN,"FW,MF",Reims,Ligue 1,21,2002,18.3,10,9,4,4,2,6,16,37.5,10,5,1,4,4,14,4,0
Sergi Darder,ESP,MF,Mallorca,La Liga,29,1993,24.0,39,26,13,21,5,12,31,38.7,19,20,4,16,16,55,16,0
Achraf Dari,MAR,"DF,FW",Brest,Ligue 1,24,1999,1.3,1,1,1,0,0,0,2,0.0,2,2,0,2,5,6,9,1
Matteo Darmian,ITA,DF,Inter,Serie A,33,1989,26.7,48,22,23,15,10,20,53,37.7,33,27,11,16,13,61,55,0
Lukas Daschner,GER,"MF,FW",Bochum,Bundesliga,24,1998,6.0,9,4,2,3,4,4,9,44.4,5,7,0,7,2,11,2,0
Josh Dasilva,ENG,"DF,FW",Brentford,Premier League,24,1998,0.3,2,1,0,1,1,0,0,,0,0,0,0,0,2,0,0
David Datro Fofana,CIV,FW,Burnley,Premier League,20,2002,9.8,10,5,3,5,2,3,6,50.0,3,9,3,6,1,11,2,0
David Datro Fofana,CIV,"FW,MF",Union Berlin,Bundesliga,20,2002,7.6,10,7,3,5,2,4,9,44.4,5,4,0,4,0,10,5,0
Juan David Cabal,COL,DF,Hellas Verona,Serie A,22,2001,16.6,36,27,19,14,3,18,29,62.1,11,30,9,21,26,62,55,2
Jonathan David,CAN,FW,Lille,Ligue 1,23,2000,29.2,26,15,6,13,7,8,26,30.8,18,16,0,16,9,35,4,0
Alphonso Davies,CAN,DF,Bayern Munich,Bundesliga,22,2000,22.9,47,24,29,13,5,30,53,56.6,23,30,4,26,26,73,49,1
Ben Davies,WAL,DF,Tottenham,Premier League,30,1993,12.1,24,17,13,8,3,16,21,76.2,5,17,15,2,10,34,35,0
Tom Davies,ENG,MF,Sheffield Utd,Premier League,25,1998,2.5,10,5,4,3,3,3,9,33.3,6,2,1,1,3,13,6,1
Keinan Davis,ENG,"FW,MF",Udinese,Serie A,25,1998,2.1,0,0,0,0,0,0,0,,0,0,0,0,0,0,3,0
Paweł Dawidowicz,POL,DF,Hellas Verona,Serie A,28,1995,23.8,53,30,33,18,2,17,29,58.6,12,17,9,8,24,77,114,1
Craig Dawson,ENG,DF,Wolves,Premier League,33,1990,24.5,30,20,23,6,1,22,34,64.7,12,51,39,12,16,46,120,1
Kevin De Bruyne,BEL,MF,Manchester City,Premier League,32,1991,13.6,14,9,1,5,8,7,20,35.0,13,5,0,5,4,18,4,0
Charles De Ketelaere,BEL,"FW,MF",Atalanta,Serie A,22,2001,22.5,33,21,3,12,18,10,20,50.0,10,30,2,28,7,40,6,0
Rodrigo De Paul,ARG,MF,Atlético Madrid,La Liga,29,1994,23.1,31,21,11,14,6,15,38,39.5,23,28,1,27,11,42,15,2
Mattia De Sciglio,ITA,DF,Juventus,Serie A,30,1992,0.5,0,0,0,0,0,0,0,,0,1,0,1,1,1,2,0
Lorenzo De Silvestri,ITA,DF,Bologna,Serie A,35,1988,7.5,10,8,5,2,3,4,7,57.1,3,9,4,5,6,16,27,0
Thibault De Smet,BEL,DF,Reims,Ligue 1,25,1998,20.3,56,35,36,16,4,33,59,55.9,26,25,5,20,21,77,51,1
Koni De Winter,BEL,DF,Genoa,Serie A,21,2002,26.4,44,25,26,13,5,21,31,67.7,10,30,10,20,21,65,78,0
Grégoire Defrel,MTQ,"FW,MF",Sassuolo,Serie A,32,1991,8.4,17,8,7,5,5,7,15,46.7,8,10,0,10,3,20,9,0
Alessandro Deiola,ITA,MF,Cagliari,Serie A,27,1995,17.9,33,19,13,16,4,18,47,38.3,29,16,6,10,9,42,37,0
Romain Del Castillo,FRA,FW,Brest,Ligue 1,27,1996,27.7,46,29,14,18,14,18,70,25.7,52,33,1,32,9,55,8,0
Thomas Delaine,FRA,"DF,MF",Strasbourg,Ligue 1,31,1992,22.7,38,19,29,8,1,20,42,47.6,22,18,2,16,17,55,51,0
Sacha Delaye,FRA,"MF,FW",Montpellier,Ligue 1,21,2002,1.4,7,2,2,2,3,1,6,16.7,5,2,0,2,0,7,1,0
Hannes Delcroix,BEL,DF,Burnley,Premier League,24,1999,6.5,10,6,6,4,0,3,4,75.0,1,9,3,6,9,19,26,0
Alessandro Dellavalle,ITA,DF,Torino,Serie A,19,2004,0.2,0,0,0,0,0,0,0,,0,1,1,0,1,1,0,0
Olivier Deman,BEL,DF,Werder Bremen,Bundesliga,23,2000,15.2,28,15,21,4,3,18,38,47.4,20,24,8,16,14,42,49,1
Karamoko Dembélé,ENG,"MF,FW",Brest,Ligue 1,20,2003,0.2,0,0,0,0,0,0,0,,0,0,0,0,0,0,0,0
Ousmane Dembélé,FRA,"MF,FW",Paris S-G,Ligue 1,26,1997,16.7,19,14,2,7,10,6,13,46.2,7,11,0,11,5,24,4,1
Jessy Deminguet,FRA,"MF,FW",Strasbourg,Ligue 1,25,1998,7.7,14,9,6,8,0,6,18,33.3,12,8,0,8,9,23,5,1
Ermedin Demirović,BIH,"FW,MF",Augsburg,Bundesliga,25,1998,31.9,24,14,5,16,3,12,40,30.0,28,28,2,26,11,35,26,0
Diego Demme,GER,MF,Napoli,Serie A,31,1991,0.8,1,1,0,1,0,0,1,0.0,1,0,0,0,0,1,0,0
Sepp van den Berg,NED,DF,Mainz 05,Bundesliga,21,2001,31.5,38,23,20,15,3,15,26,57.7,11,66,36,30,43,81,159,2
Leander Dendoncker,BEL,MF,Aston Villa,Premier League,28,1995,1.3,6,4,3,2,1,4,5,80.0,1,5,2,3,2,8,3,1
Leander Dendoncker,BEL,MF,Napoli,Serie A,28,1995,0.3,0,0,0,0,0,0,0,,0,1,1,0,0,0,0,0
Rémy Descamps,FRA,GK,Nantes,Ligue 1,27,1996,6.0,0,0,0,0,0,0,0,,0,0,0,0,0,0,7,0
Mikkel Desler,DEN,DF,Toulouse,Ligue 1,28,1995,17.2,18,12,8,7,3,9,17,52.9,8,32,13,19,19,37,38,0
Arthur Desmas,FRA,GK,Le Havre,Ligue 1,29,1994,33.0,0,0,0,0,0,0,2,0.0,2,0,0,0,0,0,13,1
Mattia Destro,ITA,"FW,MF",Empoli,Serie A,32,1991,4.1,2,1,0,2,0,1,1,100.0,0,4,0,4,2,4,3,0
Samuele Di Benedetto,GER,MF,Stuttgart,Bundesliga,18,2005,0.1,0,0,0,0,0,0,0,,0,0,0,0,1,1,0,0
Federico Di Francesco,ITA,"FW,MF",Lecce,Serie A,29,1994,0.2,1,0,0,1,0,0,0,,0,0,0,0,0,1,0,0
Raffaele Di Gennaro,ITA,GK,Inter,Serie A,29,1993,0.3,0,0,0,0,0,0,0,,0,0,0,0,0,0,0,0
Michele Di Gregorio,ITA,GK,Monza,Serie A,26,1997,31.9,1,0,1,0,0,1,4,25.0,3,1,0,1,1,2,10,2
Giovanni Di Lorenzo,ITA,DF,Napoli,Serie A,29,1993,35.9,58,36,26,26,6,32,68,47.1,36,43,16,27,24,82,45,0
Alessandro Di Pardo,ITA,"DF,MF",Cagliari,Serie A,24,1999,4.0,4,1,3,0,1,0,3,0.0,3,9,2,7,5,9,7,0
Boulaye Dia,SEN,"FW,MF",Salernitana,Serie A,26,1996,12.7,4,2,2,2,0,1,3,33.3,2,5,0,5,3,7,7,0
Moussa Diaby,FRA,"FW,MF",Aston Villa,Premier League,24,1999,24.2,12,5,5,4,3,4,22,18.2,18,8,1,7,9,21,6,0
Lamine Diack,SEN,MF,Nantes,Ligue 1,22,2000,0.0,0,0,0,0,0,0,0,,0,0,0,0,0,0,0,0
Mouctar Diakhaby,GUI,"DF,MF",Valencia,La Liga,26,1996,11.9,18,11,9,9,0,11,13,84.6,2,17,7,10,11,29,62,0
Mamadou Diakhon,FRA,"FW,MF",Reims,Ligue 1,17,2005,2.3,5,3,2,1,2,3,9,33.3,6,1,0,1,1,6,1,0
Bafodé Diakité,FRA,DF,Lille,Ligue 1,22,2001,18.8,29,20,12,15,2,24,32,75.0,8,16,8,8,21,50,49,1
Ibrahim Diakité,GUI,DF,Reims,Ligue 1,19,2003,1.2,1,0,0,1,0,0,1,0.0,1,3,0,3,2,3,5,0
Moussa Diakité,MLI,MF,Cádiz,La Liga,19,2003,0.0,0,0,0,0,0,0,0,,0,0,0,0,0,0,0,0
Oumar Diakité,CIV,FW,Reims,Ligue 1,19,2003,17.6,25,12,10,9,6,7,21,33.3,14,13,0,13,7,32,7,0
Amad Diallo,CIV,"FW,MF",Manchester Utd,Premier League,21,2002,4.3,10,3,1,6,3,3,7,42.9,4,3,1,2,1,11,6,0
Amadou Diallo,ENG,MF,Newcastle Utd,Premier League,20,2003,0.0,0,0,0,0,0,0,0,,0,0,0,0,0,0,0,0
Assane Diao,ESP,FW,Betis,La Liga,17,2005,11.6,20,12,5,9,6,6,17,35.3,11,22,4,18,7,27,7,0
Habib Diarra,SEN,"MF,FW",Strasbourg,Ligue 1,19,2004,25.6,30,23,8,20,2,9,33,27.3,24,23,4,19,17,47,15,0
Moussa Diarra,MLI,DF,Toulouse,Ligue 1,22,2000,15.5,32,12,16,15,1,13,27,48.1,14,30,14,16,20,52,43,0
Rúben Dias,POR,DF,Manchester City,Premier League,26,1997,28.4,39,20,14,21,4,19,26,73.1,7,32,17,15,30,69,77,0
Krépin Diatta,SEN,"DF,FW",Monaco,Ligue 1,24,1999,13.4,37,20,17,16,4,27,49,55.1,22,17,2,15,16,53,22,0
Mory Diaw,SEN,GK,Clermont Foot,Ligue 1,30,1993,30.0,1,1,1,0,0,1,2,50.0,1,0,0,0,1,2,13,5
Mahamadou Diawara,FRA,MF,Lyon,Ligue 1,18,2005,4.0,9,6,4,5,0,3,11,27.3,8,4,1,3,4,13,4,0
Brahim Díaz,MAR,"FW,MF",Real Madrid,La Liga,23,1999,17.2,29,19,4,16,9,6,13,46.2,7,16,1,15,5,34,2,0
Luis Díaz,COL,FW,Liverpool,Premier League,26,1997,29.2,35,25,5,17,13,7,30,23.3,23,15,0,15,3,38,8,0
Víctor Díaz,ESP,"DF,MF",Granada,La Liga,35,1988,1.8,5,3,2,3,0,1,3,33.3,2,1,0,1,1,6,8,0
Famara Diedhiou,SEN,"FW,MF",Granada,La Liga,30,1992,1.0,1,1,0,1,0,0,1,0.0,1,0,0,0,0,1,2,0
Justin Diehl,GER,"FW,MF",Köln,Bundesliga,18,2004,1.9,0,0,0,0,0,0,0,,0,1,1,0,0,0,0,1
Bamba Dieng,SEN,FW,Lorient,Ligue 1,23,2000,6.1,3,3,0,3,0,1,3,33.3,2,3,0,3,0,3,7,0
Eric Dier,ENG,DF,Tottenham,Premier League,29,1994,2.2,2,1,2,0,0,2,2,100.0,0,3,3,0,2,4,12,0
Eric Dier,ENG,DF,Bayern Munich,Bundesliga,29,1994,13.0,11,8,5,5,1,5,6,83.3,1,20,12,8,10,21,48,1
Guillaume Dietsch,FRA,GK,Metz,Ligue 1,22,2001,0.8,0,0,0,0,0,0,0,,0,0,0,0,0,0,0,0
Florian Dietz,GER,"FW,MF",Köln,Bundesliga,24,1998,0.8,0,0,0,0,0,0,0,,0,1,0,1,0,0,0,0
Lucas Digne,FRA,DF,Aston Villa,Premier League,30,1993,26.8,47,19,35,9,3,25,44,56.8,19,20,2,18,26,73,67,0
Federico Dimarco,ITA,DF,Inter,Serie A,25,1997,23.1,42,25,19,14,9,17,35,48.6,18,18,3,15,9,51,34,1
Stole Dimitrievski,MKD,GK,Rayo Vallecano,La Liga,29,1993,37.0,1,1,1,0,0,1,1,100.0,0,0,0,0,0,1,17,3
Junior Dina Ebimbe,FRA,"MF,DF",Eint Frankfurt,Bundesliga,22,2000,21.7,44,29,15,17,12,18,41,43.9,23,28,7,21,9,53,39,1
Eren Dinkçi,GER,"FW,MF",Heidenheim,Bundesliga,21,2001,29.4,32,18,16,13,3,19,48,39.6,29,40,4,36,12,44,21,0
Sinaly Diomande,CIV,DF,Lyon,Ligue 1,22,2001,9.9,10,4,5,3,2,9,16,56.3,7,12,9,3,15,25,26,1
Edan Diop,FRA,"MF,DF",Monaco,Ligue 1,18,2004,1.8,10,8,6,3,1,7,9,77.8,2,3,0,3,1,11,5,0
Issa Diop,FRA,DF,Fulham,Premier League,26,1997,15.8,30,16,23,5,2,15,20,75.0,5,28,19,9,17,47,80,1
Sofiane Diop,FRA,FW,Nice,Ligue 1,23,2000,5.5,8,6,3,4,1,4,10,40.0,6,4,0,4,3,11,3,0
Andy Diouf,FRA,MF,Lens,Ligue 1,20,2003,14.6,28,19,12,11,5,14,22,63.6,8,13,3,10,3,31,5,1
Yehvann Diouf,FRA,GK,Reims,Ligue 1,23,1999,34.0,0,0,0,0,0,0,1,0.0,1,0,0,0,1,1,19,3
Axel Disasi,FRA,DF,Chelsea,Premier League,25,1998,28.7,33,19,20,10,3,23,30,76.7,7,26,19,7,18,51,102,2
Tiago Djaló,POR,DF,Juventus,Serie A,23,2000,0.2,0,0,0,0,0,0,0,,0,1,0,1,0,0,1,0
Chaim El Djebali,TUN,MF,Lyon,Ligue 1,19,2004,0.1,0,0,0,0,0,0,0,,0,0,0,0,0,0,0,0
Djené,TOG,"DF,MF",Getafe,La Liga,31,1991,27.6,34,19,18,13,3,15,26,57.7,11,31,15,16,23,57,70,0
Koffi Djidji,CIV,DF,Torino,Serie A,30,1992,8.4,14,9,9,5,0,3,4,75.0,1,10,5,5,10,24,20,0
Berat Djimsiti,ALB,DF,Atalanta,Serie A,30,1993,31.5,42,24,29,12,1,19,31,61.3,12,53,33,20,57,99,100,0
Marko Dmitrović,SRB,GK,Sevilla,La Liga,31,1992,13.0,1,1,1,0,0,1,2,50.0,1,0,0,0,1,2,5,0
Ben Doak,SCO,FW,Liverpool,Premier League,17,2005,0.2,0,0,0,0,0,0,0,,0,0,0,0,0,0,0,0
Ritsu Doan,JPN,"DF,MF",Freiburg,Bundesliga,25,1998,25.0,50,27,21,19,10,21,36,58.3,15,30,3,27,9,59,29,0
Lewis Dobbin,ENG,MF,Everton,Premier League,20,2003,2.6,9,7,3,5,1,5,9,55.6,4,5,1,4,1,10,0,0
Dodô,BRA,DF,Fiorentina,Serie A,24,1998,5.8,5,3,1,4,0,2,5,40.0,3,2,0,2,5,10,11,0
Danilho Doekhi,NED,DF,Union Berlin,Bundesliga,25,1998,24.0,34,23,18,16,0,15,21,71.4,6,46,25,21,38,72,111,1
Matt Doherty,IRL,"DF,MF",Wolves,Premier League,31,1992,12.8,31,18,17,10,4,12,23,52.2,11,15,5,10,7,38,47,0
Josh Doig,SCO,DF,Hellas Verona,Serie A,21,2002,9.2,16,9,9,7,0,13,17,76.5,4,12,3,9,4,20,17,1
Josh Doig,SCO,DF,Sassuolo,Serie A,21,2002,14.9,25,17,16,9,0,15,27,55.6,12,31,10,21,16,41,38,0
Jeremy Doku,BEL,"FW,MF",Manchester City,Premier League,21,2002,17.7,39,22,13,12,14,9,20,45.0,11,14,0,14,9,48,5,0
Jeremy Doku,BEL,FW,Rennes,Ligue 1,21,2002,1.2,2,2,1,0,1,1,1,100.0,0,0,0,0,0,2,0,0
Jaume Doménech,ESP,GK,Valencia,La Liga,32,1990,0.9,0,0,0,0,0,0,0,,0,0,0,0,0,0,0,0
Carlos Dominguez,ESP,DF,Celta Vigo,La Liga,22,2001,17.6,33,21,17,9,7,23,37,62.2,14,24,12,12,22,55,78,0
Mario Dominguez,ESP,FW,Valencia,La Liga,19,2004,0.3,0,0,0,0,0,0,0,,0,0,0,0,0,0,0,0
Nicolás Domínguez,ARG,"MF,FW",Nott'ham Forest,Premier League,25,1998,16.6,63,34,35,27,1,23,48,47.9,25,31,5,26,18,81,24,0
Nicolás Domínguez,ARG,MF,Bologna,Serie A,25,1998,1.1,1,0,1,0,0,0,2,0.0,2,3,0,3,0,1,2,0
Giulio Donati,ITA,DF,Monza,Serie A,33,1990,0.4,0,0,0,0,0,0,0,,0,0,0,0,0,0,1,1
Jamie Donley,ENG,FW,Tottenham,Premier League,18,2005,0.0,0,0,0,0,0,0,0,,0,0,0,0,0,0,3,0
Gianluigi Donnarumma,ITA,GK,Paris S-G,Ligue 1,24,1999,24.1,0,0,0,0,0,0,0,,0,0,0,0,1,1,9,4
Patrick Dorgu,DEN,"DF,MF",Lecce,Serie A,18,2004,17.4,43,22,22,17,4,22,34,64.7,12,16,5,11,9,52,45,2
Niklas Dorsch,GER,MF,Augsburg,Bundesliga,25,1998,15.4,35,24,13,21,1,13,33,39.4,20,15,9,6,16,51,27,0
Alberto Dossena,ITA,DF,Cagliari,Serie A,24,1998,33.1,55,35,43,12,0,32,48,66.7,16,50,27,23,45,100,172,2
Carlos Dotor,ESP,MF,Celta Vigo,La Liga,22,2001,7.9,14,7,3,8,3,4,13,30.8,9,12,2,10,4,18,4,0
Abdoulaye Doucouré,MLI,"FW,MF",Everton,Premier League,30,1993,29.2,43,27,20,14,9,18,46,39.1,28,23,3,20,15,58,19,0
Cheick Doucouré,MLI,MF,Crystal Palace,Premier League,23,2000,10.2,34,17,15,13,6,18,30,60.0,12,13,2,11,20,54,12,0
Siriné Doucouré,MLI,FW,Lorient,Ligue 1,21,2002,4.7,8,6,0,4,4,3,3,100.0,0,4,0,4,1,9,6,0
Désiré Doué,FRA,"MF,FW",Rennes,Ligue 1,18,2005,18.1,32,18,11,14,7,10,33,30.3,23,30,1,29,14,46,8,0
Guela Doué,CIV,DF,Rennes,Ligue 1,20,2002,13.7,28,21,14,12,2,22,32,68.8,10,12,1,11,15,43,65,1
Alfie Doughty,ENG,DF,Luton Town,Premier League,23,1999,32.5,63,40,29,18,16,37,82,45.1,45,51,9,42,31,94,43,4
Douglas,BRA,MF,Nantes,Ligue 1,26,1997,19.7,70,42,34,30,6,30,59,50.8,29,22,8,14,26,96,30,0
Ismaël Doukouré,FRA,"MF,DF",Strasbourg,Ligue 1,20,2003,18.4,23,16,7,14,2,13,21,61.9,8,19,7,12,19,42,29,2
Kamory Doumbia,MLI,MF,Brest,Ligue 1,20,2003,9.8,28,18,8,10,10,10,29,34.5,19,14,0,14,9,37,6,0
Anastasios Douvikas,GRE,FW,Celta Vigo,La Liga,23,1999,10.1,15,7,2,6,7,3,8,37.5,5,6,3,3,2,17,9,0
Artem Dovbyk,UKR,FW,Girona,La Liga,26,1997,28.7,4,3,2,1,1,0,2,0.0,2,8,1,7,0,4,17,0
Nikola Dovedan,AUT,"MF,FW",Heidenheim,Bundesliga,29,1994,7.3,14,9,2,10,2,5,25,20.0,20,9,0,9,1,15,3,0
Damion Downs,USA,"FW,MF",Köln,Bundesliga,19,2004,2.0,1,1,1,0,0,1,2,50.0,1,1,0,1,0,1,1,0
Tommy Doyle,ENG,MF,Wolves,Premier League,21,2001,13.6,26,13,11,10,5,14,23,60.9,9,22,9,13,12,38,18,0
Radu Drăgușin,ROU,DF,Tottenham,Premier League,21,2002,4.8,5,3,5,0,0,3,3,100.0,0,5,4,1,8,13,19,0
Radu Drăgușin,ROU,DF,Genoa,Serie A,21,2002,19.0,16,11,9,6,1,8,9,88.9,1,18,12,6,21,37,87,3
Dion Drena Beljo,CRO,"FW,MF",Augsburg,Bundesliga,21,2002,6.5,0,0,0,0,0,0,2,0.0,2,8,1,7,1,1,4,0
Tim Drexler,GER,DF,Hoffenheim,Bundesliga,18,2005,6.4,16,9,12,4,0,8,17,47.1,9,12,8,4,8,24,14,0
Domingos Duarte,POR,DF,Getafe,La Liga,28,1995,10.1,7,4,6,0,1,5,7,71.4,2,7,5,2,8,15,27,0
Rubén Duarte,ESP,DF,Alavés,La Liga,27,1995,20.9,39,20,21,16,2,21,31,67.7,10,21,6,15,23,62,69,0
Martin Dúbravka,SVK,GK,Newcastle Utd,Premier League,34,1989,22.1,0,0,0,0,0,0,4,0.0,4,0,0,0,0,0,8,1
Marvin Ducksch,GER,FW,Werder Bremen,Bundesliga,29,1994,30.0,8,3,4,3,1,6,14,42.9,8,2,0,2,4,12,25,0
Ondrej Duda,SVK,MF,Hellas Verona,Serie A,28,1994,27.3,59,39,17,35,7,31,52,59.6,21,29,12,17,26,85,21,0
Denzel Dumfries,NED,DF,Inter,Serie A,27,1996,18.2,22,13,9,11,2,9,23,39.1,14,15,6,9,12,34,33,1
Paul Dummett,WAL,DF,Newcastle Utd,Premier League,31,1991,0.2,1,0,1,0,0,1,1,100.0,0,0,0,0,0,1,1,0
Alfred Duncan,GHA,MF,Fiorentina,Serie A,30,1993,21.0,35,22,13,15,7,15,35,42.9,20,27,5,22,11,46,13,0
Lewis Dunk,ENG,DF,Brighton,Premier League,31,1991,31.9,27,14,17,9,1,13,36,36.1,23,49,37,12,31,58,90,1
Jhon Durán,COL,"FW,MF",Aston Villa,Premier League,19,2003,5.3,6,5,3,1,2,1,6,16.7,5,6,0,6,1,7,10,0
Julien Duranville,BEL,"FW,MF",Dortmund,Bundesliga,17,2006,0.1,1,0,0,1,0,1,1,100.0,0,0,0,0,0,1,0,0
Hugo Duro,ESP,FW,Valencia,La Liga,23,1999,33.1,16,8,5,8,3,9,29,31.0,20,24,5,19,5,21,27,0
Jean-Kevin Duverne,HAI,DF,Nantes,Ligue 1,26,1997,15.0,37,19,16,17,4,18,44,40.9,26,17,5,12,18,55,34,0
Paulo Dybala,ARG,"FW,MF",Roma,Serie A,29,1993,21.8,22,13,3,10,9,2,18,11.1,16,12,0,12,3,25,6,1
Aron Dønnum,NOR,"FW,MF",Toulouse,Ligue 1,25,1998,17.7,16,10,3,8,5,7,22,31.8,15,13,0,13,8,24,16,1
George Earthy,ENG,FW,West Ham,Premier League,18,2004,0.4,0,0,0,0,0,0,1,0.0,1,0,0,0,1,1,0,0
Simon Ebonog,CMR,MF,Le Havre,Ligue 1,18,2004,0.2,1,1,0,1,0,1,1,100.0,0,1,1,0,0,1,1,0
Festy Ebosele,IRL,DF,Udinese,Serie A,20,2002,18.9,33,20,23,9,1,21,35,60.0,14,33,2,31,10,43,27,0
Enzo Ebosse,CMR,DF,Udinese,Serie A,24,1999,0.1,1,1,1,0,0,0,1,0.0,1,0,0,0,1,2,0,0
Tyronne Ebuehi,NGA,DF,Empoli,Serie A,27,1995,12.2,14,9,9,5,0,7,11,63.6,4,9,4,5,6,20,27,1
Ederson,BRA,GK,Manchester City,Premier League,29,1993,30.9,0,0,0,0,0,0,1,0.0,1,0,0,0,0,0,10,1
Éderson,BRA,MF,Atalanta,Serie A,24,1999,31.9,83,49,38,38,7,44,63,69.8,19,48,8,40,41,124,33,1
Odsonne Édouard,FRA,"FW,MF",Crystal Palace,Premier League,25,1998,17.3,24,12,8,8,8,4,19,21.1,15,17,1,16,6,30,19,0
John Egan,IRL,DF,Sheffield Utd,Premier League,30,1992,5.4,6,4,4,2,0,4,11,36.4,7,10,4,6,13,19,39,1
Maximilian Eggestein,GER,MF,Freiburg,Bundesliga,26,1996,32.4,49,24,25,19,5,15,36,41.7,21,53,19,34,28,77,40,1
Lilian Egloff,GER,"MF,DF",Stuttgart,Bundesliga,20,2002,1.2,4,1,3,1,0,2,4,50.0,2,3,1,2,1,5,0,0
Kingsley Ehizibue,NED,DF,Udinese,Serie A,28,1995,10.6,22,14,16,4,2,11,18,61.1,7,21,3,18,8,30,36,0
Hjalmar Ekdal,SWE,DF,Burnley,Premier League,24,1998,4.9,4,2,2,2,0,2,4,50.0,2,10,5,5,6,10,21,0
Hugo Ekitike,FRA,FW,Paris S-G,Ligue 1,21,2002,0.1,0,0,0,0,0,0,0,,0,0,0,0,0,0,0,0
Hugo Ekitike,FRA,FW,Eint Frankfurt,Bundesliga,21,2002,8.0,11,7,3,6,2,4,6,66.7,2,10,0,10,2,13,4,0
Emmanuel Ekong,SWE,FW,Empoli,Serie A,21,2002,0.1,0,0,0,0,0,0,0,,0,0,0,0,0,0,0,0
Caleb Ekuban,GHA,FW,Genoa,Serie A,29,1994,12.6,8,4,2,4,2,5,9,55.6,4,11,3,8,1,9,7,0
Anthony Elanga,SWE,"FW,MF",Nott'ham Forest,Premier League,21,2002,27.0,33,19,20,6,7,17,36,47.2,19,22,2,20,8,41,20,1
Simon Elisor,FRA,FW,Metz,Ligue 1,24,1999,8.5,9,2,3,2,4,2,6,33.3,4,6,1,5,0,9,9,0
Harvey Elliott,ENG,"MF,FW",Liverpool,Premier League,20,2003,15.0,27,17,8,14,5,10,31,32.3,21,27,0,27,6,33,7,0
Elif Elmas,MKD,"FW,MF",Napoli,Serie A,23,1999,3.8,4,3,1,3,0,2,2,100.0,0,2,0,2,2,6,8,0
Elif Elmas,MKD,"MF,FW",RB Leipzig,Bundesliga,23,1999,3.0,8,6,1,6,1,6,8,75.0,2,5,0,5,1,9,2,0
Mohamed Elneny,EGY,MF,Arsenal,Premier League,31,1992,0.3,0,0,0,0,0,0,1,0.0,1,0,0,0,1,1,0,0
Aritz Elustondo,ESP,DF,Real Sociedad,La Liga,29,1994,9.0,11,7,5,4,2,6,14,42.9,8,12,10,2,7,18,26,0
Nico Elvedi,SUI,DF,Gladbach,Bundesliga,26,1996,27.6,33,18,22,10,1,18,24,75.0,6,40,25,15,43,76,150,2
Adri Embarba,ESP,"FW,MF",Almería,La Liga,31,1992,27.5,55,37,29,15,11,26,53,49.1,27,37,1,36,15,70,12,0
Breel Embolo,SUI,FW,Monaco,Ligue 1,26,1997,2.0,3,3,0,2,1,1,4,25.0,3,1,0,1,1,4,2,0
Emanuel Emegha,NED,FW,Strasbourg,Ligue 1,20,2003,23.1,8,5,2,4,2,4,9,44.4,5,13,3,10,2,10,25,0
Emerson,BRA,DF,Tottenham,Premier League,24,1999,12.9,36,24,23,10,3,21,43,48.8,22,23,10,13,20,56,50,1
Youssef En-Nesyri,MAR,FW,Sevilla,La Liga,26,1997,28.6,10,7,3,4,3,0,10,0.0,10,9,1,8,7,17,29,1
Julio Enciso,PAR,"MF,FW",Brighton,Premier League,19,2004,5.3,6,2,3,2,1,2,7,28.6,5,11,0,11,0,6,3,0
Wataru Endo,JPN,MF,Liverpool,Premier League,30,1993,19.1,48,28,11,31,6,20,61,32.8,41,24,2,22,20,68,31,3
Arne Engels,BEL,"MF,DF",Augsburg,Bundesliga,19,2003,15.6,33,18,15,14,4,12,29,41.4,17,23,1,22,15,48,21,0
Christian Eriksen,DEN,MF,Manchester Utd,Premier League,31,1992,12.7,18,13,5,10,3,12,33,36.4,21,17,6,11,4,22,13,0
Martin Erlic,CRO,DF,Sassuolo,Serie A,25,1998,29.1,37,22,26,8,3,20,30,66.7,10,31,16,15,28,65,128,1
Gonzalo Escalante,ARG,MF,Cádiz,La Liga,30,1993,18.9,39,24,16,14,9,20,55,36.4,35,23,5,18,26,65,33,2
Aarón Escandell,ESP,GK,Las Palmas,La Liga,27,1995,1.7,0,0,0,0,0,0,0,,0,0,0,0,0,0,1,1
Alfonso Espino,URU,DF,Rayo Vallecano,La Liga,31,1992,27.9,67,45,43,22,2,30,82,36.6,52,26,4,22,40,107,63,0
Bernardo Espinosa,COL,DF,Girona,La Liga,34,1989,0.0,1,1,1,0,0,1,1,100.0,0,0,0,0,0,1,2,0
Maxime Estève,FRA,DF,Burnley,Premier League,21,2002,14.5,27,10,15,12,0,18,32,56.3,14,21,10,11,27,54,56,0
Maxime Estève,FRA,DF,Montpellier,Ligue 1,21,2002,11.1,16,12,11,5,0,10,15,66.7,5,13,9,4,18,34,50,0
Oscar Estupiñan,COL,FW,Metz,Ligue 1,26,1996,2.9,5,4,0,3,2,1,2,50.0,1,2,0,2,0,5,0,0
Pervis Estupiñán,ECU,DF,Brighton,Premier League,25,1998,13.8,26,13,12,11,3,14,30,46.7,16,14,4,10,21,47,20,0
Karl Etta,CMR,FW,Cádiz,La Liga,19,2003,0.2,1,1,0,1,0,0,0,,0,0,0,0,0,1,0,0
Jonny Evans,NIR,DF,Manchester Utd,Premier League,35,1988,15.5,22,14,20,2,0,12,21,57.1,9,25,18,7,23,45,76,0
Eberechi Eze,ENG,"MF,FW",Crystal Palace,Premier League,25,1998,22.8,35,17,4,18,13,15,31,48.4,16,27,2,25,11,46,6,0
Abde Ezzalzouli,MAR,"FW,MF",Barcelona,La Liga,21,2001,0.8,1,1,0,0,1,0,1,0.0,1,1,0,1,0,1,0,0
Abde Ezzalzouli,MAR,FW,Betis,La Liga,21,2001,9.6,17,14,7,5,5,4,14,28.6,10,10,0,10,5,22,5,0
Giovanni Fabbian,ITA,"MF,FW",Bologna,Serie A,20,2003,11.7,17,10,9,7,1,7,12,58.3,5,5,2,3,7,24,11,0
Łukasz Fabiański,POL,GK,West Ham,Premier League,38,1985,8.0,1,0,1,0,0,1,2,50.0,1,0,0,0,1,2,4,0
Nicolò Fagioli,ITA,MF,Juventus,Serie A,22,2001,4.9,5,3,1,3,1,3,7,42.9,4,3,0,3,4,9,1,0
Romain Faivre,FRA,"MF,FW",Bournemouth,Premier League,25,1998,0.5,1,1,0,1,0,0,3,0.0,3,0,0,0,0,1,0,0
Romain Faivre,FRA,"MF,FW",Lorient,Ligue 1,25,1998,16.1,13,6,5,4,4,6,15,40.0,9,6,1,5,7,20,3,1
Ilhan Fakili,FRA,"MF,FW",Clermont Foot,Ligue 1,17,2006,1.0,0,0,0,0,0,0,1,0.0,1,1,0,1,1,1,0,0
Radamel Falcao,COL,"FW,DF",Rayo Vallecano,La Liga,37,1986,4.5,7,5,1,5,1,1,3,33.3,2,2,0,2,3,10,4,0
Wladimiro Falcone,ITA,GK,Lecce,Serie A,28,1995,38.0,0,0,0,0,0,0,0,,0,1,0,1,1,1,21,2
Fali,ESP,DF,Cádiz,La Liga,29,1993,28.3,41,26,29,11,1,21,36,58.3,15,38,24,14,27,68,120,0
Davide Faraoni,ITA,DF,Hellas Verona,Serie A,31,1991,6.7,13,10,5,6,2,7,10,70.0,3,9,5,4,6,19,21,0
Davide Faraoni,ITA,DF,Fiorentina,Serie A,31,1991,4.4,9,4,5,2,2,5,11,45.5,6,3,1,2,5,14,14,0
Ansu Fati,ESP,"MF,FW",Brighton,Premier League,20,2002,5.8,5,3,1,2,2,1,11,9.1,10,8,0,8,3,8,3,0
Ansu Fati,ESP,"MF,FW",Barcelona,La Liga,20,2002,0.6,0,0,0,0,0,0,1,0.0,1,0,0,0,0,0,0,0
Khalil Fayad,FRA,"FW,MF",Montpellier,Ligue 1,19,2004,11.4,28,15,17,7,4,9,22,40.9,13,15,3,12,14,42,6,0
Federico Fazio,ARG,DF,Salernitana,Serie A,36,1987,15.1,18,11,14,4,0,8,14,57.1,6,22,19,3,17,35,99,1
Jacopo Fazzini,ITA,MF,Empoli,Serie A,20,2003,13.7,49,25,27,13,9,30,53,56.6,23,21,3,18,12,61,18,0
Peter Federico,DOM,"MF,FW",Valencia,La Liga,21,2002,7.2,5,3,3,1,1,1,10,10.0,9,11,0,11,7,12,10,0
Nabil Fekir,FRA,"MF,FW",Betis,La Liga,30,1993,11.7,15,10,5,7,3,5,10,50.0,5,9,0,9,7,22,3,0
Felipe,BRA,DF,Nott'ham Forest,Premier League,34,1989,4.2,12,9,9,3,0,9,12,75.0,3,4,1,3,4,16,12,0
Luiz Felipe,ITA,DF,Betis,La Liga,26,1997,4.0,7,3,5,2,0,4,5,80.0,1,10,4,6,4,11,16,0
João Félix,POR,FW,Barcelona,La Liga,23,1999,17.1,22,16,9,7,6,8,22,36.4,14,14,1,13,10,32,11,0
Ohis Felix Uduokhai,GER,DF,Augsburg,Bundesliga,25,1997,32.5,37,21,18,14,5,16,25,64.0,9,45,35,10,46,83,178,2
Kiko Femenía,ESP,DF,Villarreal,La Liga,32,1991,17.6,35,25,19,13,3,19,34,55.9,15,21,6,15,31,66,45,0
Evan Ferguson,IRL,FW,Brighton,Premier League,18,2004,15.2,14,6,4,7,3,5,14,35.7,9,10,3,7,2,16,8,0
Lewis Ferguson,SCO,MF,Bologna,Serie A,23,1999,30.1,37,21,16,17,4,16,37,43.2,21,25,8,17,17,54,27,1
Bruno Fernandes,POR,"MF,FW",Manchester Utd,Premier League,28,1994,34.6,68,38,27,25,16,30,88,34.1,58,49,6,43,27,95,50,2
Edimilson Fernandes,SUI,DF,Mainz 05,Bundesliga,27,1996,14.3,25,16,15,9,1,16,24,66.7,8,14,6,8,22,47,52,0
Aitor Fernández,ESP,GK,Osasuna,La Liga,32,1991,6.1,0,0,0,0,0,0,1,0.0,1,0,0,0,0,0,5,1
Álex Fernández,ESP,MF,Cádiz,La Liga,30,1992,14.3,19,9,10,9,0,11,22,50.0,11,17,5,12,15,34,30,0
Carlos Fernández,ESP,FW,Real Sociedad,La Liga,27,1996,4.5,11,7,3,6,2,0,2,0.0,2,4,0,4,0,11,5,0
Enzo Fernández,ARG,MF,Chelsea,Premier League,22,2001,24.5,50,22,22,18,10,27,65,41.5,38,36,13,23,17,67,28,0
Raúl Fernández,ESP,GK,Granada,La Liga,35,1988,3.1,0,0,0,0,0,0,1,0.0,1,0,0,0,0,0,1,2
Valery Fernández,ESP,"MF,FW",Girona,La Liga,23,1999,5.6,11,9,4,7,0,6,8,75.0,2,6,1,5,1,12,4,0
Fernando,ESP,GK,Almería,La Liga,33,1990,4.0,0,0,0,0,0,0,0,,0,1,0,1,0,0,2,0
Fernando,BRA,MF,Sevilla,La Liga,36,1987,5.1,9,8,2,4,3,5,9,55.6,4,2,0,2,7,16,9,0
Ichem Ferrah,FRA,FW,Lille,Ligue 1,17,2005,0.0,0,0,0,0,0,0,0,,0,0,0,0,0,0,0,0
Andrea Ferraris,ITA,MF,Monza,Serie A,20,2003,0.1,1,1,1,0,0,0,0,,0,0,0,0,0,1,0,0
André Ferreira,POR,GK,Granada,La Liga,27,1996,14.9,0,0,0,0,0,0,1,0.0,1,0,0,0,0,0,9,2
João Ferreira,POR,DF,Udinese,Serie A,22,2001,20.2,58,42,36,18,4,34,58,58.6,24,27,6,21,29,87,89,0
Jordan Ferri,FRA,MF,Montpellier,Ligue 1,31,1992,22.6,36,22,16,17,3,20,67,29.9,47,19,1,18,13,49,23,0
Nacho Ferri,ESP,"FW,MF",Eint Frankfurt,Bundesliga,18,2004,0.8,3,3,1,2,0,2,3,66.7,1,0,0,0,0,3,2,0
Rachad Fettal,MAR,FW,Almería,La Liga,18,2005,0.2,1,1,1,0,0,0,0,,0,0,0,0,0,1,0,0
Seydou Fini,ITA,"DF,FW",Genoa,Serie A,17,2006,0.4,0,0,0,0,0,0,0,,0,0,0,0,0,0,0,0
Max Finkgräfe,GER,"DF,FW",Köln,Bundesliga,19,2004,19.5,65,39,40,25,0,39,74,52.7,35,35,10,25,22,87,39,0
Vincenzo Fiorillo,ITA,GK,Salernitana,Serie A,33,1990,4.0,0,0,0,0,0,0,0,,0,0,0,0,0,0,0,1
Kilian Fischer,GER,"DF,MF",Wolfsburg,Bundesliga,22,2000,3.2,8,6,4,3,1,2,5,40.0,3,8,1,7,1,9,12,0
John Fleck,SCO,"MF,DF",Sheffield Utd,Premier League,31,1991,1.0,1,0,0,1,0,0,1,0.0,1,0,0,0,0,1,1,0
Mark Flekken,NED,GK,Brentford,Premier League,30,1993,36.5,1,1,1,0,0,1,5,20.0,4,1,0,1,0,1,17,1
Alessandro Florenzi,ITA,DF,Milan,Serie A,32,1991,19.2,43,21,26,12,5,26,48,54.2,22,16,9,7,20,63,25,1
Phil Foden,ENG,"FW,MF",Manchester City,Premier League,23,2000,31.7,31,20,11,10,10,13,31,41.9,18,30,0,30,13,44,18,1
Wes Foderingham,ENG,GK,Sheffield Utd,Premier League,32,1991,29.4,5,3,5,0,0,5,6,83.3,1,0,0,0,0,5,18,6
Malick Fofana,BEL,FW,Lyon,Ligue 1,18,2005,6.2,5,4,3,1,1,4,9,44.4,5,3,0,3,5,10,9,0
Youssouf Fofana,FRA,MF,Monaco,Ligue 1,24,1999,30.0,61,39,19,36,6,30,66,45.5,36,35,7,28,37,98,31,1
Jonas Föhrenbach,GER,DF,Heidenheim,Bundesliga,27,1996,31.0,44,24,24,14,6,19,36,52.8,17,34,19,15,31,75,70,0
Thomas Foket,BEL,DF,Reims,Ligue 1,28,1994,20.4,32,17,21,8,3,20,45,44.4,25,34,12,22,25,57,36,0
Michael Folorunsho,ITA,"MF,FW",Hellas Verona,Serie A,25,1998,30.9,50,28,21,22,7,23,57,40.4,34,45,12,33,17,67,44,2
Tiago Fonseca Morais,POR,FW,Lille,Ligue 1,19,2003,0.5,1,1,0,1,0,0,0,,0,0,0,0,1,2,0,0
Pablo Fornals,ESP,"MF,FW",West Ham,Premier League,27,1996,4.7,10,6,4,3,3,5,16,31.3,11,8,1,7,6,16,7,0
Pablo Fornals,ESP,"FW,MF",Betis,La Liga,27,1996,12.8,24,16,8,11,5,12,22,54.5,10,14,0,14,22,46,10,2
Emil Forsberg,SWE,"MF,FW",RB Leipzig,Bundesliga,31,1991,5.2,7,3,2,5,0,5,12,41.7,7,7,0,7,0,7,5,0
Omari Forson,ENG,FW,Manchester Utd,Premier League,19,2004,0.8,2,0,0,2,0,1,1,100.0,0,0,0,0,0,2,0,0
Philipp Förster,GER,"MF,FW",Bochum,Bundesliga,28,1995,4.3,9,5,3,4,2,2,6,33.3,4,3,0,3,7,16,3,0
Héctor Fort,ESP,DF,Barcelona,La Liga,16,2006,3.5,6,5,5,1,0,4,10,40.0,6,0,0,0,2,8,4,0
Lyle Foster,RSA,"FW,MF",Burnley,Premier League,22,2000,21.1,19,10,5,6,8,6,17,35.3,11,13,3,10,3,22,34,0
Dimitri Foulquier,FRA,"DF,MF",Valencia,La Liga,30,1993,20.5,39,22,22,13,4,18,26,69.2,8,10,1,9,16,55,49,1
Juan Foyth,ARG,DF,Villarreal,La Liga,25,1998,11.8,26,15,18,8,0,12,27,44.4,15,17,4,13,12,38,44,0
Matheus França,BRA,"MF,FW",Crystal Palace,Premier League,19,2004,2.6,3,3,2,1,0,1,7,14.3,6,4,0,4,1,4,1,0
Bartol Franjić,CRO,MF,Darmstadt 98,Bundesliga,23,2000,13.7,15,12,4,10,1,7,28,25.0,21,12,4,8,30,45,29,2
Przemysław Frankowski,POL,DF,Lens,Ligue 1,28,1995,24.4,60,39,25,26,9,31,74,41.9,43,30,7,23,25,85,36,0
Nathan Fraser,IRL,FW,Wolves,Premier League,18,2005,2.1,5,2,2,1,2,1,3,33.3,2,2,1,1,1,6,2,0
Davide Frattesi,ITA,MF,Inter,Serie A,23,1999,10.6,10,6,3,7,0,4,8,50.0,4,9,3,6,5,15,19,0
Morten Frendrup,DEN,MF,Genoa,Serie A,22,2001,34.9,133,72,47,70,16,55,91,60.4,36,55,14,41,51,184,42,1
Remo Freuler,SUI,MF,Bologna,Serie A,31,1992,29.2,78,50,41,32,5,38,69,55.1,31,37,9,28,36,114,53,2
Marco Friedl,AUT,DF,Werder Bremen,Bundesliga,25,1998,24.4,53,32,38,15,0,36,48,75.0,12,45,29,16,35,88,129,0
Marvin Friedrich,GER,DF,Gladbach,Bundesliga,27,1995,17.4,23,15,16,6,1,12,20,60.0,8,28,20,8,17,40,87,0
Jeremie Frimpong,NED,DF,Leverkusen,Bundesliga,22,2000,25.0,26,17,12,7,7,8,20,40.0,12,26,0,26,7,33,17,0
Jorge de Frutos,ESP,"FW,MF",Rayo Vallecano,La Liga,26,1997,17.2,19,8,5,8,6,7,22,31.8,15,12,0,12,7,26,18,0
Chris Führich,GER,"FW,MF",Stuttgart,Bundesliga,25,1998,28.5,30,19,6,14,10,16,37,43.2,21,31,0,31,7,37,7,0
Shiō Fukuda,JPN,"FW,MF",Gladbach,Bundesliga,19,2004,0.4,2,0,1,1,0,1,2,50.0,1,0,0,0,1,3,0,0
Angelo Fulgini,FRA,MF,Lens,Ligue 1,26,1996,15.3,23,14,6,13,4,11,19,57.9,8,22,1,21,8,31,11,0
Niclas Füllkrug,GER,FW,Werder Bremen,Bundesliga,30,1993,2.0,1,1,0,1,0,1,1,100.0,0,2,1,1,0,1,1,0
Niclas Füllkrug,GER,FW,Dortmund,Bundesliga,30,1993,24.6,7,2,1,6,0,2,8,25.0,6,17,4,13,2,9,25,0
Gerardo Fusco,ITA,FW,Salernitana,Serie A,18,2005,0.2,0,0,0,0,0,0,0,,0,0,0,0,0,0,0,0
Daniel Fuzato,BRA,GK,Getafe,La Liga,26,1997,0.1,0,0,0,0,0,0,0,,0,0,0,0,0,0,1,0
Matteo Gabbia,ITA,DF,Milan,Serie A,23,1999,14.2,29,20,15,13,1,18,24,75.0,6,11,6,5,10,39,48,0
Matteo Gabbia,ITA,DF,Villarreal,La Liga,23,1999,5.3,10,6,4,6,0,5,8,62.5,3,5,2,3,8,18,36,1
Gianluca Gaetano,ITA,"FW,MF",Cagliari,Serie A,23,2000,8.3,7,4,0,4,3,2,7,28.6,5,4,0,4,3,10,4,0
Gianluca Gaetano,ITA,MF,Napoli,Serie A,23,2000,1.8,4,1,0,4,0,2,4,50.0,2,5,2,3,1,5,4,0
Roberto Gagliardini,ITA,"MF,DF",Monza,Serie A,29,1994,26.2,61,30,27,25,9,31,50,62.0,19,30,11,19,31,92,38,0
Cody Gakpo,NED,"FW,MF",Liverpool,Premier League,24,1999,18.3,27,17,8,14,5,8,25,32.0,17,21,4,17,14,41,7,0
Javi Galán,ESP,DF,Atlético Madrid,La Liga,28,1994,1.0,5,4,2,2,1,4,5,80.0,1,1,0,1,1,6,3,0
Javi Galán,ESP,DF,Real Sociedad,La Liga,28,1994,11.9,38,22,15,19,4,15,30,50.0,15,24,1,23,14,52,17,1
Iñigo Ruiz de Galarreta,ESP,MF,Athletic Club,La Liga,29,1993,23.2,49,31,15,26,8,24,49,49.0,25,18,5,13,12,61,17,0
Pablo Galdames Millán,CHI,"MF,DF",Genoa,Serie A,26,1996,0.1,0,0,0,0,0,0,0,,0,1,0,1,0,0,0,0
Conor Gallagher,ENG,MF,Chelsea,Premier League,23,2000,34.8,85,52,37,31,17,33,77,42.9,44,50,11,39,43,128,34,0
Antonino Gallo,ITA,DF,Lecce,Serie A,23,2000,27.7,43,27,31,11,1,31,49,63.3,18,34,9,25,25,68,67,0
Cristian Gamboa,CRC,DF,Bochum,Bundesliga,33,1989,13.2,24,18,12,11,1,14,33,42.4,19,20,7,13,15,39,34,1
Kévin Gameiro,FRA,"FW,MF",Strasbourg,Ligue 1,36,1987,15.0,10,10,5,3,2,2,17,11.8,15,9,0,9,3,13,7,0
Idrissa Gana Gueye,SEN,MF,Everton,Premier League,33,1989,20.9,73,44,32,27,14,29,46,63.0,17,24,7,17,28,101,16,0
Ignatius Ganago,CMR,"FW,MF",Nantes,Ligue 1,24,1999,2.0,0,0,0,0,0,0,1,0.0,1,1,0,1,1,1,1,0
Aleix García,ESP,MF,Girona,La Liga,26,1997,35.5,49,28,17,26,6,28,54,51.9,26,45,17,28,36,85,53,3
Álvaro García,ESP,"FW,MF",Rayo Vallecano,La Liga,30,1992,27.5,34,25,15,10,9,7,34,20.6,27,35,0,35,36,70,33,0
Dani García,ESP,MF,Athletic Club,La Liga,33,1990,8.3,17,11,4,7,6,12,24,50.0,12,9,3,6,8,25,11,0
David García,ESP,DF,Osasuna,La Liga,29,1994,25.9,29,18,19,9,1,16,26,61.5,10,40,19,21,18,47,115,2
Eric García,ESP,DF,Barcelona,La Liga,22,2001,0.6,0,0,0,0,0,0,0,,0,1,1,0,0,0,0,0
Eric García,ESP,DF,Girona,La Liga,22,2001,29.3,55,37,34,18,3,34,49,69.4,15,36,18,18,30,85,79,2
Fran Garcia,ESP,DF,Real Madrid,La Liga,23,1999,15.5,25,17,11,12,2,13,31,41.9,18,16,3,13,19,44,28,1
Gonzalo García,ESP,"FW,MF",Real Madrid,La Liga,19,2004,0.2,0,0,0,0,0,0,1,0.0,1,1,1,0,0,0,1,0
Jastin García,ESP,FW,Girona,La Liga,19,2004,0.4,1,0,0,0,1,0,0,,0,0,0,0,0,1,1,0
Raúl García,ESP,"FW,MF",Athletic Club,La Liga,37,1986,4.7,9,6,2,4,3,4,9,44.4,5,10,1,9,3,12,9,0
Rubén García,ESP,"FW,MF",Osasuna,La Liga,30,1993,17.2,32,18,8,17,7,13,33,39.4,20,23,3,20,12,44,23,0
Santiago García,ESP,FW,Getafe,La Liga,21,2001,0.3,1,0,0,0,1,1,1,100.0,0,0,0,0,0,1,0,0
Ulisses Garcia,SUI,DF,Marseille,Ligue 1,27,1996,10.1,21,16,6,13,2,13,20,65.0,7,8,3,5,7,28,13,2
Unai García,ESP,DF,Osasuna,La Liga,31,1992,6.2,12,9,9,2,1,5,10,50.0,5,7,1,6,8,20,18,0
Alejandro Garnacho,ARG,FW,Manchester Utd,Premier League,19,2004,28.5,22,15,7,6,9,12,45,26.7,33,26,2,24,18,40,18,0
James Garner,ENG,MF,Everton,Premier League,22,2001,33.4,83,44,32,38,13,35,82,42.7,47,45,14,31,45,128,47,1
Luca Garritano,ITA,"MF,DF",Frosinone,Serie A,29,1994,5.4,10,5,7,2,1,5,15,33.3,10,13,0,13,4,14,8,1
Yarek Gasiorowski,ESP,DF,Valencia,La Liga,18,2005,8.2,22,12,14,5,3,13,19,68.4,6,15,8,7,15,37,50,1
Johan Gastien,FRA,MF,Clermont Foot,Ligue 1,35,1988,25.1,43,22,18,21,4,23,81,28.4,58,31,9,22,36,79,24,4
Federico Gatti,ITA,DF,Juventus,Serie A,25,1998,29.3,33,19,16,16,1,19,24,79.2,5,26,15,11,19,52,90,1
Federico Gattoni,ARG,"DF,FW",Sevilla,La Liga,24,1999,0.1,1,0,1,0,0,1,1,100.0,0,0,0,0,0,1,1,0
Gavi,ESP,"MF,FW",Barcelona,La Liga,18,2004,10.5,39,21,20,14,5,18,36,50.0,18,19,3,16,8,47,16,1
Paulo Gazzaniga,ARG,GK,Girona,La Liga,31,1992,38.0,2,2,2,0,0,2,4,50.0,2,0,0,0,0,2,12,1
Yann Gboho,FRA,"MF,FW",Toulouse,Ligue 1,22,2001,13.3,14,4,6,6,2,8,23,34.8,15,21,1,20,4,18,2,0
Dennis Geiger,GER,MF,Hoffenheim,Bundesliga,25,1998,0.7,1,0,1,0,0,0,0,,0,1,1,0,0,1,0,0
Gelabert,ESP,"MF,FW",Toulouse,Ligue 1,22,2000,8.4,14,8,5,6,3,7,20,35.0,13,8,2,6,5,19,8,0
Francesco Gelli,ITA,"MF,DF",Frosinone,Serie A,26,1996,17.3,19,13,8,4,7,10,24,41.7,14,19,3,16,11,30,27,1
Luca Gemello,ITA,GK,Torino,Serie A,23,2000,2.0,0,0,0,0,0,0,1,0.0,1,0,0,0,0,0,1,1
Valentin Gendrey,FRA,DF,Lecce,Serie A,23,2000,33.8,55,33,35,16,4,30,46,65.2,16,40,11,29,35,90,99,0
Denis Genreau,AUS,"MF,FW",Toulouse,Ligue 1,24,1999,5.2,12,9,6,6,0,8,15,53.3,7,8,1,7,6,18,8,0
Yannick Gerhardt,GER,"MF,DF",Wolfsburg,Bundesliga,29,1994,18.1,31,20,16,12,3,9,32,28.1,23,15,2,13,7,38,35,0
Anwar El Ghazi,NED,"MF,DF",Mainz 05,Bundesliga,28,1995,0.6,0,0,0,0,0,0,1,0.0,1,0,0,0,0,0,0,0
Farés Ghedjemis,FRA,"FW,MF",Frosinone,Serie A,20,2002,2.0,2,0,1,0,1,0,2,0.0,2,2,0,2,1,3,2,0
Saman Ghoddos,IRN,DF,Brentford,Premier League,29,1993,8.2,28,19,19,7,2,17,31,54.8,14,9,2,7,5,33,12,0
Lautaro Gianetti,ARG,DF,Udinese,Serie A,29,1993,7.0,9,4,7,2,0,4,5,80.0,1,10,6,4,19,28,39,0
Morgan Gibbs-White,ENG,"MF,FW",Nott'ham Forest,Premier League,23,2000,35.1,36,24,6,20,10,14,33,42.4,19,31,8,23,17,53,21,0
Samuel Gigot,FRA,DF,Marseille,Ligue 1,29,1993,19.2,33,22,16,13,4,13,19,68.4,6,28,18,10,25,58,93,1
Bryan Gil,ESP,"FW,MF",Tottenham,Premier League,22,2001,2.3,1,0,0,0,1,1,4,25.0,3,3,0,3,3,4,4,0
David Gil,ESP,GK,Cádiz,La Liga,29,1994,4.1,0,0,0,0,0,0,1,0.0,1,0,0,0,0,0,3,0
Mario Gila,ESP,DF,Lazio,Serie A,22,2000,20.1,32,14,23,8,1,19,34,55.9,15,27,14,13,20,52,69,0
Alfie Gilchrist,ENG,DF,Chelsea,Premier League,19,2003,2.3,4,0,4,0,0,2,5,40.0,3,6,3,3,3,7,11,0
Billy Gilmour,SCO,MF,Brighton,Premier League,22,2001,23.6,26,16,14,10,2,11,35,31.4,24,23,9,14,11,37,14,1
Benedikt Gimber,GER,DF,Heidenheim,Bundesliga,26,1997,22.5,40,24,25,14,1,19,35,54.3,16,27,17,10,16,56,101,1
Gvidas Gineitis,LTU,MF,Torino,Serie A,19,2004,6.0,11,7,3,8,0,4,7,57.1,3,10,4,6,4,15,9,1
Matthias Ginter,GER,DF,Freiburg,Bundesliga,29,1994,21.3,29,15,19,9,1,16,29,55.2,13,40,26,14,16,45,93,0
Olivier Giroud,FRA,FW,Milan,Serie A,36,1986,26.3,17,11,6,6,5,2,14,14.3,12,14,3,11,6,23,22,0
Jamie Gittens,ENG,"FW,MF",Dortmund,Bundesliga,18,2004,11.8,14,7,6,7,1,2,17,11.8,15,11,2,9,4,18,7,0
Klaus Gjasula,ALB,"DF,MF",Darmstadt 98,Bundesliga,33,1989,15.1,44,22,18,25,1,17,30,56.7,13,26,14,12,19,63,42,2
Serge Gnabry,GER,"FW,MF",Bayern Munich,Bundesliga,28,1995,4.8,8,5,0,5,3,2,13,15.4,11,5,0,5,3,11,2,0
Ben Godfrey,ENG,DF,Everton,Premier League,25,1998,12.4,30,20,17,8,5,15,28,53.6,13,14,8,6,16,46,57,0
Edoardo Goldaniga,ITA,DF,Cagliari,Serie A,29,1993,11.2,12,7,9,3,0,4,10,40.0,6,11,7,4,15,27,37,1
Pierluigi Gollini,ITA,GK,Napoli,Serie A,28,1995,7.0,1,1,1,0,0,1,1,100.0,0,0,0,0,1,2,2,0
Aleksandr Golovin,RUS,"MF,FW",Monaco,Ligue 1,27,1996,23.9,42,30,14,22,6,15,42,35.7,27,37,3,34,21,63,14,0
André Gomes,POR,"MF,FW",Everton,Premier League,30,1993,5.6,7,4,2,3,2,3,13,23.1,10,10,1,9,3,10,4,1
Angel Gomes,ENG,MF,Lille,Ligue 1,22,2000,28.6,26,13,4,15,7,14,32,43.8,18,23,6,17,18,44,28,1
João Gomes,BRA,MF,Wolves,Premier League,22,2001,29.4,128,74,67,49,12,44,99,44.4,55,51,8,43,18,146,29,2
Toti Gomes,POR,DF,Wolves,Premier League,24,1999,30.8,44,25,32,8,4,24,37,64.9,13,40,19,21,26,70,93,2
Joe Gomez,ENG,DF,Liverpool,Premier League,26,1997,19.8,47,31,24,16,7,30,63,47.6,33,26,4,22,19,66,50,2
Maxi Gómez,URU,FW,Cádiz,La Liga,26,1996,12.9,6,4,2,3,1,3,5,60.0,2,8,3,5,3,9,3,0
Moi Gómez,ESP,"MF,FW",Osasuna,La Liga,29,1994,22.3,30,19,7,19,4,9,24,37.5,15,15,1,14,11,41,22,0
Papu Gómez,ARG,"MF,FW",Monza,Serie A,35,1988,0.5,0,0,0,0,0,0,2,0.0,2,0,0,0,1,1,0,0
Sergio Gómez,ESP,"FW,MF",Manchester City,Premier League,22,2000,0.6,1,0,0,1,0,1,2,50.0,1,0,0,0,1,2,0,0
Unai Gómez,ESP,MF,Athletic Club,La Liga,20,2003,9.7,12,10,2,6,4,5,10,50.0,5,13,2,11,2,14,9,0
Iron Gomis,FRA,MF,Salernitana,Serie A,23,1999,1.5,4,1,2,2,0,0,1,0.0,1,2,0,2,2,6,2,0
Maxime Gonalons,FRA,MF,Clermont Foot,Ligue 1,34,1989,14.4,47,33,14,27,6,25,57,43.9,32,18,3,15,20,67,11,0
Édgar González,ESP,"DF,MF",Almería,La Liga,26,1997,28.0,45,21,22,20,3,25,49,51.0,24,48,28,20,38,83,130,3
Enso Gonzalez,PAR,"MF,DF",Wolves,Premier League,18,2005,0.0,0,0,0,0,0,0,1,0.0,1,0,0,0,0,0,0,0
Fabio González,ESP,MF,Las Palmas,La Liga,26,1997,1.4,2,2,2,0,0,1,2,50.0,1,2,0,2,0,2,0,0
Giovanni González,URU,DF,Mallorca,La Liga,28,1994,27.4,73,45,37,32,4,40,81,49.4,41,24,3,21,31,104,60,2
Hugo González,ESP,"MF,FW",Valencia,La Liga,20,2003,1.0,2,1,0,2,0,0,0,,0,0,0,0,0,2,0,0
Iñaki González,ESP,MF,Las Palmas,La Liga,19,2004,0.1,1,0,1,0,0,0,0,,0,0,0,0,0,1,1,0
Joan Gonzàlez,ESP,MF,Lecce,Serie A,21,2002,14.3,31,18,16,12,3,17,28,60.7,11,20,3,17,5,36,9,0
Nicolás González,ARG,FW,Fiorentina,Serie A,25,1998,21.3,28,18,15,8,5,8,28,28.6,20,26,1,25,12,40,9,0
Urko González,ESP,MF,Real Sociedad,La Liga,22,2001,1.7,4,1,0,3,1,2,2,100.0,0,1,0,1,1,5,6,0
Anthony Gordon,ENG,FW,Newcastle Utd,Premier League,22,2001,32.1,55,34,16,28,11,22,64,34.4,42,27,0,27,7,62,7,0
Kaide Gordon,ENG,FW,Liverpool,Premier League,18,2004,0.0,0,0,0,0,0,0,0,,0,0,0,0,0,0,0,0
Daniel Gore,ENG,MF,Manchester Utd,Premier League,18,2004,0.0,1,1,0,1,0,1,1,100.0,0,0,0,0,1,2,0,0
Leon Goretzka,GER,MF,Bayern Munich,Bundesliga,28,1995,24.9,41,23,18,14,9,24,54,44.4,30,44,8,36,31,72,42,1
Mathieu Gorgelin,FRA,GK,Le Havre,Ligue 1,32,1990,1.0,0,0,0,0,0,0,0,,0,0,0,0,0,0,0,0
Andoni Gorosabel,ESP,DF,Alavés,La Liga,26,1996,31.7,62,42,40,17,5,38,75,50.7,37,24,8,16,28,90,69,0
Robin Gosens,GER,"DF,MF",Union Berlin,Bundesliga,29,1994,25.4,63,44,25,31,7,30,44,68.2,14,52,9,43,36,99,75,0
Mario Götze,GER,MF,Eint Frankfurt,Bundesliga,31,1992,23.0,51,34,18,25,8,28,62,45.2,34,19,3,16,14,65,10,0
Amine Gouiri,ALG,"FW,MF",Rennes,Ligue 1,23,2000,23.0,20,10,4,11,5,8,19,42.1,11,18,1,17,14,34,12,0
Jeffrey Gouweleeuw,NED,DF,Augsburg,Bundesliga,32,1991,28.8,35,23,13,17,5,16,25,64.0,9,44,24,20,35,70,108,0
Pablo Gozalbez,ESP,"MF,FW",Valencia,La Liga,22,2001,1.1,1,0,0,0,1,1,6,16.7,5,0,0,0,1,2,2,0
Jonathan Gradit,FRA,DF,Lens,Ligue 1,30,1992,23.5,32,20,15,14,3,19,35,54.3,16,30,17,13,37,69,61,0
Jens Grahl,GER,GK,Eint Frankfurt,Bundesliga,34,1988,2.0,0,0,0,0,0,0,0,,0,0,0,0,0,0,3,0
Samuel Grandsir,FRA,"MF,FW",Le Havre,Ligue 1,26,1996,6.7,16,12,5,9,2,8,18,44.4,10,4,0,4,3,19,3,1
Alberto Grassi,ITA,MF,Empoli,Serie A,28,1995,20.1,30,18,13,13,4,10,26,38.5,16,26,11,15,41,71,37,0
Ryan Gravenberch,NED,MF,Liverpool,Premier League,21,2002,12.5,26,12,5,13,8,12,29,41.4,17,20,2,18,14,40,11,0
Ryan Gravenberch,NED,FW,Bayern Munich,Bundesliga,21,2002,0.1,0,0,0,0,0,0,0,,0,0,0,0,0,0,0,0
Adrian Grbić,AUT,FW,Lorient,Ligue 1,26,1996,0.3,0,0,0,0,0,0,0,,0,0,0,0,0,0,0,0
Ivo Grbić,CRO,GK,Sheffield Utd,Premier League,27,1996,8.6,0,0,0,0,0,0,1,0.0,1,1,0,1,0,0,9,1
Jack Grealish,ENG,"FW,MF",Manchester City,Premier League,27,1995,11.2,13,8,6,7,0,6,12,50.0,6,13,2,11,6,19,5,0
Mason Greenwood,ENG,"MF,FW",Getafe,La Liga,21,2001,29.6,11,6,3,5,3,4,21,19.0,17,9,0,9,4,15,4,0
Michael Gregoritsch,AUT,FW,Freiburg,Bundesliga,29,1994,18.7,16,12,8,5,3,2,14,14.3,12,17,4,13,9,25,27,0
Dominik Greif,SVK,GK,Mallorca,La Liga,26,1997,1.0,0,0,0,0,0,0,0,,0,0,0,0,0,0,0,0
Antoine Griezmann,FRA,"FW,MF",Atlético Madrid,La Liga,32,1991,29.4,33,19,14,14,5,15,41,36.6,26,34,3,31,10,43,23,1
Vincenzo Grifo,ITA,"MF,FW",Freiburg,Bundesliga,30,1993,25.8,31,20,14,11,6,14,31,45.2,17,22,1,21,15,46,20,0
Florian Grillitsch,AUT,"DF,MF",Hoffenheim,Bundesliga,27,1995,25.5,54,28,31,19,4,22,54,40.7,32,41,20,21,52,106,90,2
Álex Grimaldo,ESP,DF,Leverkusen,Bundesliga,27,1995,30.9,45,24,26,10,9,30,55,54.5,25,32,7,25,22,67,41,0
Christian Groß,GER,"DF,MF",Werder Bremen,Bundesliga,34,1989,8.9,21,16,11,9,1,11,25,44.0,14,17,6,11,13,34,28,1
Pascal Groß,GER,"MF,DF",Brighton,Premier League,32,1991,34.6,70,46,33,21,16,31,72,43.1,41,41,8,33,22,92,32,3
Brajan Gruda,GER,"MF,FW",Mainz 05,Bundesliga,19,2004,18.2,22,14,5,11,6,14,24,58.3,10,15,0,15,5,27,4,0
Ilia Gruev,BUL,MF,Werder Bremen,Bundesliga,23,2000,0.0,0,0,0,0,0,0,0,,0,0,0,0,0,0,0,0
Vicente Guaita,ESP,GK,Celta Vigo,La Liga,36,1987,26.7,1,1,1,0,0,1,2,50.0,1,0,0,0,0,1,9,1
Andrés Guardado,MEX,MF,Betis,La Liga,36,1986,5.0,17,12,5,9,3,7,14,50.0,7,4,2,2,6,23,5,0
Sergi Guardiola,ESP,"FW,MF",Cádiz,La Liga,32,1991,5.5,10,7,2,6,2,4,9,44.4,5,10,0,10,0,10,4,0
Nemanja Gudelj,SRB,"DF,MF",Sevilla,La Liga,31,1991,19.4,31,24,18,10,3,17,31,54.8,14,17,9,8,27,58,56,0
Gabriel Gudmundsson,SWE,"DF,FW",Lille,Ligue 1,24,1999,14.1,22,16,7,13,2,12,20,60.0,8,14,3,11,15,37,25,0
Gonçalo Guedes,POR,"FW,MF",Villarreal,La Liga,26,1996,10.6,6,4,1,2,3,2,7,28.6,5,8,0,8,2,8,3,0
Axel Gueguin,FRA,"DF,FW",Montpellier,Ligue 1,18,2005,1.5,9,5,6,2,1,2,6,33.3,4,2,0,2,2,11,6,0
Marc Guéhi,ENG,DF,Crystal Palace,Premier League,23,2000,22.5,28,19,21,7,0,14,24,58.3,10,22,17,5,18,46,89,1
Mattéo Guendouzi,FRA,MF,Lazio,Serie A,24,1999,26.3,34,15,11,18,5,21,49,42.9,28,24,6,18,21,55,24,1
Mattéo Guendouzi,FRA,MF,Marseille,Ligue 1,24,1999,0.2,0,0,0,0,0,0,0,,0,1,1,0,0,0,0,0
Javier Guerra,ESP,MF,Valencia,La Liga,20,2003,27.8,54,24,25,22,7,22,58,37.9,36,27,7,20,18,72,44,0
Raphaël Guerreiro,POR,"DF,MF",Bayern Munich,Bundesliga,29,1993,13.2,19,16,6,9,4,9,15,60.0,6,7,1,6,15,34,5,1
Axel Guessand,FRA,DF,Udinese,Serie A,18,2004,0.5,1,1,0,1,0,1,1,100.0,0,1,0,1,0,1,0,0
Evann Guessand,CIV,FW,Nice,Ligue 1,22,2001,17.3,16,7,2,7,7,6,7,85.7,1,12,1,11,12,28,7,0
Ander Guevara,ESP,MF,Alavés,La Liga,26,1997,32.6,59,32,28,25,6,31,64,48.4,33,34,12,22,13,72,46,1
Pape Gueye,SEN,"MF,DF",Marseille,Ligue 1,24,1999,8.5,33,21,11,19,3,13,19,68.4,6,17,3,14,13,46,12,0
Josuha Guilavogui,FRA,DF,Mainz 05,Bundesliga,32,1990,4.5,15,10,10,5,0,6,7,85.7,1,13,7,6,13,28,21,0
Morgan Guilavogui,GUI,"FW,MF",Lens,Ligue 1,25,1998,6.3,21,10,4,12,5,5,11,45.5,6,11,2,9,4,25,7,0
Frederic Guilbert,FRA,"DF,MF",Strasbourg,Ligue 1,28,1994,27.7,87,50,49,30,8,47,72,65.3,25,39,10,29,71,158,99,1
Hugo Guillamón,ESP,MF,Valencia,La Liga,23,2000,14.6,24,15,7,14,3,11,17,64.7,6,8,3,5,12,36,25,2
Bruno Guimarães,BRA,MF,Newcastle Utd,Premier League,25,1997,36.3,88,53,45,32,11,40,77,51.9,37,52,14,38,35,123,20,0
Serhou Guirassy,GUI,FW,Stuttgart,Bundesliga,27,1996,24.5,6,3,1,4,1,2,5,40.0,3,8,1,7,6,12,29,0
Marc Guiu,ESP,"FW,MF",Barcelona,La Liga,17,2006,0.8,1,0,0,1,0,0,0,,0,0,0,0,0,1,0,0
Péter Gulácsi,HUN,GK,RB Leipzig,Bundesliga,33,1990,13.0,0,0,0,0,0,0,0,,0,0,0,0,0,0,8,1
Manuel Gulde,GER,DF,Freiburg,Bundesliga,32,1991,22.7,37,23,23,13,1,17,23,73.9,6,24,14,10,25,62,82,0
Arda Güler,TUR,"FW,MF",Real Madrid,La Liga,18,2005,4.2,6,4,1,3,2,5,8,62.5,3,0,0,0,2,8,5,0
Gerard Gumbau,ESP,MF,Granada,La Liga,28,1994,29.7,55,34,21,30,4,23,62,37.1,39,24,5,19,25,80,30,2
Robert Gumny,POL,DF,Augsburg,Bundesliga,25,1998,5.3,6,5,1,3,2,1,5,20.0,4,13,5,8,7,13,15,0
İlkay Gündoğan,GER,MF,Barcelona,La Liga,32,1990,33.3,32,22,14,16,2,12,39,30.8,27,19,4,15,21,53,18,1
Christian Günter,GER,DF,Freiburg,Bundesliga,30,1993,11.8,20,12,9,11,0,7,18,38.9,11,9,3,6,2,22,16,0
Jon Guridi,ESP,MF,Alavés,La Liga,28,1995,29.8,42,24,10,27,5,12,45,26.7,33,23,3,20,22,64,22,0
Gorka Guruzeta,ESP,FW,Athletic Club,La Liga,26,1996,24.6,34,23,6,25,3,9,30,30.0,21,36,2,34,17,51,23,0
Malo Gusto,FRA,DF,Chelsea,Premier League,20,2003,19.5,55,27,34,15,6,35,52,67.3,17,28,4,24,17,72,43,1
Miguel Gutiérrez,ESP,DF,Girona,La Liga,22,2001,33.7,29,18,11,14,4,13,35,37.1,22,27,11,16,22,51,66,2
Albert Guðmundsson,ISL,"FW,MF",Genoa,Serie A,26,1997,33.5,23,10,8,10,5,12,44,27.3,32,15,2,13,11,34,13,0
Joško Gvardiol,CRO,DF,Manchester City,Premier League,21,2002,25.9,55,33,21,24,10,21,38,55.3,17,36,12,24,27,82,37,3
Emmanuel Gyasi,GHA,"DF,FW",Empoli,Serie A,29,1994,20.9,34,17,18,13,3,15,32,46.9,17,30,12,18,5,39,27,1
Norbert Gyömbér,SVK,DF,Salernitana,Serie A,31,1992,19.6,36,18,30,6,0,20,26,76.9,6,33,23,10,23,59,77,2
Erling Haaland,NOR,FW,Manchester City,Premier League,23,2000,28.4,6,3,0,3,3,2,3,66.7,1,11,1,10,2,8,16,0
Nicolas Haas,SUI,MF,Empoli,Serie A,27,1996,1.0,5,3,1,2,2,3,3,100.0,0,1,0,1,1,6,1,0
Janik Haberer,GER,"MF,DF",Union Berlin,Bundesliga,29,1994,13.6,36,24,16,13,7,22,45,48.9,23,21,4,17,12,48,18,0
Robin Hack,GER,"FW,MF",Gladbach,Bundesliga,24,1998,15.0,15,8,6,7,2,4,17,23.5,13,16,0,16,14,29,21,0
Antwoine Hackford,ENG,FW,Sheffield Utd,Premier League,19,2004,0.1,0,0,0,0,0,0,0,,0,0,0,0,0,0,0,0
Munir El Haddadi,MAR,FW,Las Palmas,La Liga,27,1995,27.2,40,27,18,17,5,17,38,44.7,21,27,1,26,11,51,16,0
Jaouen Hadjam,ALG,DF,Nantes,Ligue 1,20,2003,1.2,6,4,5,1,0,1,2,50.0,1,0,0,0,3,9,2,0
Ianis Hagi,ROU,"MF,FW",Alavés,La Liga,24,1998,8.9,17,12,2,14,1,5,12,41.7,7,8,0,8,5,22,4,0
Amadou Haidara,MLI,MF,RB Leipzig,Bundesliga,25,1998,17.0,42,27,24,16,2,23,41,56.1,18,28,6,22,21,63,37,0
Massadio Haïdara,MLI,DF,Lens,Ligue 1,30,1992,8.2,9,8,5,3,1,4,6,66.7,2,7,2,5,11,20,32,3
Oualid El Hajjam,MAR,"DF,MF",Le Havre,Ligue 1,32,1991,4.4,8,7,5,2,1,2,9,22.2,7,5,1,4,6,14,10,0
Achraf Hakimi,MAR,DF,Paris S-G,Ligue 1,24,1998,21.5,29,19,14,9,6,17,34,50.0,17,28,4,24,12,41,28,2
Lewis Hall,ENG,DF,Newcastle Utd,Premier League,18,2004,8.7,28,18,17,10,1,17,28,60.7,11,17,2,15,12,40,22,1
Sébastien Haller,CIV,FW,Dortmund,Bundesliga,29,1994,4.4,1,0,0,1,0,1,1,100.0,0,4,1,3,0,1,7,0
Gustavo Hamer,NED,MF,Sheffield Utd,Premier League,26,1997,32.3,39,21,17,15,7,16,59,27.1,43,33,9,24,29,68,35,0
Andreas Hanche-Olsen,NOR,DF,Mainz 05,Bundesliga,26,1997,11.0,20,12,10,8,2,10,16,62.5,6,10,4,6,11,31,41,0
Isak Hansen-Aarøen,NOR,MF,Werder Bremen,Bundesliga,18,2004,0.3,0,0,0,0,0,0,1,0.0,1,1,0,1,1,1,0,0
Ridgeciano Haps,SUR,DF,Genoa,Serie A,30,1993,8.6,7,6,3,2,2,5,8,62.5,3,3,0,3,6,13,11,1
Genki Haraguchi,JPN,MF,Stuttgart,Bundesliga,32,1991,0.3,1,1,1,0,0,0,0,,0,0,0,0,0,1,1,0
Amine Harit,MAR,"MF,FW",Marseille,Ligue 1,26,1997,20.2,28,16,8,17,3,13,37,35.1,24,31,4,27,12,40,4,0
Luke Harris,WAL,MF,Fulham,Premier League,18,2005,0.8,1,1,1,0,0,0,1,0.0,1,0,0,0,0,1,0,0
Jack Harrison,ENG,"MF,FW",Everton,Premier League,26,1996,24.6,37,22,12,12,13,17,49,34.7,32,25,5,20,12,49,24,0
Abdou Harroui,NED,"MF,FW",Frosinone,Serie A,25,1998,11.3,23,11,11,11,1,8,16,50.0,8,19,3,16,5,28,8,0
Makoto Hasebe,JPN,"DF,MF",Eint Frankfurt,Bundesliga,39,1984,2.4,4,2,2,2,0,3,6,50.0,3,2,1,1,2,6,5,0
Daiki Hashioka,JPN,DF,Luton Town,Premier League,24,1999,6.6,11,5,6,4,1,5,11,45.5,6,12,7,5,8,19,20,0
Hans Hateboer,NED,DF,Atalanta,Serie A,29,1994,12.4,12,5,8,2,2,5,15,33.3,10,21,7,14,4,16,21,0
Pantelis Hatzidiakos,GRE,DF,Cagliari,Serie A,26,1997,9.5,22,10,12,10,0,10,17,58.8,7,14,5,9,13,35,30,1
Kai Havertz,GER,"MF,FW",Arsenal,Premier League,24,1999,29.3,35,15,7,21,7,14,39,35.9,25,26,1,25,20,55,22,0
Thorgan Hazard,BEL,DF,Dortmund,Bundesliga,30,1993,0.1,0,0,0,0,0,0,0,,0,0,0,0,0,0,0,0
Jan Paul van Hecke,NED,DF,Brighton,Premier League,23,2000,26.3,47,26,25,19,3,27,45,60.0,18,49,27,22,30,77,76,4
Hwang Hee-chan,KOR,"FW,MF",Wolves,Premier League,27,1996,23.5,20,10,11,8,1,9,24,37.5,15,19,1,18,10,30,9,0
Silvan Hefti,SUI,"MF,DF",Genoa,Serie A,25,1997,1.3,6,1,2,3,1,4,7,57.1,3,2,0,2,0,6,1,0
Silvan Hefti,SUI,"DF,FW",Montpellier,Ligue 1,25,1997,7.9,21,15,10,7,4,15,29,51.7,14,7,2,5,8,29,11,0
Dominique Heintz,GER,DF,Köln,Bundesliga,29,1993,6.3,12,5,6,6,0,8,12,66.7,4,6,1,5,3,15,28,0
Dean Henderson,ENG,GK,Crystal Palace,Premier League,26,1997,18.0,1,1,1,0,0,1,2,50.0,1,0,0,0,0,1,8,2
Liam Henderson,SCO,MF,Empoli,Serie A,27,1996,0.1,0,0,0,0,0,0,0,,0,0,0,0,0,0,0,0
Benjamin Henrichs,GER,DF,RB Leipzig,Bundesliga,26,1997,28.1,68,39,32,26,10,27,58,46.6,31,49,4,45,33,101,37,0
Henrique,BRA,DF,Lyon,Ligue 1,29,1994,6.7,10,6,6,4,0,6,11,54.5,5,8,2,6,10,20,3,0
Luis Henrique,BRA,"FW,DF",Marseille,Ligue 1,21,2001,8.7,8,7,4,1,3,4,7,57.1,3,9,0,9,8,16,3,0
Luiz Henrique,BRA,FW,Betis,La Liga,22,2001,6.8,15,11,4,10,1,9,14,64.3,5,11,0,11,5,20,8,0
Matheus Henrique,BRA,MF,Sassuolo,Serie A,25,1997,27.8,43,29,21,18,4,18,43,41.9,25,18,8,10,25,68,31,6
Rico Henry,ENG,DF,Brentford,Premier League,26,1997,4.5,7,5,3,3,1,6,7,85.7,1,8,3,5,5,12,5,1
Thomas Henry,FRA,FW,Hellas Verona,Serie A,28,1994,3.7,0,0,0,0,0,0,0,,0,0,0,0,0,0,5,0
Christophe Hérelle,MTQ,DF,Metz,Ligue 1,30,1992,18.0,32,15,24,7,1,13,23,56.5,10,16,9,7,18,50,68,2
Mario Hermoso,ESP,DF,Atlético Madrid,La Liga,28,1995,28.4,46,25,29,13,4,28,51,54.9,23,27,9,18,30,76,93,0
Javi Hernández,ESP,DF,Cádiz,La Liga,25,1998,27.9,43,24,26,12,5,25,46,54.3,21,34,9,25,19,62,72,1
Aridane Hernández,ESP,DF,Rayo Vallecano,La Liga,34,1989,18.8,10,8,5,4,1,4,11,36.4,7,19,14,5,14,24,98,1
Lucas Hernández,FRA,DF,Paris S-G,Ligue 1,27,1996,21.2,52,36,28,15,9,29,50,58.0,21,21,5,16,27,79,38,0
Luis Hernández,ESP,DF,Cádiz,La Liga,34,1989,8.0,7,3,4,3,0,4,8,50.0,4,3,2,1,8,15,25,0
Theo Hernández,FRA,DF,Milan,Serie A,25,1997,31.0,30,17,19,11,0,11,22,50.0,11,33,13,20,23,53,42,1
Jorge Herrando,ESP,DF,Osasuna,La Liga,22,2001,18.3,29,19,23,6,0,12,19,63.2,7,20,11,9,15,44,69,1
Ander Herrera,ESP,MF,Athletic Club,La Liga,33,1989,11.4,44,32,11,26,7,20,36,55.6,16,16,6,10,15,59,18,1
Cristian Herrera,ESP,"FW,MF",Las Palmas,La Liga,32,1991,1.8,1,1,0,1,0,1,2,50.0,1,1,0,1,0,1,2,0
Sergio Herrera,ESP,GK,Osasuna,La Liga,30,1993,31.9,2,2,2,0,0,2,3,66.7,1,0,0,0,0,2,22,3
Yangel Herrera,VEN,MF,Girona,La Liga,25,1998,23.4,64,37,28,30,6,30,56,53.6,26,30,8,22,24,88,45,1
Patrick Herrmann,GER,"FW,DF",Gladbach,Bundesliga,32,1991,1.0,4,4,2,1,1,2,2,100.0,0,1,0,1,1,5,2,0
Juan Herzog,ESP,DF,Las Palmas,La Liga,20,2003,3.2,6,5,5,1,0,3,6,50.0,3,4,1,3,2,8,17,0
Son Heung-min,KOR,FW,Tottenham,Premier League,31,1992,32.6,21,13,6,7,8,10,21,47.6,11,4,1,3,8,29,4,0
Aaron Hickey,SCO,DF,Brentford,Premier League,21,2002,7.9,16,9,9,3,4,7,7,100.0,0,7,3,4,3,19,10,0
Isak Hien,SWE,DF,Hellas Verona,Serie A,24,1999,9.6,17,10,10,7,0,10,19,52.6,9,12,5,7,7,24,33,1
Isak Hien,SWE,DF,Atalanta,Serie A,24,1999,10.4,18,12,8,10,0,7,15,46.7,8,12,5,7,14,32,33,0
James Hill,ENG,DF,Bournemouth,Premier League,21,2002,0.8,3,2,1,2,0,1,1,100.0,0,3,2,1,3,6,8,0
Piero Hincapié,ECU,DF,Leverkusen,Bundesliga,21,2002,16.5,35,22,14,17,4,13,17,76.5,4,18,7,11,13,48,43,0
Jack Hinshelwood,ENG,DF,Brighton,Premier League,18,2005,9.7,14,5,7,4,3,5,13,38.5,8,6,2,4,14,28,18,0
Adam Hložek,CZE,"MF,FW",Leverkusen,Bundesliga,21,2002,5.1,10,4,2,4,4,3,7,42.9,4,4,1,3,2,12,1,0
Nicolas Höfler,GER,MF,Freiburg,Bundesliga,33,1990,25.9,63,40,36,20,7,22,49,44.9,27,30,16,14,31,94,45,0
Jonas Hofmann,GER,MF,Leverkusen,Bundesliga,31,1992,24.5,20,14,6,9,5,10,24,41.7,14,18,0,18,8,28,6,0
Philipp Hofmann,GER,FW,Bochum,Bundesliga,30,1993,17.5,10,5,4,5,1,4,7,57.1,3,11,2,9,4,14,17,0
Lucas Höler,GER,"FW,MF",Freiburg,Bundesliga,29,1994,25.6,32,24,14,10,8,4,23,17.4,19,19,4,15,15,47,35,0
Mason Holgate,ENG,DF,Sheffield Utd,Premier League,26,1996,7.9,12,7,5,6,1,5,12,41.7,7,12,5,7,11,23,40,0
Fabian Holland,GER,"MF,DF",Darmstadt 98,Bundesliga,33,1990,20.4,47,26,18,21,8,20,37,54.1,17,22,12,10,24,71,29,0
Benedict Hollerbach,GER,"FW,MF",Union Berlin,Bundesliga,22,2001,14.2,17,11,5,7,5,7,22,31.8,15,28,0,28,4,21,3,0
Emil Holm,SWE,DF,Atalanta,Serie A,23,2000,10.5,28,19,17,9,2,16,36,44.4,20,25,3,22,7,35,25,0
Gerrit Holtmann,PHI,"MF,FW",Darmstadt 98,Bundesliga,28,1995,4.4,8,5,3,4,1,7,10,70.0,3,7,0,7,2,10,4,1
Martin Hongla,CMR,MF,Hellas Verona,Serie A,25,1998,12.0,24,13,9,13,2,8,11,72.7,3,8,3,5,7,31,24,0
Martin Hongla,CMR,"MF,DF",Granada,La Liga,25,1998,6.2,7,3,2,5,0,3,9,33.3,6,6,3,3,6,13,13,1
Franck Honorat,FRA,"DF,FW",Gladbach,Bundesliga,26,1996,26.1,25,13,13,10,2,11,20,55.0,9,22,3,19,9,34,35,1
Mathias Honsak,AUT,"FW,MF",Darmstadt 98,Bundesliga,26,1996,11.3,14,7,7,6,1,6,20,30.0,14,14,2,12,8,22,25,0
Sydney van Hooijdonk,NED,FW,Bologna,Serie A,23,2000,2.4,3,0,0,2,1,1,2,50.0,1,1,1,0,1,4,4,0
Fraser Hornby,SCO,"FW,MF",Darmstadt 98,Bundesliga,23,1999,2.4,0,0,0,0,0,0,1,0.0,1,2,1,1,0,0,4,0
Lukáš Hrádecký,FIN,GK,Leverkusen,Bundesliga,33,1989,33.0,0,0,0,0,0,0,1,0.0,1,1,0,1,0,0,10,2
Xabier Huarte Armendáriz,ESP,MF,Osasuna,La Liga,22,2001,0.1,0,0,0,0,0,0,0,,0,0,0,0,0,0,0,0
Timo Hübers,GER,DF,Köln,Bundesliga,27,1996,30.9,68,47,51,14,3,49,80,61.3,31,54,28,26,63,131,168,1
Callum Hudson-Odoi,ENG,"FW,MF",Nott'ham Forest,Premier League,22,2000,20.6,18,8,4,5,9,7,28,25.0,21,16,1,15,7,25,12,1
Will Hughes,ENG,MF,Crystal Palace,Premier League,28,1995,21.0,61,33,30,20,11,24,48,50.0,24,36,14,22,21,82,25,0
Dean Huijsen,ESP,DF,Roma,Serie A,18,2005,5.7,10,5,5,5,0,1,4,25.0,3,7,4,3,4,14,26,2
Dean Huijsen,ESP,DF,Juventus,Serie A,18,2005,0.1,0,0,0,0,0,0,0,,0,0,0,0,0,0,1,0
Mats Hummels,GER,DF,Dortmund,Bundesliga,34,1988,17.6,52,34,34,12,6,30,53,56.6,23,33,11,22,33,85,82,0
Denis Huseinbasic,BIH,MF,Köln,Bundesliga,22,2001,18.1,38,18,17,15,6,20,31,64.5,11,26,1,25,13,51,14,0
Elseid Hysaj,ALB,DF,Lazio,Serie A,29,1994,13.3,24,14,8,13,3,15,24,62.5,9,16,6,10,17,41,31,0
Pierre Højbjerg,DEN,MF,Tottenham,Premier League,27,1995,14.6,32,18,13,17,2,13,34,38.2,21,21,7,14,19,51,30,3
Rasmus Højlund,DEN,FW,Manchester Utd,Premier League,20,2003,24.0,11,7,2,3,6,5,13,38.5,8,9,1,8,1,12,19,0
Iago,BRA,DF,Augsburg,Bundesliga,26,1997,18.0,36,17,22,10,4,17,33,51.5,16,39,8,31,18,54,43,0
Pablo Ibáñez,ESP,MF,Osasuna,La Liga,24,1998,12.8,18,9,5,7,6,5,21,23.8,16,26,3,23,9,27,17,0
Arijon Ibrahimović,GER,"FW,DF",Frosinone,Serie A,17,2005,5.3,7,6,4,2,1,1,9,11.1,8,4,0,4,1,8,3,0
Iglesias,ESP,"DF,FW",Getafe,La Liga,25,1998,15.7,41,22,25,11,5,21,33,63.6,12,18,7,11,16,57,53,0
Borja Iglesias,ESP,FW,Betis,La Liga,30,1993,4.5,0,0,0,0,0,0,3,0.0,3,0,0,0,2,2,2,0
Borja Iglesias,ESP,FW,Leverkusen,Bundesliga,30,1993,2.8,1,0,0,1,0,0,1,0.0,1,2,0,2,1,2,1,0
Igor,BRA,DF,Brighton,Premier League,25,1998,18.2,25,18,7,16,2,17,29,58.6,12,22,9,13,14,39,52,1
Jonathan Ikone,FRA,FW,Fiorentina,Serie A,25,1998,18.7,22,11,7,9,6,10,17,58.8,7,12,0,12,3,25,8,0
Chukwubuikem Ikwuemesi,NGA,FW,Salernitana,Serie A,21,2001,11.8,3,1,0,2,1,2,6,33.3,4,1,1,0,1,4,8,0
Andrej Ilic,SRB,FW,Lille,Ligue 1,23,2000,0.1,0,0,0,0,0,0,0,,0,0,0,0,0,0,0,0
Ivan Ilić,SRB,MF,Torino,Serie A,22,2001,23.3,22,8,9,10,3,13,27,48.1,14,20,7,13,20,42,31,0
Samuel Iling-Junior,ENG,"DF,MF",Juventus,Serie A,19,2003,9.0,23,13,9,11,3,11,18,61.1,7,17,5,12,6,29,19,0
Imanol,ESP,DF,Athletic Club,La Liga,23,2000,5.8,7,5,1,5,1,5,18,27.8,13,6,0,6,7,14,15,0
Joel Imasuen,USA,FW,Werder Bremen,Bundesliga,18,2004,0.0,0,0,0,0,0,0,0,,0,0,0,0,0,0,0,0
Ciro Immobile,ITA,FW,Lazio,Serie A,33,1990,18.4,11,9,2,5,4,3,14,21.4,11,9,3,6,5,16,11,0
Gino Infantino,ARG,MF,Fiorentina,Serie A,20,2003,1.1,1,1,0,1,0,0,1,0.0,1,4,0,4,3,4,1,0
Danny Ings,ENG,FW,West Ham,Premier League,31,1992,4.5,6,2,0,6,0,4,13,30.8,9,4,1,3,3,9,7,0
Bonke Innocent,NGA,MF,Lorient,Ligue 1,27,1996,2.3,6,4,2,2,2,2,9,22.2,7,2,1,1,4,10,2,0
Tim Iroegbunam,ENG,MF,Aston Villa,Premier League,20,2003,1.8,7,5,4,2,1,4,9,44.4,5,3,0,3,2,9,3,0
Alexander Isak,SWE,FW,Newcastle Utd,Premier League,23,1999,25.1,5,0,2,1,2,2,8,25.0,6,16,1,15,6,11,13,0
Gustav Isaksen,DEN,FW,Lazio,Serie A,22,2001,11.9,4,3,2,1,1,1,9,11.1,8,11,1,10,4,8,4,0
Isco,ESP,MF,Betis,La Liga,31,1992,25.8,41,27,15,21,5,14,38,36.8,24,19,1,18,10,51,7,0
Thomas Isherwood,SWE,DF,Darmstadt 98,Bundesliga,25,1998,7.1,11,5,7,3,1,5,9,55.6,4,10,7,3,10,21,34,0
Ismaily,BRA,DF,Lille,Ligue 1,33,1990,27.4,72,47,34,25,13,31,60,51.7,29,33,6,27,32,104,77,0
Ardian Ismajli,ALB,DF,Empoli,Serie A,26,1996,22.7,26,16,18,6,2,18,23,78.3,5,28,17,11,23,49,126,1
Yanis Issoufou,FRA,MF,Montpellier,Ligue 1,16,2006,0.1,0,0,0,0,0,0,0,,0,0,0,0,0,0,0,0
Ko Itakura,JPN,"DF,MF",Gladbach,Bundesliga,26,1997,17.7,34,21,17,15,2,16,26,61.5,10,32,18,14,22,56,62,0
Hiroki Ito,JPN,DF,Stuttgart,Bundesliga,24,1999,24.8,19,18,13,6,0,11,26,42.3,15,29,17,12,29,48,86,2
Junya Ito,JPN,"FW,MF",Reims,Ligue 1,30,1993,30.2,33,15,11,14,8,10,36,27.8,26,23,1,22,14,47,7,0
Diego Iturralde,ESP,DF,Sevilla,La Liga,20,2003,0.4,0,0,0,0,0,0,0,,0,1,1,0,0,0,2,0
Alex Iwobi,NGA,MF,Everton,Premier League,27,1996,1.6,2,0,1,0,1,2,3,66.7,1,2,0,2,1,3,0,0
Alex Iwobi,NGA,"FW,MF",Fulham,Premier League,27,1996,24.4,29,18,12,15,2,12,25,48.0,13,16,0,16,14,43,9,0
Armando Izzo,ITA,DF,Monza,Serie A,31,1992,18.3,27,17,17,9,1,16,27,59.3,11,20,16,4,27,54,49,1
Nicolas Jackson,SEN,FW,Chelsea,Premier League,22,2001,31.1,21,13,5,8,8,5,24,20.8,19,20,5,15,4,25,17,0
Jérémy Jacquet,FRA,MF,Rennes,Ligue 1,18,2005,0.1,1,1,1,0,0,0,1,0.0,1,0,0,0,1,2,0,0
Jérémy Jacquet,FRA,DF,Clermont Foot,Ligue 1,18,2005,2.8,4,3,4,0,0,3,3,100.0,0,7,3,4,6,10,10,0
Lee Jae-sung,KOR,"MF,FW",Mainz 05,Bundesliga,30,1992,23.5,33,20,11,16,6,13,39,33.3,26,22,2,20,27,60,23,0
Paul Jaeckel,GER,DF,Union Berlin,Bundesliga,25,1998,2.6,7,2,4,3,0,5,9,55.6,4,3,2,1,4,11,7,0
Filip Jagiełło,POL,MF,Genoa,Serie A,25,1997,0.4,0,0,0,0,0,0,1,0.0,1,1,1,0,1,1,0,0
Kristijan Jakić,CRO,MF,Augsburg,Bundesliga,26,1997,11.7,28,14,14,10,4,15,33,45.5,18,13,1,12,20,48,15,0
Kristijan Jakić,CRO,"MF,FW",Eint Frankfurt,Bundesliga,26,1997,2.2,3,3,1,2,0,1,3,33.3,2,1,0,1,2,5,2,0
Ismail Jakobs,SEN,DF,Monaco,Ligue 1,23,1999,16.3,57,41,27,21,9,29,47,61.7,18,19,2,17,11,68,40,0
Ablie Jallow,GAM,"MF,FW",Metz,Ligue 1,24,1998,10.2,8,5,2,3,3,3,5,60.0,2,4,0,4,8,16,3,0
Reece James,ENG,DF,Chelsea,Premier League,23,1999,4.7,14,9,10,3,1,8,10,80.0,2,4,4,0,3,17,7,1
Vitaly Janelt,GER,"MF,DF",Brentford,Premier League,25,1998,33.9,63,38,29,25,9,32,64,50.0,32,35,9,26,36,99,64,3
Jakub Jankto,CZE,"MF,FW",Cagliari,Serie A,27,1996,9.7,12,9,9,1,2,8,20,40.0,12,5,1,4,5,17,20,0
Tony Jantschke,GER,"DF,MF",Gladbach,Bundesliga,33,1990,0.3,1,1,1,0,0,1,1,100.0,0,2,2,0,1,2,4,0
Adnan Januzaj,BEL,"FW,MF",Sevilla,La Liga,28,1995,2.1,3,3,2,0,1,0,1,0.0,1,2,0,2,1,4,0,0
Nuha Jatta,GAM,FW,RB Leipzig,Bundesliga,17,2006,0.0,0,0,0,0,0,0,0,,0,0,0,0,0,0,0,0
Mikel Jauregizar,ESP,MF,Athletic Club,La Liga,19,2003,1.7,0,0,0,0,0,0,6,0.0,6,5,0,5,0,0,2,0
Luis Javier Suárez,COL,FW,Almería,La Liga,25,1997,10.2,7,5,2,5,0,2,6,33.3,4,11,0,11,0,7,13,0
Danley Jean-Jacques,HAI,MF,Metz,Ligue 1,23,2000,29.8,54,28,24,21,9,19,56,33.9,37,48,7,41,44,98,44,0
Salim El Jebari,MAR,MF,Atlético Madrid,La Liga,19,2004,0.1,1,0,0,1,0,0,0,,0,0,0,0,0,1,1,0
Daniel Jebbison,ENG,FW,Sheffield Utd,Premier League,19,2003,0.2,0,0,0,0,0,0,0,,0,1,0,1,0,0,0,0
Jeffinho,BRA,"FW,MF",Lyon,Ligue 1,23,1999,3.4,11,4,3,5,3,4,11,36.4,7,1,0,1,0,11,0,0
Fredrik Jensen,FIN,"MF,FW",Augsburg,Bundesliga,25,1997,14.9,23,11,9,8,6,14,28,50.0,14,30,1,29,12,35,21,0
Mathias Jensen,DEN,MF,Brentford,Premier League,27,1996,24.5,54,32,25,22,7,26,95,27.4,69,41,6,35,23,77,25,1
Moritz Jenz,GER,DF,Wolfsburg,Bundesliga,24,1999,19.4,34,24,21,11,2,14,21,66.7,7,29,17,12,26,60,94,0
Gabriel Jesus,BRA,FW,Arsenal,Premier League,26,1997,16.4,24,17,11,5,8,5,18,27.8,13,23,1,22,13,37,12,0
Juan Jesus,BRA,DF,Napoli,Serie A,32,1991,23.5,42,19,28,12,2,23,33,69.7,10,23,12,11,23,65,67,1
Alejandro Jiménez,ESP,DF,Milan,Serie A,18,2005,0.8,2,1,2,0,0,2,5,40.0,3,0,0,0,0,2,4,0
Raúl Jiménez,MEX,FW,Fulham,Premier League,32,1991,15.5,18,12,4,8,6,7,20,35.0,13,11,3,8,4,22,13,0
João Pedro,BRA,"FW,MF",Brighton,Premier League,21,2001,22.7,31,14,10,13,8,14,24,58.3,10,15,2,13,11,42,28,0
Joelinton,BRA,"MF,FW",Newcastle Utd,Premier League,26,1996,14.2,39,27,21,15,3,14,38,36.8,24,23,7,16,19,58,11,1
Ryan John Giles,ENG,"DF,MF",Luton Town,Premier League,23,2000,5.6,8,6,4,3,1,2,7,28.6,5,2,0,2,4,12,22,0
Ben Johnson,ENG,"DF,FW",West Ham,Premier League,23,2000,6.0,11,7,7,3,1,9,14,64.3,5,2,1,1,5,16,14,0
Brennan Johnson,WAL,FW,Tottenham,Premier League,22,2001,23.2,26,15,14,5,7,12,31,38.7,19,37,1,36,10,36,12,1
Brennan Johnson,WAL,"FW,MF",Nott'ham Forest,Premier League,22,2001,2.6,4,1,1,1,2,2,4,50.0,2,4,1,3,0,4,0,0
Joseph Johnson,ENG,DF,Luton Town,Premier League,17,2006,0.9,0,0,0,0,0,0,1,0.0,1,0,0,0,0,0,0,0
Sam Johnstone,ENG,GK,Crystal Palace,Premier League,30,1993,20.0,1,0,1,0,0,1,1,100.0,0,0,0,0,1,2,5,0
Curtis Jones,ENG,MF,Liverpool,Premier League,22,2001,13.0,27,14,12,12,3,10,23,43.5,13,22,0,22,7,34,8,0
Frenkie de Jong,NED,MF,Barcelona,La Liga,26,1997,18.2,43,26,14,23,6,8,19,42.1,11,18,8,10,14,57,28,1
Joan Jordán,ESP,MF,Sevilla,La Liga,29,1994,4.2,8,7,3,3,2,7,15,46.7,8,4,2,2,4,12,2,0
Jordi,ESP,"MF,DF",Getafe,La Liga,22,2001,6.4,16,11,3,11,2,7,15,46.7,8,7,2,5,8,24,7,0
Jeremy Jorge,ESP,FW,Getafe,La Liga,20,2003,0.0,0,0,0,0,0,0,0,,0,0,0,0,0,0,0,0
Kaio Jorge,BRA,FW,Frosinone,Serie A,21,2002,9.0,6,4,0,1,5,3,4,75.0,1,6,0,6,1,7,0,0
Jorginho,ITA,MF,Arsenal,Premier League,31,1991,10.2,24,10,6,10,8,11,23,47.8,12,17,1,16,12,36,7,1
Willian José,BRA,FW,Betis,La Liga,31,1991,21.9,7,3,1,2,4,2,5,40.0,3,8,2,6,2,9,15,0
Joselu,ESP,FW,Real Madrid,La Liga,33,1990,18.7,6,3,1,4,1,0,7,0.0,7,11,1,10,6,12,11,0
Diogo Jota,POR,FW,Liverpool,Premier League,26,1996,12.7,23,13,6,13,4,10,23,43.5,13,9,1,8,7,30,4,0
Antoine Joujou,FRA,"FW,MF",Le Havre,Ligue 1,20,2003,8.7,20,12,7,7,6,11,21,52.4,10,11,2,9,7,27,5,0
Luka Jović,SRB,FW,Milan,Serie A,25,1997,9.7,6,4,0,3,3,4,6,66.7,2,3,0,3,1,7,9,0
Kamil Jóźwiak,POL,MF,Granada,La Liga,25,1998,6.3,13,10,4,6,3,9,17,52.9,8,4,0,4,2,15,6,0
Juanmi,ESP,FW,Cádiz,La Liga,30,1993,9.7,9,4,2,7,0,2,9,22.2,7,6,0,6,6,15,3,0
Juanpe,ESP,DF,Girona,La Liga,32,1991,8.3,11,8,8,3,0,9,10,90.0,1,17,11,6,7,18,50,1
Mads Juel Andersen,DEN,DF,Luton Town,Premier League,25,1997,4.4,6,5,4,2,0,4,4,100.0,0,9,6,3,8,14,29,0
Christopher Jullien,FRA,DF,Montpellier,Ligue 1,30,1993,13.7,16,12,11,5,0,6,17,35.3,11,25,20,5,12,28,106,2
Anthony Jung,GER,DF,Werder Bremen,Bundesliga,31,1991,28.7,37,23,21,14,2,18,33,54.5,15,39,17,22,24,61,102,0
Eli Junior Kroupi,FRA,"FW,MF",Lorient,Ligue 1,17,2006,12.0,7,4,2,2,3,1,9,11.1,8,6,0,6,10,17,5,0
Hamed Junior Traorè,CIV,MF,Bournemouth,Premier League,23,2000,0.5,1,0,1,0,0,1,3,33.3,2,3,0,3,0,1,0,0
Hamed Junior Traorè,CIV,MF,Napoli,Serie A,23,2000,4.2,4,2,2,0,2,1,6,16.7,5,3,0,3,2,6,1,1
Vinicius Júnior,BRA,FW,Real Madrid,La Liga,23,2000,20.7,18,13,5,5,8,3,12,25.0,9,13,0,13,1,19,3,2
Josip Juranović,CRO,DF,Union Berlin,Bundesliga,27,1995,14.4,20,14,11,7,2,10,21,47.6,11,17,3,14,12,32,27,1
David Jurásek,CZE,DF,Hoffenheim,Bundesliga,22,2000,5.5,14,11,13,1,0,7,17,41.2,10,7,2,5,3,17,22,1
Julian Justvan,GER,"FW,MF",Hoffenheim,Bundesliga,25,1998,0.5,1,0,1,0,0,1,2,50.0,1,1,0,1,0,1,0,0
Julian Justvan,GER,"MF,FW",Darmstadt 98,Bundesliga,25,1998,11.4,10,4,2,7,1,3,17,17.6,14,12,2,10,11,21,6,1
Filip Jørgensen,DEN,GK,Villarreal,La Liga,21,2002,36.0,3,1,3,0,0,3,4,75.0,1,0,0,0,2,5,10,3
Mathias Jørgensen,DEN,DF,Brentford,Premier League,33,1990,12.1,17,12,15,1,1,11,19,57.9,8,9,5,4,12,29,40,0
Mohamed Kaba,FRA,MF,Lecce,Serie A,21,2001,15.3,39,23,15,16,8,17,34,50.0,17,22,4,18,12,51,13,0
Sory Kaba,GUI,FW,Las Palmas,La Liga,28,1995,8.0,2,0,0,2,0,0,5,0.0,5,6,0,6,0,2,9,0
Ozan Kabak,TUR,DF,Hoffenheim,Bundesliga,23,2000,25.4,48,35,32,14,2,19,33,57.6,14,43,21,22,46,94,106,2
Christian Kabasele,BEL,DF,Udinese,Serie A,32,1991,9.6,10,7,4,5,1,2,11,18.2,9,15,9,6,12,22,56,0
Issa Kaboré,BFA,DF,Luton Town,Premier League,22,2001,19.2,52,28,23,21,8,24,45,53.3,21,22,11,11,16,68,56,2
Abdoul Kader Bamba,FRA,"FW,MF",Nantes,Ligue 1,29,1994,6.8,10,7,2,5,3,5,15,33.3,10,4,0,4,4,14,4,1
Yaya Kader Fofana,MLI,"MF,DF",Reims,Ligue 1,19,2004,0.4,3,3,1,1,1,0,1,0.0,1,0,0,0,1,4,0,0
Pavel Kadeřábek,CZE,"DF,FW",Hoffenheim,Bundesliga,31,1992,26.8,31,19,10,15,6,18,40,45.0,22,22,8,14,23,54,68,0
Tino Kadewere,ZIM,"FW,MF",Lyon,Ligue 1,27,1996,3.3,1,1,0,1,0,1,5,20.0,4,3,1,2,5,6,7,0
Tino Kadewere,ZIM,"FW,MF",Nantes,Ligue 1,27,1996,8.7,9,4,3,3,3,6,11,54.5,5,10,1,9,10,19,8,0
Kaiky,BRA,DF,Almería,La Liga,19,2004,5.8,7,4,6,0,1,3,6,50.0,3,9,7,2,3,10,29,1
Florian Kainz,AUT,"MF,FW",Köln,Bundesliga,30,1992,24.4,28,20,8,13,7,17,39,43.6,22,20,6,14,13,41,23,1
Sasa Kalajdzic,AUT,FW,Wolves,Premier League,26,1997,1.8,6,2,3,2,1,1,2,50.0,1,3,0,3,1,7,6,0
Sasa Kalajdzic,AUT,FW,Eint Frankfurt,Bundesliga,26,1997,3.6,2,2,0,2,0,0,0,,0,2,2,0,2,4,6,0
Arnaud Kalimuendo,FRA,FW,Rennes,Ligue 1,21,2002,23.8,5,4,2,2,1,2,5,40.0,3,13,2,11,4,9,4,0
Yayah Kallon,SLE,FW,Hellas Verona,Serie A,22,2001,0.0,0,0,0,0,0,0,0,,0,0,0,0,0,0,0,0
Gedeon Kalulu,COD,DF,Lorient,Ligue 1,25,1997,10.8,23,17,13,8,2,12,22,54.5,10,18,2,16,5,28,30,0
Pierre Kalulu,FRA,DF,Milan,Serie A,23,2000,4.2,5,1,2,3,0,1,2,50.0,1,4,3,1,1,6,12,1
Daichi Kamada,JPN,MF,Lazio,Serie A,26,1996,17.2,53,36,22,22,9,28,52,53.8,24,24,5,19,18,71,7,0
Waren Kamanzi,NOR,"DF,FW",Toulouse,Ligue 1,22,2000,13.2,36,24,16,16,4,13,23,56.5,10,11,3,8,9,45,35,0
Boubacar Kamara,FRA,MF,Aston Villa,Premier League,23,1999,18.4,43,29,16,21,6,24,47,51.1,23,21,7,14,21,64,16,0
Hassane Kamara,CIV,DF,Udinese,Serie A,29,1994,24.7,45,32,26,13,6,25,38,65.8,13,29,2,27,26,71,66,0
Willy Kambwala,FRA,DF,Manchester Utd,Premier League,18,2004,3.7,3,1,1,2,0,1,3,33.3,2,6,3,3,4,7,14,1
Jakub Kamiński,POL,"FW,MF",Wolfsburg,Bundesliga,21,2002,5.3,14,5,12,2,0,3,6,50.0,3,3,0,3,2,16,5,0
Thomas Kaminski,BEL,GK,Luton Town,Premier League,30,1992,37.8,2,1,2,0,0,2,6,33.3,4,1,0,1,0,2,14,2
Kevin Kampl,SVN,MF,RB Leipzig,Bundesliga,32,1990,15.1,19,8,8,9,2,10,21,47.6,11,19,7,12,11,30,14,1
Harry Kane,ENG,FW,Bayern Munich,Bundesliga,30,1993,31.5,13,9,4,4,5,6,18,33.3,12,12,4,8,6,19,14,0
Lee Kang-in,KOR,"FW,MF",Paris S-G,Ligue 1,22,2001,16.3,26,13,7,9,10,15,36,41.7,21,7,0,7,6,32,3,0
Yann Karamoh,FRA,"MF,FW",Torino,Serie A,25,1998,1.8,1,0,0,0,1,0,0,,0,0,0,0,0,1,1,0
Yann Karamoh,FRA,"FW,MF",Montpellier,Ligue 1,25,1998,3.2,1,0,0,0,1,1,2,50.0,1,3,0,3,0,1,0,0
Atakan Karazor,,MF,Stuttgart,Bundesliga,26,1996,29.1,72,44,23,38,11,29,60,48.3,31,37,8,29,27,99,43,0
Ayman Kari,FRA,MF,Lorient,Ligue 1,18,2004,9.9,18,14,9,9,0,12,19,63.2,7,19,2,17,6,24,9,1
Emir Karic,AUT,DF,Darmstadt 98,Bundesliga,26,1997,19.8,45,27,23,14,8,21,33,63.6,12,42,11,31,13,58,43,0
Loris Karius,GER,GK,Newcastle Utd,Premier League,30,1993,1.0,0,0,0,0,0,0,0,,0,0,0,0,0,0,1,0
Jesper Karlsson,SWE,FW,Bologna,Serie A,25,1998,3.8,3,3,2,1,0,2,8,25.0,6,4,0,4,4,7,1,0
Jon Karrikaburu,ESP,"MF,FW",Alavés,La Liga,20,2002,0.2,0,0,0,0,0,0,0,,0,0,0,0,0,0,0,0
Rick Karsdorp,NED,DF,Roma,Serie A,28,1995,13.2,25,18,11,8,6,16,24,66.7,8,13,4,9,9,34,16,0
Grigoris Kastanos,CYP,"MF,DF",Salernitana,Serie A,25,1998,16.4,23,14,8,9,6,9,20,45.0,11,13,4,9,8,31,9,0
Silas Katompa,COD,"FW,MF",Stuttgart,Bundesliga,24,1998,10.0,5,3,3,2,0,3,12,25.0,9,9,0,9,0,5,4,0
Panos Katseris,GRE,DF,Lorient,Ligue 1,22,2001,11.6,26,20,16,8,2,16,25,64.0,9,20,4,16,8,34,18,0
Mikkel Kaufmann,DEN,FW,Union Berlin,Bundesliga,22,2001,5.4,6,3,2,3,1,3,10,30.0,7,12,0,12,1,7,4,0
Michael Kayode,ITA,DF,Fiorentina,Serie A,19,2004,22.9,53,30,27,15,11,35,48,72.9,13,25,12,13,18,71,46,2
Moise Kean,ITA,FW,Juventus,Serie A,23,2000,7.3,7,4,3,2,2,1,3,33.3,2,4,1,3,2,9,5,0
Michael Keane,ENG,DF,Everton,Premier League,30,1993,4.9,7,3,3,3,1,1,7,14.3,6,5,4,1,5,12,18,1
Ibrahima Kebe,MLI,MF,Girona,La Liga,22,2000,0.1,1,1,0,1,0,0,0,,0,1,0,1,1,2,0,0
Kévin Keben Biakolo,CMR,DF,Toulouse,Ligue 1,19,2004,5.8,4,2,4,0,0,3,6,50.0,3,7,0,7,8,12,17,0
Yassine Kechta,MAR,MF,Le Havre,Ligue 1,21,2002,20.5,46,24,24,19,3,31,73,42.5,42,20,3,17,23,69,16,1
Thilo Kehrer,GER,"DF,MF",West Ham,Premier League,26,1996,0.2,1,1,0,1,0,0,0,,0,2,2,0,0,1,0,0
Thilo Kehrer,GER,DF,Monaco,Ligue 1,26,1996,14.7,32,22,22,7,3,22,39,56.4,17,18,6,12,30,62,55,0
Habib Keita,MLI,MF,Clermont Foot,Ligue 1,21,2002,14.2,34,19,14,15,5,17,28,60.7,11,27,10,17,29,63,30,0
Naby Keïta,GUI,"MF,DF",Werder Bremen,Bundesliga,28,1995,1.2,1,1,1,0,0,0,1,0.0,1,2,0,2,2,3,1,0
Yannik Keitel,GER,"DF,MF",Freiburg,Bundesliga,23,2000,10.2,20,15,14,5,1,10,15,66.7,5,17,8,9,12,32,44,3
Caoimhín Kelleher,IRL,GK,Liverpool,Premier League,24,1998,10.0,0,0,0,0,0,0,0,,0,0,0,0,0,0,4,1
Thomas Keller,GER,"MF,FW",Heidenheim,Bundesliga,23,1999,0.0,0,0,0,0,0,0,0,,0,0,0,0,0,0,0,0
Lloyd Kelly,ENG,DF,Bournemouth,Premier League,24,1998,17.3,24,19,10,9,5,14,25,56.0,11,22,12,10,13,37,67,0
Omari Kellyman,ENG,FW,Aston Villa,Premier League,17,2005,0.4,1,0,0,1,0,1,2,50.0,1,0,0,0,0,1,0,0
Aljoscha Kemlein,GER,MF,Union Berlin,Bundesliga,18,2004,0.3,0,0,0,0,0,0,3,0.0,3,1,0,1,0,0,0,0
Tobias Kempe,GER,MF,Darmstadt 98,Bundesliga,34,1989,15.0,20,13,9,8,3,8,24,33.3,16,16,4,12,9,29,12,0
Milos Kerkez,HUN,DF,Bournemouth,Premier League,19,2003,21.9,47,26,31,13,3,30,42,71.4,12,31,11,20,20,67,60,2
Kaine Kesler-Hayden,ENG,"MF,DF",Aston Villa,Premier League,20,2002,0.1,0,0,0,0,0,0,0,,0,0,0,0,0,0,0,0
Reda Khadra,GER,"FW,MF",Reims,Ligue 1,22,2001,15.2,16,10,5,4,7,8,20,40.0,12,8,2,6,3,19,13,0
Wahbi Khazri,TUN,FW,Montpellier,Ligue 1,32,1991,12.6,24,17,8,12,4,14,35,40.0,21,10,0,10,3,27,7,0
Rani Khedira,GER,MF,Union Berlin,Bundesliga,29,1994,14.9,35,22,15,19,1,17,26,65.4,9,12,5,7,22,57,38,0
Abdukodir Khusanov,UZB,DF,Lens,Ligue 1,19,2004,9.0,21,12,13,8,0,9,17,52.9,8,13,8,5,13,34,32,2
Kiké,ESP,"FW,MF",Alavés,La Liga,33,1989,15.8,8,4,2,3,3,4,9,44.4,5,16,5,11,1,9,12,0
Luca Kilian,GER,DF,Köln,Bundesliga,23,1999,7.1,16,9,15,1,0,9,14,64.3,5,12,5,7,7,23,28,0
Max Kilman,ENG,DF,Wolves,Premier League,26,1997,38.0,47,21,40,6,1,24,32,75.0,8,64,37,27,39,86,182,4
Joshua Kimmich,GER,"MF,DF",Bayern Munich,Bundesliga,28,1995,24.2,45,33,25,15,5,26,39,66.7,13,32,4,28,14,59,28,1
Jakub Kiwior,POL,DF,Arsenal,Premier League,23,2000,10.5,20,12,11,8,1,14,19,73.7,5,11,3,8,8,28,28,1
Simon Kjær,DEN,DF,Milan,Serie A,34,1989,13.0,24,15,11,11,2,14,22,63.6,8,22,16,6,14,38,46,2
Davy Klaassen,NED,MF,Inter,Serie A,30,1993,2.3,4,2,0,4,0,1,3,33.3,2,5,1,4,3,7,4,0
Christoph Klarer,AUT,DF,Darmstadt 98,Bundesliga,23,2000,26.2,37,22,30,4,3,24,36,66.7,12,31,20,11,21,58,94,1
Tim Kleindienst,GER,FW,Heidenheim,Bundesliga,27,1995,31.9,21,12,6,11,4,7,25,28.0,18,32,8,24,12,33,58,0
Lukas Klostermann,GER,DF,RB Leipzig,Bundesliga,27,1996,16.0,15,10,7,7,1,4,13,30.8,9,25,12,13,13,28,64,1
Justin Kluivert,NED,"MF,FW",Bournemouth,Premier League,24,1999,21.3,28,14,5,12,11,8,30,26.7,22,16,1,15,8,36,11,0
Ansgar Knauff,GER,"MF,DF",Eint Frankfurt,Bundesliga,21,2002,23.4,43,26,17,16,10,17,31,54.8,14,40,3,37,20,63,15,0
Robin Knoche,GER,DF,Union Berlin,Bundesliga,31,1992,21.3,34,22,27,7,0,19,30,63.3,11,27,19,8,13,47,73,0
Gregor Kobel,SUI,GK,Dortmund,Bundesliga,25,1997,26.3,0,0,0,0,0,0,1,0.0,1,0,0,0,0,0,11,0
Robin Koch,GER,DF,Eint Frankfurt,Bundesliga,27,1996,30.4,38,23,26,12,0,17,27,63.0,10,33,24,9,32,70,136,2
Philipp Köhn,SUI,GK,Monaco,Ligue 1,25,1998,22.0,1,1,1,0,0,1,1,100.0,0,0,0,0,1,2,5,3
Dominik Kohr,GER,"DF,MF",Mainz 05,Bundesliga,29,1994,24.3,65,42,36,25,4,36,57,63.2,21,27,6,21,43,108,58,0
Koke,ESP,MF,Atlético Madrid,La Liga,31,1992,27.7,66,44,27,32,7,36,79,45.6,43,37,12,25,16,82,34,1
Sead Kolašinac,BIH,DF,Atalanta,Serie A,30,1993,24.2,44,32,23,19,2,30,49,61.2,19,22,9,13,21,65,47,0
Luca Koleosho,ITA,"MF,FW",Burnley,Premier League,18,2004,10.8,7,4,2,5,0,2,10,20.0,8,13,0,13,2,9,0,0
Randal Kolo Muani,FRA,"FW,MF",Paris S-G,Ligue 1,24,1998,14.1,10,8,5,3,2,5,13,38.5,8,5,0,5,4,14,10,0
Randal Kolo Muani,FRA,FW,Eint Frankfurt,Bundesliga,24,1998,1.7,0,0,0,0,0,0,0,,0,0,0,0,0,0,1,0
Mert Kömür,GER,"MF,DF",Augsburg,Bundesliga,18,2005,1.3,3,3,3,0,0,3,5,60.0,2,0,0,0,0,3,1,0
Cheick Konaté,MLI,DF,Clermont Foot,Ligue 1,19,2004,11.9,26,15,17,9,0,20,36,55.6,16,16,2,14,13,39,21,0
Ibrahima Konaté,FRA,DF,Liverpool,Premier League,24,1999,17.5,36,22,22,13,1,18,24,75.0,6,18,12,6,20,56,51,1
Geoffrey Kondogbia,CTA,MF,Marseille,Ligue 1,30,1993,16.3,48,31,18,25,5,13,32,40.6,19,21,4,17,30,78,25,0
Abdoul Koné,FRA,DF,Reims,Ligue 1,18,2005,2.1,7,7,5,2,0,4,11,36.4,7,2,0,2,2,9,9,0
Amadou Koné,MLI,MF,Reims,Ligue 1,18,2005,5.3,13,8,11,2,0,6,10,60.0,4,8,3,5,10,23,10,0
Ibrahima Koné,MLI,FW,Almería,La Liga,24,1999,3.1,1,0,1,0,0,1,1,100.0,0,1,0,1,0,1,4,0
Ibrahima Koné,MLI,FW,Lorient,Ligue 1,24,1999,0.4,0,0,0,0,0,0,1,0.0,1,0,0,0,0,0,0,0
Manu Koné,FRA,MF,Gladbach,Bundesliga,22,2001,17.3,45,26,20,20,5,17,25,68.0,8,22,1,21,15,60,16,1
Ezri Konsa,ENG,DF,Aston Villa,Premier League,25,1997,34.1,54,32,28,23,3,23,27,85.2,4,36,20,16,28,82,73,3
Teun Koopmeiners,NED,MF,Atalanta,Serie A,25,1998,29.2,39,24,12,22,5,17,50,34.0,33,33,3,30,10,49,35,0
Odilon Kossounou,CIV,DF,Leverkusen,Bundesliga,22,2001,20.1,30,20,11,12,7,15,26,57.7,11,27,3,24,27,57,43,1
Filip Kostić,SRB,DF,Juventus,Serie A,30,1992,20.2,37,23,20,13,4,17,33,51.5,16,29,8,21,9,46,43,0
N'Guessan Kouadio,CIV,"MF,FW",Metz,Ligue 1,20,2003,1.2,3,1,0,3,0,0,3,0.0,3,3,0,3,1,4,0,0
Christian Kouamé,CIV,FW,Fiorentina,Serie A,25,1997,12.1,13,4,7,6,0,6,10,60.0,4,16,0,16,2,15,10,0
Rominigue Kouamé,MLI,MF,Cádiz,La Liga,26,1996,9.1,14,9,6,7,1,7,15,46.7,8,10,2,8,13,27,10,1
Koffi Kouao,CIV,DF,Metz,Ligue 1,25,1998,9.6,20,13,12,7,1,11,17,64.7,6,9,6,3,13,33,38,1
Tomáš Koubek,CZE,GK,Augsburg,Bundesliga,30,1992,3.0,0,0,0,0,0,0,0,,0,0,0,0,0,0,1,1
Therence Koudou,FRA,DF,Reims,Ligue 1,18,2004,3.5,2,2,1,1,0,0,2,0.0,2,4,3,1,4,6,9,0
Jules Koundé,FRA,DF,Barcelona,La Liga,24,1998,32.2,37,23,22,10,5,28,51,54.9,23,32,12,20,25,62,83,5
Boubakar Kouyaté,MLI,DF,Montpellier,Ligue 1,26,1997,21.4,49,30,39,8,2,28,51,54.9,23,31,20,11,29,78,123,1
Cheikhou Kouyaté,SEN,MF,Nott'ham Forest,Premier League,33,1989,2.4,8,5,3,3,2,1,4,25.0,3,4,1,3,2,10,10,0
Mateo Kovačić,CRO,MF,Manchester City,Premier League,29,1994,17.2,36,25,16,15,5,18,28,64.3,10,23,1,22,10,46,10,0
Viktor Kovalenko,UKR,MF,Empoli,Serie A,27,1996,6.8,5,2,2,2,1,2,8,25.0,6,12,2,10,1,6,7,0
Matej Kovar,CZE,GK,Leverkusen,Bundesliga,23,2000,1.0,0,0,0,0,0,0,0,,0,0,0,0,0,0,0,0
Dawid Kownacki,POL,FW,Werder Bremen,Bundesliga,26,1997,4.2,1,1,1,0,0,1,4,25.0,3,3,1,2,0,1,1,0
Emil Krafth,SWE,DF,Newcastle Utd,Premier League,28,1994,10.1,21,14,10,7,4,12,25,48.0,13,8,3,5,9,30,21,0
Alex Král,CZE,MF,Union Berlin,Bundesliga,25,1998,15.2,19,14,7,10,2,8,20,40.0,12,15,4,11,11,30,30,0
Andrej Kramarić,CRO,"MF,FW",Hoffenheim,Bundesliga,32,1991,24.4,11,2,5,4,2,6,13,46.2,7,14,2,12,10,21,12,2
Christoph Kramer,GER,MF,Gladbach,Bundesliga,32,1991,2.8,10,5,5,5,0,2,14,14.3,12,7,1,6,4,14,6,0
Frans Krätzig,GER,DF,Bayern Munich,Bundesliga,20,2003,0.6,2,0,2,0,0,1,2,50.0,1,0,0,0,0,2,0,0
Tom Krauß,GER,MF,Mainz 05,Bundesliga,22,2001,15.0,57,33,22,31,4,21,58,36.2,37,33,4,29,17,74,28,0
Rasmus Kristensen,DEN,DF,Roma,Serie A,26,1997,19.4,36,19,25,8,3,28,50,56.0,22,27,7,20,8,44,50,0
Thomas Kristensen,DEN,DF,Udinese,Serie A,21,2002,23.3,35,24,25,10,0,21,33,63.6,12,29,20,9,29,64,118,0
Toni Kroos,GER,MF,Real Madrid,La Liga,33,1990,23.6,53,34,19,25,9,24,59,40.7,35,22,4,18,17,70,11,1
Nikola Krstović,MNE,FW,Lecce,Serie A,23,2000,26.4,17,6,3,9,5,6,10,60.0,4,12,4,8,4,21,22,0
Rade Krunić,BIH,MF,Milan,Serie A,29,1993,7.6,10,8,3,6,1,4,9,44.4,5,7,3,4,11,21,14,0
Lukas Kübler,GER,DF,Freiburg,Bundesliga,30,1992,20.5,50,24,35,13,2,26,42,61.9,16,36,14,22,37,87,57,1
Takefusa Kubo,JPN,"FW,MF",Real Sociedad,La Liga,22,2001,23.9,26,17,15,6,5,9,23,39.1,14,21,2,19,11,37,8,1
Mahmut Kücüksahin,,MF,Augsburg,Bundesliga,19,2004,0.0,0,0,0,0,0,0,0,,0,0,0,0,0,0,0,0
Mohammed Kudus,GHA,"FW,MF",West Ham,Premier League,22,2000,27.6,65,47,27,27,11,20,40,50.0,20,25,0,25,11,76,9,1
Christian Kühlwetter,GER,MF,Heidenheim,Bundesliga,27,1996,0.1,0,0,0,0,0,0,0,,0,0,0,0,0,0,0,0
Dejan Kulusevski,SWE,"FW,MF",Tottenham,Premier League,23,2000,30.7,62,33,19,20,23,25,67,37.3,42,24,1,23,18,80,2,1
Sael Kumbedi,FRA,DF,Lyon,Ligue 1,18,2005,10.3,30,20,14,12,4,9,22,40.9,13,12,3,9,14,44,18,2
Marash Kumbulla,ALB,DF,Sassuolo,Serie A,23,2000,4.0,3,2,2,1,0,1,2,50.0,1,8,6,2,0,3,22,0
Justin Kumi,ITA,FW,Sassuolo,Serie A,19,2004,0.0,0,0,0,0,0,0,0,,0,0,0,0,0,0,0,0
Layvin Kurzawa,FRA,DF,Paris S-G,Ligue 1,30,1992,0.1,0,0,0,0,0,0,0,,0,0,0,0,0,0,0,0
Berkan Kutlu,TUR,MF,Genoa,Serie A,25,1998,2.2,6,4,5,1,0,3,6,50.0,3,3,0,3,4,10,5,0
Daler Kuzyaev,RUS,MF,Le Havre,Ligue 1,30,1993,23.2,34,19,11,13,10,15,43,34.9,28,18,5,13,22,56,18,1
Khvicha Kvaratskhelia,GEO,FW,Napoli,Serie A,22,2001,30.4,42,21,11,19,12,15,49,30.6,34,15,1,14,13,55,9,0
Giorgi Kvernadze,GEO,"FW,DF",Frosinone,Serie A,20,2003,0.7,3,0,2,0,1,2,2,100.0,0,1,0,1,1,4,0,0
Moritz-Broni Kwarteng,GHA,FW,Bochum,Bundesliga,25,1998,3.1,3,0,0,3,0,1,7,14.3,6,4,0,4,2,5,0,0
Grejohn Kyei,FRA,FW,Clermont Foot,Ligue 1,27,1995,11.4,6,4,2,2,2,2,3,66.7,1,5,1,4,1,7,10,0
Giorgos Kyriakopoulos,GRE,DF,Monza,Serie A,27,1996,19.0,19,10,16,3,0,11,24,45.8,13,18,1,17,13,32,28,0
Luca de la Torre,USA,MF,Celta Vigo,La Liga,25,1998,21.7,39,21,12,22,5,22,43,51.2,21,23,4,19,12,51,17,0
Gaëtan Laborde,FRA,"FW,MF",Nice,Ligue 1,29,1994,21.2,18,12,8,4,6,11,30,36.7,19,20,2,18,6,24,8,1
Alexandre Lacazette,FRA,FW,Lyon,Ligue 1,32,1991,25.5,19,12,8,9,2,5,17,29.4,12,22,3,19,8,27,9,0
Maxence Lacroix,FRA,DF,Wolfsburg,Bundesliga,23,2000,26.2,48,29,28,18,2,29,41,70.7,12,35,12,23,24,72,121,0
Alban Lafont,FRA,GK,Nantes,Ligue 1,24,1999,27.7,0,0,0,0,0,0,2,0.0,2,0,0,0,0,0,14,0
Yoel Lago,ESP,DF,Celta Vigo,La Liga,19,2004,1.0,2,0,2,0,0,0,0,,0,1,0,1,0,2,2,0
Aïssa Laïdouni,TUN,MF,Union Berlin,Bundesliga,26,1996,11.9,21,12,4,12,5,4,12,33.3,8,26,2,24,12,33,14,2
Konrad Laimer,AUT,"DF,MF",Bayern Munich,Bundesliga,26,1997,19.7,56,36,25,20,11,22,52,42.3,30,42,6,36,18,74,13,2
Stefan Lainer,AUT,"DF,MF",Gladbach,Bundesliga,30,1992,8.3,23,16,15,8,0,14,24,58.3,10,13,6,7,5,28,28,0
Kenny Lala,MAD,DF,Brest,Ligue 1,31,1991,33.0,78,51,39,28,11,30,56,53.6,26,27,6,21,28,106,75,1
Adam Lallana,ENG,"MF,FW",Brighton,Premier League,35,1988,9.4,8,3,4,4,0,0,4,0.0,4,2,1,1,3,11,1,0
Mathis Lambourde,FRA,FW,Rennes,Ligue 1,17,2006,0.1,0,0,0,0,0,0,1,0.0,1,1,0,1,0,0,1,0
Érik Lamela,ARG,"FW,MF",Sevilla,La Liga,31,1992,5.1,21,14,4,10,7,10,15,66.7,5,12,0,12,1,22,5,0
Mohamed Lamine Bayo,GUI,FW,Le Havre,Ligue 1,25,1998,15.4,13,5,2,5,6,2,10,20.0,8,8,1,7,2,15,11,0
Didier Lamkel Zé,CMR,"FW,MF",Metz,Ligue 1,26,1996,6.1,7,2,2,4,1,2,5,40.0,3,4,0,4,0,7,11,0
Tariq Lamptey,GHA,"DF,FW",Brighton,Premier League,22,2000,10.2,21,14,14,5,2,13,22,59.1,9,7,3,4,6,27,6,0
Bruno Langa,MOZ,DF,Almería,La Liga,25,1997,9.1,17,12,10,5,2,6,14,42.9,8,11,4,7,4,21,33,2
Gianluca Lapadula,PER,FW,Cagliari,Serie A,33,1990,13.4,1,1,0,0,1,1,10,10.0,9,2,1,1,2,3,5,0
Aymeric Laporte,ESP,DF,Manchester City,Premier League,29,1994,0.1,0,0,0,0,0,0,0,,0,1,1,0,0,0,1,0
Julien Laporte,FRA,DF,Lorient,Ligue 1,29,1993,20.2,23,14,15,7,1,16,36,44.4,20,36,26,10,11,34,116,1
Cyle Larin,CAN,FW,Mallorca,La Liga,28,1995,20.3,17,8,6,4,7,2,7,28.6,5,16,5,11,3,20,17,0
Yasser Larouci,ALG,DF,Sheffield Utd,Premier League,22,2001,5.9,17,9,10,5,2,10,14,71.4,4,6,1,5,7,24,20,1
Hugo Larsson,SWE,MF,Eint Frankfurt,Bundesliga,19,2004,21.0,32,18,18,10,4,15,28,53.6,13,34,7,27,29,61,30,1
Jamaal Lascelles,ENG,DF,Newcastle Utd,Premier League,29,1993,12.0,14,9,7,7,0,6,11,54.5,5,17,12,5,5,19,42,0
Juanmi Latasa,ESP,FW,Getafe,La Liga,22,2001,17.3,9,7,0,6,3,1,11,9.1,10,9,0,9,4,13,21,0
Toni Lato,ESP,DF,Mallorca,La Liga,25,1997,17.2,38,23,19,13,6,16,27,59.3,11,17,3,14,17,55,27,0
Armand Lauriente,FRA,FW,Sassuolo,Serie A,24,1998,32.3,31,20,8,14,9,13,44,29.5,31,29,4,25,15,46,11,0
Roméo Lavia,BEL,MF,Chelsea,Premier League,19,2004,0.4,1,0,0,1,0,0,0,,0,0,0,0,0,1,1,0
Lázaro,BRA,"FW,MF",Almería,La Liga,21,2002,3.2,4,1,2,0,2,2,8,25.0,6,4,0,4,1,5,1,0
Valentino Lazaro,AUT,"DF,MF",Torino,Serie A,27,1996,22.2,18,11,7,9,2,13,19,68.4,6,14,1,13,8,26,29,0
Darko Lazović,SRB,"FW,MF",Hellas Verona,Serie A,32,1990,21.4,26,16,11,6,9,16,31,51.6,15,10,1,9,6,32,14,0
Manuel Lazzari,ITA,DF,Lazio,Serie A,29,1993,18.6,26,18,13,10,3,18,28,64.3,10,20,4,16,12,38,37,1
Théo Le Bris,FRA,"DF,MF",Lorient,Ligue 1,20,2002,16.8,35,22,25,7,3,19,40,47.5,21,24,3,21,12,47,42,0
Julien Le Cardinal,FRA,DF,Brest,Ligue 1,25,1997,5.3,19,11,11,7,1,8,12,66.7,4,6,3,3,13,32,26,0
Julien Le Cardinal,FRA,DF,Lens,Ligue 1,25,1997,0.6,6,2,4,2,0,4,9,44.4,5,2,1,1,0,6,0,0
Jérémy Le Douaron,FRA,FW,Brest,Ligue 1,25,1998,18.0,21,10,7,9,5,11,26,42.3,15,14,1,13,2,23,10,0
Enzo Le Fée,FRA,MF,Rennes,Ligue 1,23,2000,17.0,50,35,23,17,10,23,47,48.9,24,17,3,14,19,69,20,0
Vincent Le Goff,FRA,"DF,MF",Lorient,Ligue 1,33,1989,6.0,5,0,4,0,1,4,8,50.0,4,11,3,8,3,8,10,0
Robin Le Normand,ESP,DF,Real Sociedad,La Liga,26,1996,27.4,31,22,16,15,0,17,30,56.7,13,26,15,11,28,59,96,1
Nicola Leali,ITA,GK,Genoa,Serie A,30,1993,2.0,0,0,0,0,0,0,0,,0,0,0,0,0,0,0,0
Rafael Leão,POR,FW,Milan,Serie A,24,1999,27.9,16,10,3,8,5,8,13,61.5,5,15,1,14,9,25,19,0
Adrien Lebeau,FRA,"MF,FW",Brest,Ligue 1,24,1999,0.6,0,0,0,0,0,0,3,0.0,3,2,1,1,0,0,1,0
Jean-Louis Leca,FRA,GK,Lens,Ligue 1,37,1985,1.0,0,0,0,0,0,0,0,,0,0,0,0,0,0,1,0
Benjamin Lecomte,FRA,GK,Montpellier,Ligue 1,32,1991,30.0,0,0,0,0,0,0,1,0.0,1,0,0,0,0,0,16,1
Jeremías Ledesma,ARG,GK,Cádiz,La Liga,30,1993,33.9,1,1,1,0,0,1,4,25.0,3,0,0,0,0,1,15,3
Pierre Lees-Melou,FRA,MF,Brest,Ligue 1,30,1993,28.0,96,67,51,41,4,49,129,38.0,80,61,11,50,43,139,64,3
Diogo Leite,POR,DF,Union Berlin,Bundesliga,24,1999,30.0,52,36,31,15,6,25,51,49.0,26,48,22,26,47,99,155,1
Maxim Leitsch,GER,DF,Mainz 05,Bundesliga,25,1998,4.2,6,3,5,1,0,3,6,50.0,3,2,0,2,4,10,13,0
Florian Lejeune,FRA,DF,Rayo Vallecano,La Liga,32,1991,37.0,39,25,26,11,2,19,30,63.3,11,33,18,15,23,62,155,1
Stefan Lekovic,SRB,DF,Villarreal,La Liga,19,2004,0.3,0,0,0,0,0,0,0,,0,1,1,0,0,0,1,0
Iñigo Lekue,ESP,DF,Athletic Club,La Liga,30,1993,22.2,40,22,25,10,5,27,53,50.9,26,24,6,18,15,55,50,0
Thomas Lemar,FRA,MF,Atlético Madrid,La Liga,27,1995,1.8,3,1,2,1,0,1,2,50.0,1,0,0,0,0,3,0,0
Mario Lemina,GAB,MF,Wolves,Premier League,29,1993,33.0,90,58,46,33,11,25,47,53.2,22,36,9,27,41,131,64,0
Álvaro Lemos,ESP,DF,Las Palmas,La Liga,30,1993,2.8,4,1,1,3,0,0,2,0.0,2,3,1,2,2,6,4,0
Ruben Lendinez,ESP,DF,Valencia,La Liga,20,2003,0.1,2,2,0,2,0,1,1,100.0,0,0,0,0,0,2,1,0
Clément Lenglet,FRA,DF,Aston Villa,Premier League,28,1995,12.8,13,9,7,5,1,7,13,53.8,6,19,11,8,7,20,47,1
Bernd Leno,GER,GK,Fulham,Premier League,31,1992,38.0,0,0,0,0,0,0,0,,0,0,0,0,0,0,14,1
Christopher Lenz,GER,"DF,MF",RB Leipzig,Bundesliga,28,1994,0.5,2,1,2,0,0,1,1,100.0,0,0,0,0,2,4,2,0
Christopher Lenz,GER,DF,Eint Frankfurt,Bundesliga,28,1994,0.1,1,1,0,1,0,1,1,100.0,0,0,0,0,0,1,1,0
Johann Lepenant,FRA,MF,Lyon,Ligue 1,20,2002,2.8,4,3,2,2,0,1,8,12.5,7,5,0,5,4,8,0,0
Jefferson Lerma,COL,"MF,DF",Crystal Palace,Premier League,28,1994,26.7,42,25,15,23,4,19,40,47.5,21,31,12,19,36,78,72,0
Léo Leroy,FRA,MF,Montpellier,Ligue 1,23,2000,5.5,19,10,8,8,3,6,21,28.6,15,12,3,9,7,26,8,0
Robert Lewandowski,POL,FW,Barcelona,La Liga,34,1988,30.6,8,5,0,6,2,4,12,33.3,8,13,4,9,9,17,18,0
Jamie Leweling,GER,"FW,MF",Stuttgart,Bundesliga,22,2001,16.9,18,10,4,6,8,5,17,29.4,12,21,1,20,5,23,13,0
Rico Lewis,ENG,"DF,MF",Manchester City,Premier League,18,2004,9.0,10,7,4,4,2,3,7,42.9,4,7,1,6,4,14,6,0
Keane Lewis-Potter,ENG,"FW,DF",Brentford,Premier League,22,2001,16.0,17,7,5,11,1,7,15,46.7,8,10,2,8,7,24,23,0
Philipp Lienhart,AUT,DF,Freiburg,Bundesliga,27,1996,14.1,20,13,14,5,1,13,23,56.5,10,18,11,7,14,34,51,0
Matthijs de Ligt,NED,DF,Bayern Munich,Bundesliga,23,1999,15.4,15,12,4,8,3,6,11,54.5,5,14,10,4,19,34,52,0
Victor Lindelöf,SWE,DF,Manchester Utd,Premier League,29,1994,14.8,15,10,8,7,0,5,13,38.5,8,18,9,9,12,27,40,1
Jesper Lindstrøm,DEN,"FW,MF",Napoli,Serie A,23,2000,4.8,8,3,2,3,3,4,8,50.0,4,3,0,3,2,10,6,0
Jesper Lindstrøm,DEN,FW,Eint Frankfurt,Bundesliga,23,2000,0.9,1,1,1,0,0,0,0,,0,0,0,0,0,1,0,0
Karol Linetty,POL,MF,Torino,Serie A,28,1995,20.6,30,21,9,20,1,9,29,31.0,20,24,8,16,23,53,27,1
Samuel Lino,BRA,"DF,MF",Atlético Madrid,La Liga,23,1999,23.1,61,34,32,17,12,35,70,50.0,35,37,1,36,14,75,27,0
Luca Lipani,ITA,MF,Sassuolo,Serie A,18,2005,4.3,9,7,4,3,2,3,11,27.3,8,9,2,7,6,15,7,0
Pol Lirola,ESP,DF,Frosinone,Serie A,25,1997,17.1,30,18,14,15,1,17,35,48.6,18,12,1,11,19,49,41,1
Marcin Listkowski,POL,FW,Lecce,Serie A,25,1998,0.1,0,0,0,0,0,0,0,,0,0,0,0,0,0,0,0
Valentino Livramento,ENG,DF,Newcastle Utd,Premier League,20,2002,14.6,23,13,15,6,2,10,21,47.6,11,16,7,9,25,48,41,1
Dejan Ljubicic,AUT,"MF,FW",Köln,Bundesliga,25,1997,22.8,43,27,20,18,5,20,43,46.5,23,22,2,20,18,61,11,0
Javier Llabrés,ESP,"MF,FW",Mallorca,La Liga,20,2002,2.7,3,1,1,1,1,1,2,50.0,1,1,0,1,3,6,4,0
Diego Llorente,ESP,DF,Roma,Serie A,29,1993,24.1,31,19,20,10,1,11,24,45.8,13,40,27,13,22,53,79,0
Marcos Llorente,ESP,"MF,DF",Atlético Madrid,La Liga,28,1995,28.5,40,23,18,17,5,16,44,36.4,28,36,11,25,14,54,35,0
Gautier Lloris,FRA,DF,Le Havre,Ligue 1,28,1995,30.9,50,28,40,9,1,28,42,66.7,14,50,30,20,32,82,142,1
Abou Lô,SEN,"MF,DF",Metz,Ligue 1,23,2000,2.2,3,1,2,1,0,1,4,25.0,3,5,2,3,4,7,8,0
Giovani Lo Celso,ARG,MF,Tottenham,Premier League,27,1996,5.6,22,13,10,8,4,9,14,64.3,5,4,1,3,5,27,2,0
Stanislav Lobotka,SVK,MF,Napoli,Serie A,28,1994,36.5,61,39,18,30,13,24,60,40.0,36,30,8,22,30,91,29,0
Manuel Locatelli,ITA,MF,Juventus,Serie A,25,1998,33.4,69,43,24,35,10,31,58,53.4,27,43,17,26,25,94,65,0
Bradley Locko,FRA,DF,Brest,Ligue 1,21,2002,32.9,97,55,57,34,6,47,80,58.8,33,28,1,27,40,137,69,0
Tom Lockyer,WAL,DF,Luton Town,Premier League,28,1994,13.0,25,16,17,6,2,15,22,68.2,7,23,13,10,23,48,68,0
Renan Lodi,BRA,DF,Marseille,Ligue 1,25,1998,13.7,24,16,8,13,3,13,21,61.9,8,7,2,5,16,40,35,0
Ruben Loftus-Cheek,ENG,MF,Milan,Serie A,27,1996,23.0,28,18,7,14,7,15,27,55.6,12,24,12,12,9,37,10,1
Andy Logbo,FRA,FW,Le Havre,Ligue 1,19,2004,2.8,0,0,0,0,0,0,3,0.0,3,7,3,4,0,0,2,0
Enzo Loiodice,FRA,MF,Las Palmas,La Liga,22,2000,19.9,62,35,15,34,13,20,42,47.6,22,20,2,18,12,74,16,1
Sean Longstaff,ENG,MF,Newcastle Utd,Premier League,25,1997,30.5,54,30,17,29,8,24,63,38.1,39,43,7,36,17,71,23,0
Ademola Lookman,NGA,"FW,MF",Atalanta,Serie A,25,1997,21.0,20,15,2,11,7,8,22,36.4,14,19,0,19,9,29,0,1
Noah Loosli,SUI,DF,Bochum,Bundesliga,26,1997,3.8,10,7,6,4,0,7,14,50.0,7,7,1,6,7,17,18,0
Anthony Lopes,POR,GK,Lyon,Ligue 1,32,1990,31.0,0,0,0,0,0,0,0,,0,0,0,0,0,0,16,0
David López,ESP,DF,Girona,La Liga,33,1989,21.8,33,20,21,12,0,17,22,77.3,5,28,19,9,20,53,63,4
Diego López,ESP,"MF,FW",Valencia,La Liga,21,2002,29.5,37,25,14,16,7,13,56,23.2,43,23,1,22,20,57,12,0
Fermin López,ESP,"MF,FW",Barcelona,La Liga,20,2003,16.1,41,21,15,18,8,14,40,35.0,26,14,1,13,4,45,9,0
Javi López,ESP,DF,Alavés,La Liga,21,2002,26.5,23,12,11,9,3,15,26,57.7,11,25,9,16,10,33,77,1
Maxime Lopez,FRA,MF,Fiorentina,Serie A,25,1997,8.9,18,9,5,10,3,6,12,50.0,6,3,1,2,7,25,6,0
Maxime Lopez,FRA,MF,Sassuolo,Serie A,25,1997,1.6,2,1,1,1,0,1,2,50.0,1,1,1,0,2,4,0,0
Pau López,ESP,GK,Marseille,Ligue 1,28,1994,32.7,0,0,0,0,0,0,2,0.0,2,0,0,0,0,0,10,1
Unai López,ESP,MF,Rayo Vallecano,La Liga,27,1995,23.4,48,24,18,23,7,21,53,39.6,32,24,3,21,16,64,15,2
Dion Lopy,SEN,MF,Almería,La Liga,21,2002,21.3,62,37,36,20,6,17,44,38.6,27,23,5,18,15,77,22,2
Anthony Losilla,FRA,MF,Bochum,Bundesliga,37,1986,28.6,63,37,15,40,8,23,51,45.1,28,37,8,29,25,88,51,0
Jordan Lotomba,SUI,DF,Nice,Ligue 1,24,1998,20.0,36,28,18,9,9,25,35,71.4,10,30,9,21,16,52,26,1
Tom Louchet,FRA,"MF,DF",Nice,Ligue 1,20,2003,4.5,14,5,6,6,2,7,11,63.6,4,7,3,4,3,17,9,0
Imran Louza,MAR,MF,Lorient,Ligue 1,24,1999,9.6,13,7,2,8,3,2,8,25.0,6,8,1,7,9,22,4,0
Matteo Lovato,ITA,DF,Torino,Serie A,23,2000,6.0,10,7,5,5,0,4,5,80.0,1,9,5,4,13,23,10,0
Matteo Lovato,ITA,DF,Salernitana,Serie A,23,2000,10.5,27,14,17,8,2,16,24,66.7,8,14,7,7,18,45,41,1
Dejan Lovren,CRO,DF,Lyon,Ligue 1,34,1989,8.0,9,7,6,3,0,3,7,42.9,4,6,5,1,12,21,37,0
Sandi Lovrić,SVN,MF,Udinese,Serie A,25,1998,22.1,25,12,9,11,5,9,23,39.1,14,21,2,19,21,46,24,0
Max Lowe,ENG,"DF,MF",Sheffield Utd,Premier League,26,1997,5.6,21,10,13,5,3,8,15,53.3,7,10,4,6,5,26,15,0
Anthony Lozano,HON,"MF,FW",Getafe,La Liga,30,1993,1.0,0,0,0,0,0,0,1,0.0,1,0,0,0,0,0,1,0
Anthony Lozano,HON,FW,Almería,La Liga,30,1993,8.6,7,5,2,5,0,4,7,57.1,3,6,1,5,2,9,12,0
Lucas,BRA,DF,Cádiz,La Liga,22,2001,17.1,47,27,32,11,4,32,55,58.2,23,27,4,23,17,64,45,0
Lorenzo Lucca,ITA,FW,Udinese,Serie A,22,2000,28.8,19,11,4,11,4,5,20,25.0,15,18,3,15,3,22,36,1
Jhon Lucumí,COL,DF,Bologna,Serie A,25,1998,24.6,48,29,31,17,0,27,36,75.0,9,32,17,15,16,64,68,2
José Luis Gayà,ESP,DF,Valencia,La Liga,28,1995,19.9,71,36,44,23,4,43,67,64.2,24,18,3,15,11,82,42,0
José Luis Morales,ESP,"FW,MF",Villarreal,La Liga,36,1987,11.6,5,3,1,4,0,3,13,23.1,10,9,1,8,7,12,4,0
José Luis Palomino,ARG,DF,Atalanta,Serie A,33,1990,0.3,2,1,1,1,0,1,1,100.0,0,2,1,1,1,3,6,0
Douglas Luiz,BRA,MF,Aston Villa,Premier League,25,1998,33.3,58,38,21,27,10,25,53,47.2,28,32,8,24,23,81,18,2
Romelu Lukaku,BEL,FW,Roma,Serie A,30,1993,29.3,6,5,1,2,3,2,4,50.0,2,7,1,6,0,6,19,1
Castello Lukeba,FRA,DF,RB Leipzig,Bundesliga,20,2002,24.3,19,12,10,9,0,10,12,83.3,2,35,13,22,12,31,94,2
Dodi Lukebakio,BEL,"FW,MF",Sevilla,La Liga,25,1997,12.5,5,2,2,2,1,1,6,16.7,5,9,2,7,2,7,5,0
Saša Lukić,SRB,MF,Fulham,Premier League,26,1996,12.5,33,19,9,17,7,18,39,46.2,21,18,5,13,16,49,19,1
Karlo Lulić,CRO,MF,Frosinone,Serie A,27,1996,0.2,0,0,0,0,0,0,0,,0,1,0,1,1,1,0,0
Andriy Lunin,UKR,GK,Real Madrid,La Liga,24,1999,21.0,0,0,0,0,0,0,1,0.0,1,0,0,0,0,0,15,1
Sebastiano Luperto,ITA,DF,Empoli,Serie A,26,1996,37.8,37,26,25,10,2,15,24,62.5,9,46,35,11,32,69,157,1
Mateus Lusuardi,BRA,DF,Frosinone,Serie A,19,2004,2.4,2,1,1,1,0,1,3,33.3,2,4,2,2,4,6,8,0
Andreas Luthe,GER,GK,Bochum,Bundesliga,36,1987,1.0,0,0,0,0,0,0,0,,0,0,0,0,0,0,1,0
Zito Luvumbo,ANG,"FW,MF",Cagliari,Serie A,21,2002,21.6,9,6,5,2,2,4,15,26.7,11,19,0,19,1,10,2,0
Charalambos Lykogiannis,GRE,DF,Bologna,Serie A,29,1993,10.0,10,6,5,4,1,5,10,50.0,5,15,5,10,5,15,30,0
Senne Lynen,BEL,MF,Werder Bremen,Bundesliga,24,1999,20.0,64,38,33,27,4,30,70,42.9,40,41,8,33,41,105,56,0
Joshua M'Bahia,CIV,MF,Clermont Foot,Ligue 1,18,2005,0.2,0,0,0,0,0,0,0,,0,0,0,0,0,0,0,0
Othmane Maamma,FRA,FW,Montpellier,Ligue 1,17,2005,1.0,3,3,2,0,1,1,1,100.0,0,3,0,3,0,3,0,0
Ian Maatsen,NED,"FW,MF",Chelsea,Premier League,21,2002,2.3,3,2,1,1,1,0,4,0.0,4,4,0,4,3,6,10,0
Ian Maatsen,NED,DF,Dortmund,Bundesliga,21,2002,14.0,30,22,15,9,6,16,30,53.3,14,22,4,18,13,43,26,0
Alexis Mac Allister,ARG,MF,Liverpool,Premier League,24,1998,28.9,99,55,35,50,14,59,125,47.2,66,65,8,57,35,134,25,1
Deiver Machado,COL,DF,Lens,Ligue 1,29,1993,12.5,24,18,10,10,4,15,20,75.0,5,13,2,11,7,31,8,0
Darwin Machís,VEN,MF,Cádiz,La Liga,30,1993,8.7,23,14,7,9,7,13,24,54.2,11,8,1,7,4,27,2,0
James Maddison,ENG,MF,Tottenham,Premier League,26,1996,23.7,33,19,5,18,10,15,29,51.7,14,15,3,12,13,46,10,1
Noni Madueke,ENG,FW,Chelsea,Premier League,21,2002,11.7,16,10,8,4,4,11,34,32.4,23,11,0,11,4,20,14,0
Pablo Maffeo,ESP,DF,Mallorca,La Liga,26,1997,16.2,35,22,18,13,4,23,40,57.5,17,12,2,10,10,45,23,0
Gabriel Magalhães,BRA,DF,Arsenal,Premier League,25,1997,33.8,48,28,24,22,2,17,22,77.3,5,44,33,11,31,79,100,1
Soungoutou Magassa,FRA,"DF,MF",Monaco,Ligue 1,19,2003,15.0,56,26,22,32,2,26,48,54.2,22,21,4,17,21,77,36,2
Giulio Maggiore,ITA,MF,Salernitana,Serie A,25,1998,20.0,49,29,26,22,1,20,42,47.6,22,27,5,22,24,73,38,0
Matej Maglica,CRO,DF,Darmstadt 98,Bundesliga,24,1998,18.9,35,21,25,10,0,22,36,61.1,14,29,11,18,22,57,92,5
Giangiacomo Magnani,ITA,DF,Hellas Verona,Serie A,27,1995,27.2,33,18,23,10,0,15,25,60.0,10,50,28,22,45,78,118,0
Hugo Magnetti,FRA,MF,Brest,Ligue 1,25,1998,26.0,49,27,18,26,5,24,58,41.4,34,19,1,18,18,67,18,0
Yohann Magnin,FRA,MF,Clermont Foot,Ligue 1,26,1997,18.7,49,31,12,32,5,22,47,46.8,25,38,13,25,19,68,26,1
Frank Magri,CMR,"FW,MF",Toulouse,Ligue 1,23,1999,16.0,22,14,5,12,5,15,21,71.4,6,16,4,12,4,26,17,0
Harry Maguire,ENG,DF,Manchester Utd,Premier League,30,1993,18.4,24,17,14,10,0,12,22,54.5,10,33,24,9,25,49,83,1
Jon Magunacelaya,ESP,"FW,MF",Real Sociedad,La Liga,23,2000,1.3,5,3,2,3,0,4,8,50.0,4,3,0,3,0,5,2,0
Adel Mahamoud,COM,FW,Nantes,Ligue 1,20,2003,0.1,0,0,0,0,0,0,1,0.0,1,0,0,0,0,0,0,0
Arne Maier,GER,MF,Augsburg,Bundesliga,24,1999,11.1,14,9,5,8,1,5,14,35.7,9,19,2,17,6,20,11,0
Habib Maïga,CIV,"MF,FW",Metz,Ligue 1,27,1996,1.6,2,2,1,0,1,1,3,33.3,2,2,0,2,4,6,2,0
Mike Maignan,FRA,GK,Milan,Serie A,28,1995,29.0,1,0,1,0,0,1,1,100.0,0,1,0,1,1,2,4,3
Linton Maina,GER,"FW,MF",Köln,Bundesliga,24,1999,21.1,18,15,11,5,2,9,28,32.1,19,12,1,11,6,24,12,0
Patrick Mainka,GER,DF,Heidenheim,Bundesliga,28,1994,34.0,85,49,58,24,3,38,74,51.4,36,66,32,34,49,134,158,1
Kobbie Mainoo,ENG,MF,Manchester Utd,Premier League,18,2005,21.4,47,27,20,16,11,21,45,46.7,24,20,12,8,22,69,30,1
Ainsley Maitland-Niles,ENG,"DF,MF",Lyon,Ligue 1,25,1997,15.9,34,18,12,14,8,19,37,51.4,18,16,6,10,17,51,29,1
Radosław Majecki,POL,GK,Monaco,Ligue 1,23,1999,12.0,0,0,0,0,0,0,0,,0,1,0,1,0,0,5,1
Lovro Majer,CRO,MF,Rennes,Ligue 1,25,1998,0.2,0,0,0,0,0,0,0,,0,0,0,0,0,0,1,0
Lovro Majer,CRO,"MF,FW",Wolfsburg,Bundesliga,25,1998,23.4,39,18,17,22,0,12,31,38.7,19,20,1,19,12,51,13,0
Jean-Victor Makengo,FRA,"MF,FW",Lorient,Ligue 1,25,1998,5.3,5,4,3,2,0,2,6,33.3,4,12,1,11,8,13,5,0
Jordy Makengo,FRA,DF,Freiburg,Bundesliga,21,2001,11.4,17,11,11,5,1,6,10,60.0,4,16,4,12,11,28,37,0
Antoine Makoumbou,CGO,MF,Cagliari,Serie A,25,1998,30.0,41,24,21,15,5,15,30,50.0,15,23,4,19,16,57,27,2
Nemanja Maksimović,SRB,MF,Getafe,La Liga,28,1995,36.3,65,43,26,31,8,23,41,56.1,18,56,23,33,46,111,61,0
Julián Malatini,ARG,DF,Werder Bremen,Bundesliga,22,2001,6.7,18,13,12,3,3,16,24,66.7,8,8,1,7,13,31,26,0
Daniel Maldini,ITA,"MF,FW",Monza,Serie A,21,2001,3.7,3,2,0,2,1,3,6,50.0,3,2,0,2,2,5,1,0
Daniel Maldini,ITA,"FW,MF",Empoli,Serie A,21,2001,2.9,4,2,0,2,2,2,2,100.0,0,5,0,5,2,6,2,0
Youssef Maleh,MAR,MF,Empoli,Serie A,24,1998,28.9,74,48,30,36,8,23,52,44.2,29,62,7,55,25,99,29,0
Donyell Malen,NED,"FW,MF",Dortmund,Bundesliga,24,1999,19.8,11,7,5,3,3,2,6,33.3,4,11,4,7,2,13,8,0
Ruslan Malinovskyi,UKR,MF,Genoa,Serie A,30,1993,17.2,35,20,18,11,6,17,41,41.5,24,22,8,14,5,40,16,0
Lennard Maloney,USA,MF,Heidenheim,Bundesliga,23,1999,25.4,43,26,14,24,5,25,59,42.4,34,33,9,24,25,68,88,0
Aaron Malouda,FRA,FW,Lille,Ligue 1,17,2005,0.0,0,0,0,0,0,0,0,,0,0,0,0,0,0,0,0
Giorgi Mamardashvili,GEO,GK,Valencia,La Liga,22,2000,36.5,4,3,4,0,0,4,4,100.0,0,1,0,1,2,6,22,2
David Mamutovic,GER,"FW,DF",Mainz 05,Bundesliga,22,2000,0.1,1,1,0,1,0,1,1,100.0,0,0,0,0,0,1,0,0
Wilson Manafá,POR,"DF,MF",Granada,La Liga,29,1994,2.7,6,4,3,2,1,4,7,57.1,3,1,0,1,1,7,4,1
Hianga Mananga Mbock,FRA,"MF,FW",Brest,Ligue 1,23,1999,0.1,1,0,0,0,1,1,2,50.0,1,0,0,0,1,2,0,0
Gianluca Mancini,ITA,DF,Roma,Serie A,27,1996,31.9,34,20,21,11,2,11,27,40.7,16,38,26,12,36,70,77,1
Marco Mancosu,ITA,"MF,FW",Cagliari,Serie A,34,1988,1.7,3,0,0,2,1,1,2,50.0,1,0,0,0,0,3,0,0
Steve Mandanda,FRA,GK,Rennes,Ligue 1,38,1985,34.0,2,0,2,0,0,2,4,50.0,2,0,0,0,0,2,6,1
Christos Mandas,GRE,GK,Lazio,Serie A,21,2001,8.0,0,0,0,0,0,0,1,0.0,1,0,0,0,1,1,3,1
Reinildo Mandava,MOZ,DF,Atlético Madrid,La Liga,29,1994,8.1,30,22,16,11,3,19,22,86.4,3,10,2,8,15,45,21,0
Aïssa Mandi,ALG,DF,Villarreal,La Liga,31,1991,12.4,13,8,8,5,0,7,14,50.0,7,10,7,3,8,21,41,0
Rolando Mandragora,ITA,MF,Fiorentina,Serie A,26,1997,17.6,26,11,8,13,5,10,22,45.5,12,14,3,11,9,35,18,1
Orel Mangala,BEL,MF,Nott'ham Forest,Premier League,25,1998,17.4,27,13,16,10,1,14,29,48.3,15,12,6,6,26,53,32,0
Orel Mangala,BEL,MF,Lyon,Ligue 1,25,1998,4.4,5,3,0,2,3,1,3,33.3,2,3,2,1,5,10,6,0
Vito Mannone,ITA,GK,Lille,Ligue 1,35,1988,1.0,0,0,0,0,0,0,0,,0,0,0,0,0,0,0,0
Kostas Manolas,GRE,DF,Salernitana,Serie A,32,1991,5.4,9,5,6,3,0,6,8,75.0,2,10,7,3,2,11,20,0
Javier Manquillo,ESP,"DF,MF",Celta Vigo,La Liga,29,1994,8.3,15,11,6,5,4,8,15,53.3,7,14,3,11,3,18,17,0
Braydon Manu,GHA,MF,Darmstadt 98,Bundesliga,26,1997,1.9,2,0,0,1,1,0,0,,0,1,0,1,0,2,0,0
Benson Manuel,ANG,"MF,FW",Burnley,Premier League,26,1997,1.3,3,2,2,1,0,0,0,,0,1,0,1,0,3,0,0
Faitout Maouassa,FRA,"DF,MF",Granada,La Liga,25,1998,2.5,8,5,6,1,1,4,5,80.0,1,6,0,6,1,9,3,0
Faitout Maouassa,FRA,"MF,DF",Lens,Ligue 1,25,1998,0.8,1,1,1,0,0,1,1,100.0,0,1,0,1,0,1,3,0
Marcão,BRA,DF,Sevilla,La Liga,27,1996,3.9,9,6,5,4,0,6,10,60.0,4,8,6,2,4,13,11,1
Solly March,ENG,"FW,DF",Brighton,Premier League,29,1994,6.2,19,14,9,7,3,8,14,57.1,6,5,0,5,11,30,8,0
Riccardo Marchizza,ITA,DF,Frosinone,Serie A,25,1998,12.8,7,6,4,3,0,3,13,23.1,10,10,2,8,7,14,33,0
Gian Marco Ferrari,ITA,DF,Sassuolo,Serie A,31,1992,25.2,22,10,11,11,0,12,18,66.7,6,28,17,11,25,47,76,0
Óscar de Marcos,ESP,DF,Athletic Club,La Liga,34,1989,25.1,56,39,26,24,6,42,71,59.2,29,28,6,22,15,71,44,0
Alberto Marí,ESP,FW,Valencia,La Liga,22,2001,3.1,4,2,0,1,3,1,1,100.0,0,3,0,3,0,4,5,0
José Mari,ESP,"MF,FW",Cádiz,La Liga,35,1987,0.2,2,1,0,2,0,1,2,50.0,1,0,0,0,0,2,0,0
Pablo Marí,ESP,DF,Monza,Serie A,29,1993,29.1,41,25,34,7,0,22,34,64.7,12,40,25,15,37,78,115,1
José María Giménez,URU,DF,Atlético Madrid,La Liga,28,1995,14.7,18,10,10,7,1,5,16,31.3,11,16,12,4,10,28,95,0
Mariano,DOM,"FW,MF",Sevilla,La Liga,29,1993,2.7,1,1,0,1,0,0,1,0.0,1,1,0,1,0,1,2,0
Mirko Marić,CRO,FW,Monza,Serie A,28,1995,3.2,4,0,2,1,1,0,2,0.0,2,4,0,4,2,6,3,0
Rafa Marín,ESP,DF,Alavés,La Liga,21,2002,27.1,32,20,23,9,0,14,27,51.9,13,34,21,13,33,65,129,2
Răzvan Marin,ROU,MF,Empoli,Serie A,27,1996,20.2,40,22,13,23,4,19,29,65.5,10,16,4,12,6,46,30,2
Diego Mariño,ESP,GK,Almería,La Liga,33,1990,1.0,0,0,0,0,0,0,0,,0,0,0,0,0,0,1,0
Guillermo Maripán,CHI,DF,Monaco,Ligue 1,29,1994,19.6,22,8,15,6,1,10,27,37.0,17,26,13,13,30,52,106,4
Mika Màrmol,ESP,DF,Las Palmas,La Liga,21,2002,35.3,70,42,44,24,2,35,53,66.0,18,39,19,20,44,114,147,2
Omar Marmoush,EGY,"FW,MF",Eint Frankfurt,Bundesliga,24,1999,25.6,21,11,7,8,6,6,16,37.5,10,13,0,13,11,32,7,0
Marquinhos,BRA,"FW,MF",Nantes,Ligue 1,20,2003,1.7,3,2,2,0,1,1,4,25.0,3,7,2,5,6,9,1,0
Marquinhos,BRA,DF,Paris S-G,Ligue 1,29,1994,17.1,19,11,10,7,2,11,17,64.7,6,29,19,10,17,36,58,1
Unai Marrero,ESP,GK,Real Sociedad,La Liga,21,2001,1.6,0,0,0,0,0,0,0,,0,0,0,0,0,0,0,0
Agustín Martegani,ARG,MF,Salernitana,Serie A,23,2000,8.1,13,7,7,3,3,6,18,33.3,12,4,1,3,4,17,7,1
Eric Martel,GER,MF,Köln,Bundesliga,21,2002,27.3,70,43,32,34,4,37,67,55.2,30,65,19,46,43,113,80,0
Roger Martí,ESP,FW,Cádiz,La Liga,32,1991,15.1,12,6,1,9,2,2,7,28.6,5,16,1,15,7,19,4,0
Anthony Martial,FRA,FW,Manchester Utd,Premier League,27,1995,5.0,4,1,1,1,2,1,1,100.0,0,4,0,4,0,4,3,0
Aarón Martín,ESP,DF,Genoa,Serie A,26,1997,15.3,21,10,7,10,4,9,22,40.9,13,12,4,8,9,30,15,0
Iván Martín,ESP,MF,Girona,La Liga,24,1999,30.3,44,25,22,15,7,22,57,38.6,35,25,3,22,21,65,14,0
Jon Martin,ESP,DF,Real Sociedad,La Liga,17,2006,0.3,0,0,0,0,0,0,0,,0,0,0,0,0,0,3,0
Jonas Martin,FRA,MF,Brest,Ligue 1,33,1990,13.4,43,27,17,24,2,21,36,58.3,15,16,2,14,9,52,28,2
Mario Martín,ESP,MF,Real Madrid,La Liga,19,2004,0.2,5,1,0,2,3,3,4,75.0,1,2,1,1,0,5,0,0
Gabriel Martinelli,BRA,FW,Arsenal,Premier League,22,2001,22.4,30,24,9,12,9,13,32,40.6,19,23,1,22,5,35,9,1
Tommaso Martinelli,ITA,GK,Fiorentina,Serie A,17,2006,1.0,0,0,0,0,0,0,0,,0,0,0,0,0,0,0,0
Arnau Martinez,ESP,DF,Girona,La Liga,20,2003,13.8,25,16,17,6,2,15,32,46.9,17,15,5,10,10,35,41,3
Emiliano Martínez,ARG,GK,Aston Villa,Premier League,30,1992,33.5,0,0,0,0,0,0,0,,0,0,0,0,0,0,12,3
Iñigo Martínez,ESP,DF,Barcelona,La Liga,32,1991,14.4,10,7,9,1,0,6,8,75.0,2,13,10,3,11,21,50,0
Josep Martinez,ESP,GK,Genoa,Serie A,25,1998,36.0,0,0,0,0,0,0,0,,0,0,0,0,1,1,21,3
Lautaro Martínez,ARG,FW,Inter,Serie A,25,1997,29.5,22,16,4,13,5,4,19,21.1,15,30,1,29,20,42,10,0
Lisandro Martínez,ARG,DF,Manchester Utd,Premier League,25,1998,7.2,12,8,8,4,0,5,12,41.7,7,10,8,2,5,17,26,0
Marc Martínez,ESP,GK,Granada,La Liga,33,1990,3.0,0,0,0,0,0,0,1,0.0,1,0,0,0,0,0,1,0
Lucas Martínez Quarta,ARG,DF,Fiorentina,Serie A,27,1996,25.5,75,47,43,28,4,36,54,66.7,18,38,14,24,30,105,69,4
Adam Marušić,MNE,DF,Lazio,Serie A,30,1992,34.4,45,31,24,19,2,27,49,55.1,22,27,7,20,29,74,63,2
Marvin,ESP,"FW,DF",Las Palmas,La Liga,23,2000,20.6,39,25,18,17,4,18,36,50.0,18,28,2,26,14,53,18,1
Omar Mascarell,EQG,MF,Mallorca,La Liga,30,1993,17.5,33,16,16,17,0,18,35,51.4,17,24,8,16,31,64,30,1
Adam Masina,MAR,DF,Udinese,Serie A,29,1994,0.7,4,0,2,2,0,2,4,50.0,2,2,1,1,2,6,5,0
Adam Masina,MAR,DF,Torino,Serie A,29,1994,11.4,17,12,8,8,1,5,20,25.0,15,12,6,6,11,28,30,0
Erhan Mašović,SRB,"DF,MF",Bochum,Bundesliga,24,1998,24.7,64,40,37,22,5,37,70,52.9,33,32,10,22,25,89,75,2
Han-Noah Massengo,FRA,"MF,DF",Burnley,Premier League,22,2001,0.2,1,1,1,0,0,0,0,,0,1,0,1,0,1,0,0
Roberto Massimo,GER,"FW,DF",Stuttgart,Bundesliga,22,2000,0.9,1,0,1,0,0,1,2,50.0,1,0,0,0,0,1,1,0
Clinton Mata,ANG,DF,Lyon,Ligue 1,30,1992,24.7,43,24,29,8,6,23,40,57.5,17,35,16,19,40,83,61,0
Jaime Mata,ESP,"FW,MF",Getafe,La Liga,34,1988,19.9,24,15,12,8,4,11,26,42.3,15,18,1,17,17,41,31,0
Pape Matar Sarr,SEN,MF,Tottenham,Premier League,20,2002,23.0,34,24,11,17,6,15,36,41.7,21,21,5,16,31,65,28,1
Eliot Matazo,BEL,MF,Monaco,Ligue 1,21,2002,1.1,3,1,0,3,0,2,4,50.0,2,1,1,0,3,6,0,0
Jean-Philippe Mateta,FRA,FW,Crystal Palace,Premier League,26,1997,25.4,22,15,4,11,7,6,10,60.0,4,13,4,9,4,26,14,0
Nemanja Matić,SRB,MF,Rennes,Ligue 1,34,1988,11.4,19,10,7,9,3,9,12,75.0,3,15,7,8,27,46,19,0
Nemanja Matić,SRB,MF,Lyon,Ligue 1,34,1988,13.9,17,11,8,7,2,9,19,47.4,10,17,6,11,16,33,17,1
Joël Matip,CMR,DF,Liverpool,Premier League,31,1991,8.7,12,6,7,4,1,8,12,66.7,4,16,12,4,9,21,43,0
Alex Matos,ENG,MF,Chelsea,Premier League,18,2004,0.0,0,0,0,0,0,0,0,,0,0,0,0,0,0,0,0
Chrislain Matsima,FRA,DF,Clermont Foot,Ligue 1,21,2002,13.1,18,11,11,7,0,10,18,55.6,8,14,10,4,13,31,74,1
Chrislain Matsima,FRA,DF,Monaco,Ligue 1,21,2002,3.3,9,7,5,3,1,2,7,28.6,5,4,1,3,4,13,4,0
Jean Mattéo Bahoya,FRA,"MF,FW",Eint Frankfurt,Bundesliga,18,2005,2.0,3,1,0,3,0,1,4,25.0,3,2,0,2,1,4,1,0
Remi Matthews,ENG,GK,Crystal Palace,Premier League,29,1994,0.0,0,0,0,0,0,0,0,,0,0,0,0,0,0,1,0
Alan Matturro,URU,DF,Genoa,Serie A,18,2004,1.2,1,1,1,0,0,1,1,100.0,0,6,3,3,2,3,4,0
Azor Matusiwa,NED,MF,Reims,Ligue 1,25,1998,15.4,39,27,17,19,3,22,32,68.8,10,21,3,18,33,72,32,1
Azor Matusiwa,NED,MF,Rennes,Ligue 1,25,1998,8.8,7,3,3,4,0,4,7,57.1,3,9,2,7,11,18,17,0
Neal Maupay,FRA,FW,Brentford,Premier League,26,1996,14.7,10,7,4,5,1,3,13,23.1,10,11,0,11,2,12,3,0
Neal Maupay,FRA,FW,Everton,Premier League,26,1996,1.2,0,0,0,0,0,0,1,0.0,1,2,0,2,0,0,1,0
Aïman Maurer,MAR,"MF,FW",Clermont Foot,Ligue 1,18,2004,0.6,1,1,1,0,0,1,3,33.3,2,0,0,0,0,1,0,0
Konstantinos Mavropanos,GRE,DF,West Ham,Premier League,25,1997,16.7,28,16,17,9,2,17,21,81.0,4,21,13,8,23,51,79,3
Christian Mawissa,FRA,DF,Toulouse,Ligue 1,18,2005,12.4,22,15,14,4,4,9,23,39.1,14,22,11,11,22,44,41,1
Philipp Max,GER,DF,Eint Frankfurt,Bundesliga,29,1993,15.0,26,17,6,18,2,19,26,73.1,7,18,1,17,7,33,18,2
Eric Maxim Choupo-Moting,CMR,"MF,FW",Bayern Munich,Bundesliga,34,1989,8.0,17,12,8,5,4,6,14,42.9,8,5,0,5,7,24,7,0
Luís Maximiano,POR,GK,Almería,La Liga,24,1999,33.0,0,0,0,0,0,0,1,0.0,1,0,0,0,0,0,19,2
Noam Mayoka-Tika,BEL,MF,Marseille,Ligue 1,19,2003,0.0,0,0,0,0,0,0,0,,0,0,0,0,0,0,0,0
Borja Mayoral,ESP,FW,Getafe,La Liga,26,1997,23.9,9,5,2,2,5,5,22,22.7,17,7,0,7,4,13,16,0
Senny Mayulu,FRA,"FW,MF",Paris S-G,Ligue 1,17,2006,3.6,13,8,6,6,1,6,7,85.7,1,1,0,1,3,16,0,0
Youssef Maziz,FRA,"FW,MF",Metz,Ligue 1,25,1998,1.4,0,0,0,0,0,0,2,0.0,2,1,0,1,1,1,2,0
Noussair Mazraoui,MAR,DF,Bayern Munich,Bundesliga,25,1997,13.3,32,21,14,11,7,13,21,61.9,8,14,1,13,20,52,27,1
Luca Mazzitelli,ITA,MF,Frosinone,Serie A,27,1995,24.6,45,23,15,24,6,26,49,53.1,23,23,7,16,19,64,62,0
Pasquale Mazzocchi,ITA,DF,Salernitana,Serie A,28,1995,14.1,25,19,14,10,1,16,29,55.2,13,14,6,8,5,30,31,0
Pasquale Mazzocchi,ITA,DF,Napoli,Serie A,28,1995,4.8,5,2,1,2,2,2,3,66.7,1,5,1,4,1,6,13,0
Kevin Mbabu,SUI,DF,Augsburg,Bundesliga,28,1995,22.7,51,39,25,18,8,23,40,57.5,17,29,9,20,24,75,48,0
Noah Mbamba,BEL,MF,Leverkusen,Bundesliga,18,2005,0.2,0,0,0,0,0,0,0,,0,0,0,0,1,1,0,0
Ethan Mbappé,FRA,"MF,DF",Paris S-G,Ligue 1,16,2006,0.5,0,0,0,0,0,0,2,0.0,2,1,0,1,0,0,0,0
Kylian Mbappé,FRA,FW,Paris S-G,Ligue 1,24,1998,24.0,4,1,1,1,2,4,9,44.4,5,4,0,4,2,6,2,0
Malick Mbaye,SEN,"MF,FW",Metz,Ligue 1,19,2004,1.7,5,1,0,1,4,1,2,50.0,1,1,0,1,1,6,2,0
Mamadou Mbaye,SEN,DF,Cádiz,La Liga,25,1998,3.2,6,3,3,3,0,2,5,40.0,3,10,7,3,5,11,26,0
Chancel Mbemba,COD,DF,Marseille,Ligue 1,28,1994,24.5,33,21,25,7,1,17,30,56.7,13,21,13,8,13,46,95,1
Nolan Mbemba,CGO,MF,Le Havre,Ligue 1,28,1995,0.2,2,1,0,1,1,1,2,50.0,1,0,0,0,0,2,0,0
Bryan Mbeumo,CMR,FW,Brentford,Premier League,23,1999,21.8,15,10,6,6,3,5,19,26.3,14,26,2,24,7,22,13,0
Christ Mbondi,FRA,FW,Reims,Ligue 1,18,2004,0.0,1,1,1,0,0,1,1,100.0,0,0,0,0,0,1,0,0
Jordi Mboula,ESP,"FW,MF",Hellas Verona,Serie A,24,1999,3.4,4,4,1,2,1,4,7,57.1,3,4,1,3,1,5,0,0
Nathanael Mbuku,COD,FW,Augsburg,Bundesliga,21,2002,0.1,0,0,0,0,0,0,0,,0,1,0,1,0,0,0,0
James Mcatee,ENG,"MF,FW",Sheffield Utd,Premier League,20,2002,20.2,32,21,9,13,10,13,33,39.4,20,20,0,20,11,43,18,0
James Mcatee,ENG,MF,Manchester City,Premier League,20,2002,0.0,0,0,0,0,0,0,0,,0,1,0,1,0,0,0,0
Oliver McBurnie,SCO,FW,Sheffield Utd,Premier League,27,1996,14.2,17,7,4,7,6,5,12,41.7,7,18,2,16,5,22,28,0
James McConnell,ENG,MF,Liverpool,Premier League,18,2004,0.0,0,0,0,0,0,0,0,,0,1,0,1,1,1,0,0
John McGinn,SCO,"MF,FW",Aston Villa,Premier League,28,1994,33.3,59,35,18,34,7,32,77,41.6,45,33,4,29,21,80,21,0
Scott McKenna,SCO,DF,Nott'ham Forest,Premier League,26,1996,4.6,4,0,3,1,0,2,3,66.7,1,6,4,2,5,9,27,0
Weston McKennie,USA,"MF,DF",Juventus,Serie A,24,1998,28.8,48,29,31,11,6,17,27,63.0,10,28,7,21,18,66,69,0
Dwight McNeil,ENG,"MF,FW",Everton,Premier League,23,1999,32.1,44,27,16,14,14,24,55,43.6,31,44,7,37,22,66,37,0
Scott McTominay,SCO,"MF,FW",Manchester Utd,Premier League,26,1996,21.1,49,25,23,24,2,22,33,66.7,11,34,12,22,14,63,54,0
Facundo Medina,ARG,DF,Lens,Ligue 1,24,1999,30.2,64,38,25,31,8,44,69,63.8,25,38,13,25,24,88,59,2
Ben Mee,ENG,DF,Brentford,Premier League,33,1989,14.1,26,15,12,12,2,17,22,77.3,5,21,13,8,13,39,63,1
Marvin Mehlem,GER,MF,Darmstadt 98,Bundesliga,25,1997,16.5,28,21,10,14,4,11,27,40.7,16,21,2,19,33,61,15,0
Bamo Meïté,CIV,DF,Marseille,Ligue 1,21,2001,7.1,16,10,13,3,0,8,12,66.7,4,11,5,6,11,27,35,0
Bamo Meïté,CIV,DF,Lorient,Ligue 1,21,2001,1.6,2,1,2,0,0,0,1,0.0,1,3,2,1,3,5,9,0
Hannibal Mejbri,TUN,"MF,FW",Manchester Utd,Premier League,20,2003,1.5,3,3,1,2,0,1,3,33.3,2,1,1,0,0,3,0,0
Hannibal Mejbri,TUN,MF,Sevilla,La Liga,20,2003,1.2,3,3,1,2,0,0,1,0.0,1,1,0,1,0,3,0,0
Óscar Melendo,ESP,"MF,FW",Granada,La Liga,25,1997,12.5,14,6,4,10,0,4,12,33.3,8,13,0,13,5,19,4,1
Gonzalo Melero,ESP,"MF,FW",Almería,La Liga,29,1994,12.3,14,8,7,5,2,7,19,36.8,12,12,4,8,4,18,11,0
Birger Meling,NOR,DF,Rennes,Ligue 1,28,1994,0.2,1,1,1,0,0,1,1,100.0,0,1,0,1,0,1,0,0
Arthur Melo,BRA,MF,Fiorentina,Serie A,26,1996,22.1,45,30,17,24,4,26,42,61.9,16,27,3,24,18,63,8,0
Memphis,NED,FW,Atlético Madrid,La Liga,29,1994,9.9,5,2,0,3,2,3,6,50.0,3,2,0,2,1,6,0,0
Houboulang Mendes,GNB,DF,Almería,La Liga,25,1998,4.4,16,13,11,5,0,8,16,50.0,8,4,2,2,1,17,17,1
Nuno Mendes,POR,DF,Paris S-G,Ligue 1,21,2002,3.0,5,5,4,1,0,4,7,57.1,3,4,0,4,4,9,2,0
Tomás Mendes,ESP,MF,Alavés,La Liga,18,2004,0.1,0,0,0,0,0,0,0,,0,0,0,0,0,0,0,0
Brais Méndez,ESP,"MF,FW",Real Sociedad,La Liga,26,1997,26.8,42,28,13,20,9,15,43,34.9,28,23,4,19,12,54,21,0
Bruno Méndez,URU,DF,Granada,La Liga,23,1999,14.8,36,17,19,12,5,21,37,56.8,16,24,6,18,26,62,45,0
Diego Méndez,ESP,MF,Rayo Vallecano,La Liga,19,2003,0.1,1,1,1,0,0,1,1,100.0,0,0,0,0,1,2,0,0
Leonardo Mendicino,ITA,MF,Atalanta,Serie A,17,2006,0.0,0,0,0,0,0,0,0,,0,0,0,0,0,0,0,0
Antoine Mendy,FRA,DF,Nice,Ligue 1,19,2004,4.6,7,5,4,3,0,3,7,42.9,4,4,1,3,8,15,16,0
Benjamin Mendy,FRA,DF,Lorient,Ligue 1,29,1994,7.9,3,1,2,1,0,1,5,20.0,4,8,2,6,7,10,20,0
Ferland Mendy,FRA,DF,Real Madrid,La Liga,28,1995,19.1,15,10,12,2,1,11,14,78.6,3,12,2,10,13,28,26,1
Formose Mendy,SEN,DF,Lorient,Ligue 1,22,2001,14.0,33,19,24,8,1,20,33,60.6,13,23,12,11,20,53,59,1
Nampalys Mendy,SEN,MF,Lens,Ligue 1,31,1992,11.7,29,18,10,13,6,16,20,80.0,4,11,4,7,14,43,14,1
Teden Mengi,ENG,DF,Luton Town,Premier League,21,2002,27.4,54,22,33,20,1,19,30,63.3,11,39,27,12,57,111,140,1
Chris Mepham,WAL,DF,Bournemouth,Premier League,25,1997,6.9,12,11,9,3,0,9,14,64.3,5,13,6,7,7,19,30,1
Jorge Meré,ESP,DF,Cádiz,La Liga,26,1997,7.5,8,7,6,2,0,4,7,57.1,3,5,3,2,8,16,33,0
Alex Meret,ITA,GK,Napoli,Serie A,26,1997,30.8,1,0,1,0,0,1,2,50.0,1,0,0,0,0,1,10,1
Mikel Merino,ESP,MF,Real Sociedad,La Liga,27,1996,27.6,77,43,25,34,18,22,48,45.8,26,36,11,25,16,93,55,3
Quentin Merlin,FRA,DF,Marseille,Ligue 1,21,2002,7.8,13,12,7,5,1,8,20,40.0,12,4,0,4,6,19,14,0
Quentin Merlin,FRA,DF,Nantes,Ligue 1,21,2002,14.3,29,20,15,12,2,16,25,64.0,9,22,1,21,18,47,22,0
Junior Messias,BRA,"MF,DF",Genoa,Serie A,32,1991,11.7,26,20,19,5,2,8,19,42.1,11,9,1,8,5,31,22,0
Thomas Meunier,BEL,DF,Dortmund,Bundesliga,31,1991,6.5,5,1,3,2,0,3,13,23.1,10,8,2,6,4,9,22,0
Bastien Meupiyou,FRA,DF,Nantes,Ligue 1,17,2006,0.1,0,0,0,0,0,0,0,,0,0,0,0,0,0,1,0
Alexander Meyer,GER,GK,Dortmund,Bundesliga,32,1991,7.7,1,1,1,0,0,1,1,100.0,0,0,0,0,0,1,2,1
Omenuke Mfulu,COD,"MF,FW",Las Palmas,La Liga,29,1994,0.9,4,3,3,1,0,0,1,0.0,1,1,1,0,2,6,5,0
Lucas Michal,FRA,FW,Monaco,Ligue 1,18,2005,0.1,0,0,0,0,0,0,0,,0,0,0,0,0,0,0,0
Sven Michel,GER,"FW,MF",Augsburg,Bundesliga,33,1990,6.5,7,5,2,1,4,2,7,28.6,5,1,0,1,0,7,4,0
Miguel,ESP,"FW,MF",Alavés,La Liga,23,1999,0.7,0,0,0,0,0,0,0,,0,2,0,2,0,0,0,0
Georges Mikautadze,GEO,FW,Metz,Ligue 1,22,2000,19.4,4,3,1,2,1,0,9,0.0,9,11,0,11,8,12,3,0
Nikola Milenković,SRB,DF,Fiorentina,Serie A,25,1997,27.9,41,21,24,14,3,22,36,61.1,14,22,14,8,27,68,95,1
Lewis Miley,ENG,MF,Newcastle Utd,Premier League,17,2006,13.4,33,21,6,20,7,15,32,46.9,17,20,3,17,8,41,18,2
Arkadiusz Milik,POL,FW,Juventus,Serie A,29,1994,10.2,9,5,2,5,2,3,5,60.0,2,7,1,6,5,14,3,0
Vanja Milinković-Savić,SRB,GK,Torino,Serie A,26,1997,36.0,1,0,1,0,0,1,1,100.0,0,0,0,0,1,2,14,4
Éder Militão,BRA,DF,Real Madrid,La Liga,25,1998,5.5,7,3,4,3,0,6,9,66.7,3,4,3,1,4,11,19,1
Luis Milla,ESP,MF,Getafe,La Liga,28,1994,23.5,57,33,19,28,10,28,47,59.6,19,20,1,19,32,89,10,0
Enzo Millot,FRA,"MF,FW",Stuttgart,Bundesliga,21,2002,24.9,40,22,9,21,10,18,39,46.2,21,24,2,22,16,56,7,1
James Milner,ENG,"DF,MF",Brighton,Premier League,37,1986,8.6,20,14,9,10,1,9,14,64.3,5,9,0,9,8,28,16,0
Jovan Milošević,SRB,"FW,MF",Stuttgart,Bundesliga,18,2005,0.3,0,0,0,0,0,0,0,,0,0,0,0,0,0,0,0
Marko Milovanović,SRB,"FW,MF",Almería,La Liga,19,2003,3.4,4,4,1,3,0,2,4,50.0,2,2,0,2,0,4,5,0
Kim Min-jae,KOR,DF,Bayern Munich,Bundesliga,26,1996,21.9,37,24,21,11,5,12,24,50.0,12,29,19,10,45,82,70,2
Yerry Mina,COL,"DF,MF",Fiorentina,Serie A,28,1994,0.5,1,1,1,0,0,1,2,50.0,1,0,0,0,0,1,2,0
Yerry Mina,COL,DF,Cagliari,Serie A,28,1994,13.5,20,13,14,6,0,13,19,68.4,6,23,14,9,4,24,77,0
Takumi Minamino,JPN,MF,Monaco,Ligue 1,28,1995,23.5,34,17,10,13,11,16,54,29.6,38,29,1,28,11,45,8,0
Lucas Mincarelli,FRA,"DF,MF",Montpellier,Ligue 1,19,2004,10.9,29,16,19,6,4,17,34,50.0,17,17,4,13,8,37,27,0
Tyrone Mings,ENG,DF,Aston Villa,Premier League,30,1993,0.3,0,0,0,0,0,0,0,,0,0,0,0,1,1,1,0
Óscar Mingueza,ESP,"DF,MF",Celta Vigo,La Liga,24,1999,33.3,62,38,44,11,7,37,80,46.3,43,38,7,31,17,79,49,2
Ignasi Miquel,ESP,DF,Granada,La Liga,30,1992,33.2,47,30,39,6,2,23,40,57.5,17,32,16,16,45,92,132,4
Rafa Mir,ESP,"FW,MF",Sevilla,La Liga,26,1997,4.3,2,2,1,1,0,1,2,50.0,1,2,0,2,1,3,1,0
Ignacio Miramon,ARG,MF,Lille,Ligue 1,20,2003,0.4,1,0,0,1,0,0,1,0.0,1,1,0,1,0,1,0,0
Aleksei Miranchuk,RUS,"MF,FW",Atalanta,Serie A,27,1995,13.1,12,6,6,4,2,5,13,38.5,8,6,1,5,2,14,5,1
Juan Miranda,ESP,DF,Betis,La Liga,23,2000,20.6,38,24,21,13,4,17,31,54.8,14,31,6,25,19,57,62,0
Kevin Miranda,ITA,DF,Sassuolo,Serie A,20,2003,0.2,0,0,0,0,0,0,0,,0,0,0,0,0,0,1,0
Antonio Mirante,ITA,GK,Milan,Serie A,40,1983,2.0,0,0,0,0,0,0,0,,0,0,0,0,0,0,1,0
Fabio Miretti,ITA,MF,Juventus,Serie A,19,2003,12.3,18,14,6,8,4,10,26,38.5,16,10,1,9,7,25,6,0
Filippo Missori,ITA,DF,Sassuolo,Serie A,19,2004,3.0,6,3,2,4,0,4,11,36.4,7,3,2,1,4,10,8,0
Tyrick Mitchell,ENG,"DF,MF",Crystal Palace,Premier League,23,1999,35.6,105,60,75,21,9,43,60,71.7,17,63,10,53,26,131,104,0
Kaoru Mitoma,JPN,FW,Brighton,Premier League,26,1997,16.5,13,6,3,7,3,5,19,26.3,14,15,1,14,5,18,12,0
Aleksandar Mitrović,SRB,FW,Fulham,Premier League,28,1994,0.4,0,0,0,0,0,0,0,,0,0,0,0,0,0,0,0
Stefan Mitrović,SRB,"FW,MF",Hellas Verona,Serie A,20,2002,4.3,6,3,0,5,1,2,5,40.0,3,6,1,5,0,6,4,0
Stefan Mitrović,SRB,DF,Getafe,La Liga,33,1990,7.8,9,3,7,2,0,4,8,50.0,4,3,2,1,6,15,26,0
Maximilian Mittelstädt,GER,DF,Stuttgart,Bundesliga,26,1997,23.4,91,51,46,39,6,53,89,59.6,36,36,6,30,46,137,65,0
Henrikh Mkhitaryan,ARM,MF,Inter,Serie A,34,1989,30.9,62,34,18,35,9,24,49,49.0,25,23,4,19,29,91,43,0
Marko Mladenović,SRB,MF,Eint Frankfurt,Bundesliga,18,2005,0.1,0,0,0,0,0,0,0,,0,0,0,0,0,0,0,0
Jakub Moder,POL,"MF,DF",Brighton,Premier League,24,1999,6.9,19,10,9,5,5,9,18,50.0,9,8,2,6,2,21,12,0
Luka Modrić,CRO,MF,Real Madrid,La Liga,37,1985,18.8,22,15,10,6,6,9,25,36.0,16,13,4,9,21,43,9,0
Max Moerstedt,GER,"DF,FW",Hoffenheim,Bundesliga,,,0.1,0,0,0,0,0,0,1,0.0,1,0,0,0,0,0,0,0
Terem Moffi,NGA,FW,Nice,Ligue 1,24,1999,21.7,7,4,0,5,2,3,12,25.0,9,14,1,13,3,10,15,0
Mostafa Mohamed,EGY,FW,Nantes,Ligue 1,25,1997,22.2,21,14,7,11,3,6,28,21.4,22,21,5,16,12,33,29,0
Dion Moise Sahi,CIV,"MF,FW",Strasbourg,Ligue 1,21,2001,7.0,5,5,1,2,2,0,3,0.0,3,11,1,10,1,6,7,0
Johan Mojica,COL,DF,Osasuna,La Liga,30,1992,22.7,30,22,11,15,4,16,25,64.0,9,15,2,13,21,51,40,2
Alberto Moleiro,ESP,"FW,MF",Las Palmas,La Liga,19,2003,20.0,15,6,4,7,4,6,30,20.0,24,11,0,11,7,22,10,0
Nahuel Molina,ARG,DF,Atlético Madrid,La Liga,25,1998,20.6,38,22,16,18,4,26,54,48.1,28,19,3,16,9,47,36,1
Florent Mollet,FRA,"MF,FW",Nantes,Ligue 1,31,1991,23.1,18,11,8,6,4,10,31,32.3,21,18,5,13,13,31,17,0
Jon Moncayola,ESP,MF,Osasuna,La Liga,25,1998,20.0,27,18,14,10,3,17,42,40.5,25,31,5,26,15,42,21,0
Enzo Mongo,FRA,DF,Nantes,Ligue 1,18,2005,0.1,1,1,1,0,0,1,2,50.0,1,1,1,0,1,2,0,0
Ilario Monterisi,ITA,DF,Frosinone,Serie A,21,2001,16.3,23,13,14,7,2,12,26,46.2,14,22,18,4,8,31,63,0
César Montes,MEX,DF,Almería,La Liga,26,1997,19.9,22,13,13,9,0,9,18,50.0,9,21,9,12,11,33,94,0
Gonzalo Montiel,ARG,DF,Nott'ham Forest,Premier League,26,1997,8.9,22,19,12,8,2,16,29,55.2,13,8,3,5,9,31,31,1
Lorenzo Montipò,ITA,GK,Hellas Verona,Serie A,27,1996,37.0,1,1,1,0,0,1,3,33.3,2,0,0,0,0,1,25,2
Kieffer Moore,WAL,"FW,MF",Bournemouth,Premier League,30,1992,1.2,0,0,0,0,0,0,0,,0,0,0,0,0,0,0,0
Mikey Moore,ENG,MF,Tottenham,Premier League,15,2007,0.0,0,0,0,0,0,0,0,,0,0,0,0,0,0,1,0
Álvaro Morata,ESP,FW,Atlético Madrid,La Liga,30,1992,21.2,16,10,4,7,5,3,5,60.0,2,18,3,15,1,17,26,0
Diego Moreira,POR,"FW,MF",Lyon,Ligue 1,18,2004,3.0,0,0,0,0,0,0,3,0.0,3,3,0,3,2,2,5,0
Alberto Moreno,ESP,DF,Villarreal,La Liga,31,1992,16.5,31,21,19,10,2,10,30,33.3,20,12,2,10,24,55,33,0
Álex Moreno,ESP,DF,Aston Villa,Premier League,30,1993,11.5,18,12,18,0,0,12,19,63.2,7,11,2,9,13,31,37,0
Gerard Moreno,ESP,FW,Villarreal,La Liga,31,1992,24.6,25,12,10,7,8,11,25,44.0,14,24,7,17,9,34,24,0
Jorge Moreno,ESP,DF,Osasuna,La Liga,22,2001,0.2,0,0,0,0,0,0,0,,0,1,0,1,0,0,3,0
Mateu Morey,ESP,DF,Dortmund,Bundesliga,23,2000,1.2,2,2,1,1,0,2,4,50.0,2,3,1,2,1,3,3,0
Ilaix Moriba,GUI,"MF,FW",Getafe,La Liga,20,2003,6.7,20,11,3,11,6,4,9,44.4,5,3,1,2,4,24,10,0
Manu Morlanes,ESP,MF,Mallorca,La Liga,24,1999,17.9,50,29,23,26,1,23,53,43.4,30,13,1,12,20,70,21,0
Nikola Moro,CRO,MF,Bologna,Serie A,25,1998,9.3,21,16,8,12,1,8,15,53.3,7,14,1,13,7,28,10,0
Carlton Morris,ENG,"FW,MF",Luton Town,Premier League,27,1995,31.8,15,8,4,6,5,9,15,60.0,6,24,5,19,1,16,53,0
Cristhian Mosquera,ESP,DF,Valencia,La Liga,19,2004,34.2,57,34,36,18,3,25,39,64.1,14,42,23,19,36,93,137,2
Yerson Mosquera,COL,DF,Villarreal,La Liga,22,2001,13.7,27,13,18,7,2,12,15,80.0,3,12,2,10,17,44,65,0
Dany Mota,POR,"FW,MF",Monza,Serie A,25,1998,22.8,13,7,2,5,6,8,17,47.1,9,4,1,3,2,15,18,0
Lebo Mothiba,RSA,FW,Strasbourg,Ligue 1,27,1996,6.9,5,2,1,4,0,3,4,75.0,1,6,1,5,0,5,11,0
Youssoufa Moukoko,GER,FW,Dortmund,Bundesliga,18,2004,6.9,4,1,2,2,0,3,7,42.9,4,4,1,3,2,6,4,0
Steve Mounié,BEN,FW,Brest,Ligue 1,28,1994,19.7,8,7,0,3,5,3,11,27.3,8,13,3,10,2,10,18,0
Mason Mount,ENG,"MF,FW",Manchester Utd,Premier League,24,1999,5.7,22,14,6,10,6,6,16,37.5,10,6,1,5,6,28,3,0
Samuel Moutoussamy,COD,MF,Nantes,Ligue 1,26,1996,12.3,38,20,14,17,7,17,37,45.9,20,16,3,13,11,49,13,0
Loris Mouyokolo,FRA,DF,Lorient,Ligue 1,22,2001,1.0,4,1,4,0,0,1,1,100.0,0,1,0,1,0,4,3,0
Divin Mubama,ENG,FW,West Ham,Premier League,18,2004,0.9,0,0,0,0,0,0,0,,0,0,0,0,0,0,0,0
Mykhailo Mudryk,UKR,FW,Chelsea,Premier League,22,2001,17.5,21,12,9,7,5,10,32,31.3,22,14,1,13,9,30,9,0
François Mughe,CMR,"MF,DF",Marseille,Ligue 1,19,2004,2.0,0,0,0,0,0,0,3,0.0,3,2,0,2,1,1,1,0
Nordi Mukiele,FRA,DF,Paris S-G,Ligue 1,25,1997,8.8,12,8,6,5,1,8,15,53.3,7,17,4,13,14,26,28,0
Samuele Mulattieri,ITA,"FW,MF",Sassuolo,Serie A,22,2000,5.1,1,1,0,0,1,1,2,50.0,1,7,2,5,1,2,2,0
Andreas Müller,GER,MF,Darmstadt 98,Bundesliga,23,2000,3.9,14,9,8,5,1,4,9,44.4,5,5,2,3,4,18,5,0
Jannik Müller,GER,"DF,MF",Darmstadt 98,Bundesliga,29,1994,12.6,33,16,21,9,3,16,27,59.3,11,24,12,12,17,50,39,1
Kevin Müller,GER,GK,Heidenheim,Bundesliga,32,1991,34.0,3,0,3,0,0,3,5,60.0,2,0,0,0,0,3,6,1
Marcus Müller,GER,MF,Mainz 05,Bundesliga,20,2002,0.2,0,0,0,0,0,0,0,,0,0,0,0,0,0,0,0
Thomas Müller,GER,"MF,FW",Bayern Munich,Bundesliga,33,1989,18.4,26,16,5,10,11,13,35,37.1,22,22,0,22,3,29,6,0
Abdul Mumin,GHA,DF,Rayo Vallecano,La Liga,25,1998,18.8,19,10,13,4,2,8,10,80.0,2,27,19,8,22,41,82,1
Marshall Munetsi,ZIM,MF,Reims,Ligue 1,27,1996,24.1,61,39,18,34,9,33,61,54.1,28,21,7,14,14,75,33,0
Iker Muniain,ESP,"MF,FW",Athletic Club,La Liga,30,1992,6.6,5,1,2,3,0,1,3,33.3,2,4,1,3,0,5,0,0
Rodrigo Muniz,BRA,FW,Fulham,Premier League,22,2001,17.7,7,3,1,5,1,1,6,16.7,5,9,3,6,6,13,20,0
Aihen Muñoz,ESP,DF,Real Sociedad,La Liga,25,1997,12.5,36,21,20,10,6,24,35,68.6,11,16,8,8,9,45,33,0
Daniel Muñoz,COL,"DF,MF",Crystal Palace,Premier League,27,1996,16.0,55,35,31,14,10,19,38,50.0,19,29,7,22,24,79,47,0
Iker Muñoz,ESP,MF,Osasuna,La Liga,20,2002,20.6,32,18,13,17,2,15,31,48.4,16,16,5,11,11,43,50,0
Javier Muñoz,ESP,MF,Las Palmas,La Liga,28,1995,29.3,42,23,14,22,6,16,44,36.4,28,40,4,36,20,62,29,1
Finley Munroe,ENG,MF,Aston Villa,Premier League,18,2005,0.0,0,0,0,0,0,0,0,,0,0,0,0,0,0,0,0
Arijanet Muric,KVX,GK,Burnley,Premier League,24,1998,10.0,1,1,1,0,0,1,1,100.0,0,0,0,0,0,1,10,4
Luis Muriel,COL,"FW,MF",Atalanta,Serie A,32,1991,4.5,3,2,0,2,1,1,1,100.0,0,4,0,4,1,4,0,0
Murillo,BRA,DF,Nott'ham Forest,Premier League,21,2002,31.0,50,31,36,13,1,19,33,57.6,14,41,24,17,37,87,188,0
Vedat Muriqi,KVX,FW,Mallorca,La Liga,29,1994,25.9,11,6,4,3,4,2,14,14.3,12,11,4,7,6,17,26,0
Alex Murphy,IRL,"DF,FW",Newcastle Utd,Premier League,19,2004,0.1,1,1,0,1,0,1,2,50.0,1,1,0,1,1,2,0,0
Jacob Murphy,ENG,"FW,DF",Newcastle Utd,Premier League,28,1995,13.2,20,10,8,4,8,12,26,46.2,14,17,0,17,6,26,16,0
Yunus Musah,USA,"MF,FW",Milan,Serie A,20,2002,16.4,25,14,15,6,4,8,15,53.3,7,18,4,14,10,35,16,1
Jamal Musiala,GER,"MF,FW",Bayern Munich,Bundesliga,20,2003,19.5,40,25,9,21,10,14,36,38.9,22,25,1,24,16,56,5,0
Florent Muslija,KVX,"MF,FW",Freiburg,Bundesliga,25,1998,1.2,5,4,3,2,0,2,5,40.0,3,1,0,1,0,5,2,0
Juan Musso,ARG,GK,Atalanta,Serie A,29,1994,11.0,1,0,1,0,0,1,1,100.0,0,0,0,0,0,1,6,0
Kingstone Mutandwa,ZAM,"FW,MF",Cagliari,Serie A,20,2003,0.4,1,0,1,0,0,1,4,25.0,3,1,0,1,0,1,2,0
Yvon Mvogo,SUI,GK,Lorient,Ligue 1,29,1994,34.0,0,0,0,0,0,0,1,0.0,1,0,0,0,0,0,15,3
Joel Mvuka,NOR,"DF,FW",Lorient,Ligue 1,20,2002,2.2,5,3,3,1,1,3,7,42.9,4,1,0,1,2,7,1,0
Junior Mwanga,FRA,"MF,FW",Strasbourg,Ligue 1,20,2003,16.1,40,20,23,12,5,12,24,50.0,12,20,5,15,18,58,19,0
Phillipp Mwene,AUT,DF,Mainz 05,Bundesliga,29,1994,22.2,34,15,15,16,3,16,33,48.5,17,27,3,24,17,51,47,0
Vitaliy Mykolenko,UKR,DF,Everton,Premier League,24,1999,27.4,69,38,46,21,2,41,66,62.1,25,36,11,25,36,105,92,0
Joakim Mæhle,DEN,"DF,MF",Wolfsburg,Bundesliga,26,1997,27.2,62,39,33,18,11,41,64,64.1,23,43,5,38,29,91,65,0
Obite N'Dicka,CIV,DF,Roma,Serie A,23,1999,24.1,32,18,12,19,1,12,20,60.0,8,30,16,14,16,48,75,0
Kévin N'Doram,FRA,MF,Metz,Ligue 1,27,1996,17.8,31,22,20,9,2,17,38,44.7,21,17,8,9,27,58,38,0
Nathan N'Goumou,FRA,"FW,MF",Gladbach,Bundesliga,23,2000,15.4,37,22,17,18,2,16,34,47.1,18,22,0,22,5,42,17,1
Stanley N'Soki,FRA,DF,Hoffenheim,Bundesliga,24,1999,7.0,21,10,12,8,1,17,29,58.6,12,13,2,11,8,29,33,0
Nacho,ESP,DF,Real Madrid,La Liga,33,1990,19.4,18,10,9,7,2,6,13,46.2,7,23,13,10,18,36,56,0
Bilal Nadir,FRA,"MF,FW",Marseille,Ligue 1,19,2003,1.3,4,3,2,2,0,1,2,50.0,1,0,0,0,2,6,2,0
Mahamadou Nagida,CMR,DF,Rennes,Ligue 1,18,2005,1.2,1,1,0,0,1,0,2,0.0,2,2,1,1,4,5,0,0
Marvelous Nakamba,ZIM,MF,Luton Town,Premier League,29,1994,12.6,40,24,24,14,2,24,42,57.1,18,23,6,17,11,51,11,1
Keito Nakamura,JPN,"FW,MF",Reims,Ligue 1,23,2000,15.3,28,11,9,10,9,17,37,45.9,20,15,2,13,6,34,7,0
Nahitan Nández,URU,"MF,DF",Cagliari,Serie A,27,1995,26.0,59,40,27,23,9,27,64,42.2,37,25,2,23,19,78,32,0
Matija Nastasić,SRB,DF,Mallorca,La Liga,30,1993,25.1,35,17,26,9,0,24,32,75.0,8,33,20,13,29,64,114,0
Natan,BRA,DF,Napoli,Serie A,22,2001,10.6,14,10,10,3,1,5,10,50.0,5,12,9,3,8,22,32,0
Lapo Nava,ITA,GK,Milan,Serie A,19,2004,0.0,0,0,0,0,0,0,0,,0,0,0,0,0,0,0,0
Roberto Navarro,ESP,"MF,FW",Cádiz,La Liga,21,2002,21.0,46,29,20,21,5,22,43,51.2,21,33,0,33,19,65,7,1
Jesús Navas,ESP,DF,Sevilla,La Liga,37,1985,22.3,37,27,21,14,2,22,40,55.0,18,15,7,8,22,59,48,0
Keylor Navas,CRC,GK,Paris S-G,Ligue 1,36,1986,4.0,0,0,0,0,0,0,0,,0,0,0,0,0,0,2,0
Michel Ndary Adopo,FRA,MF,Atalanta,Serie A,23,2000,1.2,4,3,0,3,1,1,1,100.0,0,0,0,0,0,4,2,1
Youssouf Ndayishimiye,BDI,"MF,DF",Nice,Ligue 1,24,1998,19.0,31,20,17,12,2,12,23,52.2,11,19,11,8,12,43,47,1
Bassirou Ndiaye,SEN,FW,Lorient,Ligue 1,21,2002,1.7,5,2,2,2,1,3,5,60.0,2,1,1,0,1,6,0,0
Iliman Ndiaye,SEN,"FW,MF",Marseille,Ligue 1,23,2000,18.0,21,18,5,11,5,11,29,37.9,18,14,2,12,6,27,6,0
Massamba Ndiaye,SEN,GK,Clermont Foot,Ligue 1,21,2001,4.0,0,0,0,0,0,0,0,,0,0,0,0,0,0,2,0
Rassoul Ndiaye,SEN,"MF,FW",Le Havre,Ligue 1,21,2001,5.8,25,17,8,16,1,12,24,50.0,12,2,1,1,4,29,5,0
Michael Ndiweni,ENG,FW,Newcastle Utd,Premier League,19,2003,0.0,0,0,0,0,0,0,0,,0,0,0,0,0,0,0,0
Cher Ndour,ITA,MF,Paris S-G,Ligue 1,19,2004,0.3,2,2,0,2,0,1,2,50.0,1,0,0,0,0,2,0,0
Dan Ndoye,SUI,"FW,MF",Bologna,Serie A,22,2000,19.7,30,15,17,11,2,17,39,43.6,22,20,1,19,10,40,14,0
Joseph Nduquidi,FRA,"MF,DF",Metz,Ligue 1,18,2004,8.3,11,4,6,3,2,1,9,11.1,8,11,3,8,11,22,15,1
Loïc Nego,HUN,"DF,MF",Le Havre,Ligue 1,32,1991,17.3,37,26,21,12,4,18,30,60.0,12,12,2,10,16,53,17,0
Álvaro Negredo,ESP,"FW,MF",Cádiz,La Liga,37,1985,0.6,0,0,0,0,0,0,0,,0,1,0,1,1,1,0,0
Reiss Nelson,ENG,FW,Arsenal,Premier League,23,1999,3.0,9,6,5,1,3,8,10,80.0,2,5,1,4,1,10,5,0
Zack Nelson,ENG,"MF,DF",Luton Town,Premier League,18,2004,0.1,1,0,1,0,0,0,0,,0,0,0,0,0,1,0,0
Neto,BRA,GK,Bournemouth,Premier League,34,1989,32.0,0,0,0,0,0,0,0,,0,1,0,1,1,1,12,3
Pedro Neto,POR,"FW,MF",Wolves,Premier League,23,2000,16.8,7,3,3,2,2,5,15,33.3,10,5,1,4,5,12,2,0
Luca Netz,GER,DF,Gladbach,Bundesliga,20,2003,24.7,38,22,19,16,3,23,43,53.5,20,36,10,26,22,60,76,1
Manuel Neuer,GER,GK,Bayern Munich,Bundesliga,37,1986,22.8,1,1,1,0,0,0,0,,0,0,0,0,0,1,14,3
Florian Neuhaus,GER,MF,Gladbach,Bundesliga,26,1997,13.6,15,12,7,8,0,8,26,30.8,18,8,6,2,14,29,8,0
Carlos Neva,ESP,DF,Granada,La Liga,27,1996,35.0,32,21,22,9,1,17,40,42.5,23,39,14,25,30,62,108,2
Jessic Ngankam,GER,"FW,MF",Mainz 05,Bundesliga,23,2000,2.0,1,1,0,1,0,0,0,,0,3,1,2,3,4,0,0
Jessic Ngankam,GER,FW,Eint Frankfurt,Bundesliga,23,2000,3.1,3,2,1,1,1,0,0,,0,0,0,0,0,3,1,0
Cyril Ngonge,BEL,"FW,MF",Hellas Verona,Serie A,23,2000,15.9,14,9,5,3,6,5,14,35.7,9,7,1,6,4,18,10,0
Cyril Ngonge,BEL,FW,Napoli,Serie A,23,2000,3.5,5,3,1,4,0,2,2,100.0,0,2,0,2,0,5,2,0
Steve Ngoura,FRA,"FW,MF",Le Havre,Ligue 1,18,2005,2.5,2,1,1,1,0,1,4,25.0,3,0,0,0,0,2,3,0
Moussa Niakhate,SEN,DF,Nott'ham Forest,Premier League,27,1996,16.2,42,25,33,9,0,20,25,80.0,5,19,12,7,14,56,51,0
M'Baye Niang,SEN,FW,Empoli,Serie A,28,1994,7.9,3,1,0,1,2,0,6,0.0,6,7,1,6,3,6,10,0
Tanguy Nianzou,FRA,DF,Sevilla,La Liga,21,2002,3.5,12,8,9,2,1,8,11,72.7,3,2,0,2,3,15,9,1
Shamar Nicholson,JAM,FW,Clermont Foot,Ligue 1,26,1997,16.5,6,2,0,4,2,1,4,25.0,3,6,2,4,0,6,15,0
Rasmus Nicolaisen,DEN,DF,Toulouse,Ligue 1,26,1997,32.5,50,30,39,11,0,26,44,59.1,18,44,33,11,42,92,158,1
Moritz Nicolas,GER,GK,Gladbach,Bundesliga,25,1997,27.0,1,0,1,0,0,1,3,33.3,2,0,0,0,0,1,12,5
Hans Nicolussi Caviglia,ITA,MF,Juventus,Serie A,23,2000,3.0,5,2,1,3,1,4,6,66.7,2,5,1,4,0,5,2,0
Saúl Ñíguez,ESP,MF,Atlético Madrid,La Liga,28,1994,15.3,64,39,29,29,6,30,49,61.2,19,36,9,27,14,78,56,0
Justin Njinmah,GER,FW,Werder Bremen,Bundesliga,22,2000,11.3,5,1,2,2,1,3,9,33.3,6,9,1,8,2,7,6,0
Eddie Nketiah,ENG,FW,Arsenal,Premier League,24,1999,12.0,12,7,2,6,4,2,7,28.6,5,11,0,11,4,16,4,0
Niels Nkounkou,FRA,"DF,MF",Eint Frankfurt,Bundesliga,22,2000,14.5,54,30,34,17,3,29,64,45.3,35,30,2,28,16,70,30,0
Christopher Nkunku,FRA,"FW,MF",Chelsea,Premier League,25,1997,4.9,5,4,0,4,1,1,2,50.0,1,4,1,3,2,7,4,0
Felix Nmecha,GER,MF,Dortmund,Bundesliga,22,2000,11.3,19,13,7,8,4,11,22,50.0,11,18,5,13,11,30,19,0
Lukas Nmecha,GER,FW,Wolfsburg,Bundesliga,24,1998,0.5,1,1,0,0,1,0,0,,0,1,0,1,0,1,0,0
Peru Nolaskoain,ESP,"DF,MF",Athletic Club,La Liga,24,1998,0.1,1,1,1,0,0,1,1,100.0,0,0,0,0,0,1,1,0
Joseph Nonge,BEL,MF,Juventus,Serie A,18,2005,0.3,0,0,0,0,0,0,0,,0,0,0,0,0,0,1,0
Jonathan Norbye,NOR,MF,RB Leipzig,Bundesliga,16,2007,0.0,0,0,0,0,0,0,0,,0,0,0,0,0,0,0,0
Arnaud Nordin,FRA,"FW,MF",Montpellier,Ligue 1,25,1998,13.8,12,6,3,5,4,6,16,37.5,10,11,0,11,2,14,10,0
Rhys Norrington-Davies,WAL,DF,Sheffield Utd,Premier League,24,1999,1.2,1,1,1,0,0,0,1,0.0,1,2,0,2,1,2,2,0
Oliver Norwood,NIR,MF,Sheffield Utd,Premier League,32,1991,16.0,41,26,18,18,5,20,47,42.6,27,24,9,15,21,62,39,0
Tijjani Noslin,NED,"FW,MF",Hellas Verona,Serie A,24,1999,14.9,18,8,5,7,6,6,16,37.5,10,17,2,15,2,20,14,0
Randy Nteka,ANG,"FW,MF",Rayo Vallecano,La Liga,25,1997,6.4,11,4,1,6,4,4,10,40.0,6,6,1,5,2,13,11,1
Ernest Nuamah,GHA,"FW,MF",Lyon,Ligue 1,19,2003,20.4,28,14,18,6,4,12,38,31.6,26,15,1,14,8,36,9,0
Alexander Nübel,GER,GK,Stuttgart,Bundesliga,26,1996,30.0,2,2,2,0,0,2,4,50.0,2,0,0,0,0,2,13,4
Kasim Nuhu,GHA,DF,Hoffenheim,Bundesliga,28,1995,0.1,0,0,0,0,0,0,0,,0,0,0,0,0,0,0,0
Matheus Nunes,POR,MF,Wolves,Premier League,24,1998,2.0,3,1,3,0,0,2,6,33.3,4,0,0,0,6,9,1,0
Matheus Nunes,POR,MF,Manchester City,Premier League,24,1998,7.3,10,4,1,7,2,5,16,31.3,11,7,1,6,1,11,8,1
Darwin Núñez,URU,FW,Liverpool,Premier League,24,1999,22.7,22,12,2,10,10,11,23,47.8,12,18,6,12,3,25,9,0
Unai Núñez,ESP,DF,Celta Vigo,La Liga,26,1997,31.1,51,28,30,19,2,23,49,46.9,26,38,24,14,52,103,153,3
Fabian Nürnberger,BUL,"DF,MF",Darmstadt 98,Bundesliga,24,1999,16.8,29,22,22,6,1,22,41,53.7,19,11,1,10,17,46,26,0
Ethan Nwaneri,ENG,FW,Arsenal,Premier League,16,2007,0.2,0,0,0,0,0,0,0,,0,1,0,1,0,0,0,0
Simeon Nwankwo,NGA,FW,Salernitana,Serie A,31,1992,7.6,6,3,0,2,4,1,3,33.3,2,7,0,7,0,6,4,0
Gerzino Nyamsi,FRA,DF,Strasbourg,Ligue 1,26,1997,12.1,18,14,13,5,0,12,18,66.7,6,19,11,8,10,28,43,0
Ørjan Nyland,NOR,GK,Sevilla,La Liga,32,1990,24.0,0,0,0,0,0,0,1,0.0,1,0,0,0,0,0,9,1
Rabby Nzingoula,CGO,"MF,FW",Strasbourg,Ligue 1,17,2005,1.5,3,3,0,3,0,3,4,75.0,1,4,0,4,5,8,0,0
M'Bala Nzola,ANG,FW,Fiorentina,Serie A,26,1996,17.2,11,8,1,4,6,6,7,85.7,1,10,1,9,0,11,22,0
Christian Nørgaard,DEN,MF,Brentford,Premier League,29,1994,27.8,81,50,42,31,8,32,87,36.8,55,48,6,42,54,135,50,0
Jake O'Brien,IRL,DF,Lyon,Ligue 1,22,2001,26.3,22,16,16,5,1,14,20,70.0,6,23,18,5,12,34,98,1
Mark O'Mahony,IRL,FW,Brighton,Premier League,18,2005,0.7,1,0,1,0,0,1,2,50.0,1,2,1,1,0,1,1,0
Dara O'Shea,IRL,DF,Burnley,Premier League,24,1999,32.1,39,20,22,14,3,11,26,42.3,15,41,30,11,35,74,158,2
Michael Obafemi,IRL,"FW,MF",Burnley,Premier League,23,2000,0.2,0,0,0,0,0,0,0,,0,1,0,1,0,0,0,0
Adam Obert,SVK,DF,Cagliari,Serie A,20,2002,10.5,17,9,8,8,1,8,17,47.1,9,13,7,6,21,38,41,1
Pedro Obiang,EQG,MF,Sassuolo,Serie A,31,1992,5.0,8,4,3,4,1,2,10,20.0,8,6,4,2,8,16,10,0
Jan Oblak,SVN,GK,Atlético Madrid,La Liga,30,1993,38.0,0,0,0,0,0,0,0,,0,0,0,0,0,0,10,0
Brian Ocampo,URU,"MF,FW",Cádiz,La Liga,24,1999,2.8,4,3,1,3,0,2,5,40.0,3,4,0,4,3,7,0,0
Lucas Ocampos,ARG,"FW,MF",Sevilla,La Liga,29,1994,31.9,66,47,22,27,17,29,58,50.0,29,34,1,33,21,87,29,0
Guillermo Ochoa,MEX,GK,Salernitana,Serie A,38,1985,21.0,0,0,0,0,0,0,1,0.0,1,0,0,0,0,0,9,1
Jens Odgaard,DEN,"FW,MF",Bologna,Serie A,24,1999,4.8,4,4,1,1,2,1,3,33.3,2,9,0,9,1,5,3,0
Wilson Odobert,FRA,"MF,FW",Burnley,Premier League,18,2004,23.3,17,13,8,5,4,6,22,27.3,16,26,2,24,6,23,14,0
Álvaro Odriozola,ESP,DF,Real Sociedad,La Liga,27,1995,4.4,9,7,7,1,1,5,5,100.0,0,2,1,1,8,17,7,0
Tim Oermann,GER,DF,Bochum,Bundesliga,19,2003,7.9,19,11,11,4,4,9,14,64.3,5,15,6,9,2,21,22,0
Odeluga Offiah,ENG,DF,Brighton,Premier League,20,2002,1.4,1,0,1,0,0,1,1,100.0,0,0,0,0,1,2,0,0
Chiedozie Ogbene,IRL,"MF,DF",Luton Town,Premier League,26,1997,22.2,17,10,10,7,0,12,22,54.5,10,14,3,11,7,24,34,2
Angelo Ogbonna,ITA,DF,West Ham,Premier League,35,1988,7.1,11,5,9,2,0,6,7,85.7,1,13,10,3,3,14,29,0
Florent Ogier,FRA,DF,Clermont Foot,Ligue 1,34,1989,10.5,19,9,13,6,0,11,18,61.1,7,25,19,6,9,28,35,3
Noah Okafor,SUI,"FW,MF",Milan,Serie A,23,2000,9.9,6,4,1,4,1,3,10,30.0,7,8,1,7,0,6,10,0
David Okereke,NGA,"FW,MF",Torino,Serie A,25,1997,2.8,3,1,1,1,1,0,3,0.0,3,2,0,2,1,4,0,0
Caleb Okoli,ITA,DF,Frosinone,Serie A,22,2001,32.4,56,34,33,22,1,29,44,65.9,15,48,32,16,29,85,156,4
Maduka Okoye,NGA,GK,Udinese,Serie A,23,1999,21.0,0,0,0,0,0,0,0,,0,0,0,0,1,1,4,2
Masaya Okugawa,JPN,"FW,DF",Augsburg,Bundesliga,27,1996,0.4,0,0,0,0,0,0,0,,0,0,0,0,0,0,2,0
Joseph Okumu,KEN,DF,Reims,Ligue 1,26,1997,19.4,44,28,28,14,2,24,38,63.2,14,27,19,8,35,79,112,2
Aingeru Olabarrieta,ESP,FW,Athletic Club,La Liga,17,2005,0.1,0,0,0,0,0,0,0,,0,0,0,0,0,0,0,0
Michael Olakigbe,ENG,"DF,FW",Brentford,Premier League,19,2004,0.7,3,0,2,1,0,2,4,50.0,2,7,0,7,1,4,0,1
Olasagasti,ESP,MF,Real Sociedad,La Liga,22,2000,4.0,16,13,4,7,5,5,8,62.5,3,2,0,2,3,19,5,1
Finn Ole Becker,GER,MF,Hoffenheim,Bundesliga,23,2000,6.7,10,9,8,2,0,4,17,23.5,13,9,1,8,1,11,10,0
Mathias Olesen,LUX,"MF,FW",Köln,Bundesliga,22,2001,1.2,0,0,0,0,0,0,0,,0,0,0,0,2,2,2,0
Michael Olise,FRA,"FW,MF",Crystal Palace,Premier League,21,2001,14.2,19,10,7,10,2,8,24,33.3,16,21,0,21,11,30,9,0
Mathías Olivera,URU,DF,Napoli,Serie A,25,1997,17.4,50,29,29,15,6,23,39,59.0,16,35,6,29,20,70,25,0
Dani Olmo,ESP,MF,RB Leipzig,Bundesliga,25,1998,16.1,26,18,14,8,4,10,22,45.5,12,7,0,7,13,39,12,1
Robin Olsen,SWE,GK,Aston Villa,Premier League,33,1990,4.5,0,0,0,0,0,0,0,,0,0,0,0,0,0,1,0
Warmed Omari,COM,DF,Rennes,Ligue 1,23,2000,23.0,32,19,23,7,2,16,28,57.1,12,30,20,10,33,65,77,2
Becir Omeragic,SUI,"DF,MF",Montpellier,Ligue 1,21,2002,25.7,48,29,31,13,4,20,33,60.6,13,51,29,22,27,75,65,0
Jonas Omlin,SUI,GK,Gladbach,Bundesliga,29,1994,7.0,1,0,1,0,0,1,1,100.0,0,0,0,0,0,1,3,0
Andrew Omobamidele,IRL,DF,Nott'ham Forest,Premier League,21,2002,8.7,10,3,9,1,0,5,8,62.5,3,12,8,4,13,23,42,1
Samu Omorodion,ESP,FW,Alavés,La Liga,19,2004,21.3,6,3,1,4,1,0,4,0.0,4,11,2,9,1,7,14,0
Samu Omorodion,ESP,FW,Granada,La Liga,19,2004,0.9,1,1,0,1,0,1,1,100.0,0,0,0,0,0,1,0,0
Amadou Onana,BEL,MF,Everton,Premier League,21,2001,23.2,71,38,32,31,8,21,42,50.0,21,25,6,19,21,92,31,0
André Onana,CMR,GK,Manchester Utd,Premier League,27,1996,38.0,2,0,2,0,0,2,2,100.0,0,0,0,0,0,2,11,2
Jean Onana,CMR,MF,Marseille,Ligue 1,23,2000,6.3,23,14,6,14,3,13,25,52.0,12,10,2,8,11,34,11,1
Ryan One,SCO,FW,Sheffield Utd,Premier League,17,2006,0.1,0,0,0,0,0,0,0,,0,0,0,0,0,0,0,0
Karim Onisiwo,AUT,"FW,MF",Mainz 05,Bundesliga,31,1992,16.6,17,8,4,6,7,6,11,54.5,5,18,4,14,2,19,7,0
Tyler Onyango,ENG,MF,Everton,Premier League,20,2003,0.0,0,0,0,0,0,0,0,,0,0,0,0,0,0,0,0
Fred Onyedinma,ENG,"DF,MF",Luton Town,Premier League,26,1996,4.5,10,6,7,3,0,5,12,41.7,7,3,0,3,1,11,13,0
Frank Onyeka,NGA,MF,Brentford,Premier League,25,1998,12.9,37,24,9,23,5,16,29,55.2,13,15,7,8,23,60,17,0
Loïs Openda,BEL,FW,RB Leipzig,Bundesliga,23,2000,30.0,3,3,0,1,2,0,6,0.0,6,19,3,16,5,8,14,0
Royce Openda Owaga,GAB,FW,Lorient,Ligue 1,21,2002,0.2,0,0,0,0,0,0,0,,0,0,0,0,0,0,0,0
Christopher Operi,CIV,DF,Le Havre,Ligue 1,26,1997,27.2,55,36,37,15,3,32,59,54.2,27,45,7,38,35,90,68,1
Leon Opitz,GER,"FW,DF",Werder Bremen,Bundesliga,18,2005,0.2,2,2,1,1,0,2,3,66.7,1,0,0,0,0,2,0,0
Gift Orban,NGA,FW,Lyon,Ligue 1,21,2002,5.3,4,3,0,1,3,1,4,25.0,3,2,0,2,1,5,2,1
Willi Orban,HUN,DF,RB Leipzig,Bundesliga,30,1992,17.6,20,12,8,10,2,9,18,50.0,9,22,13,9,16,36,76,1
Ivan Ordets,UKR,DF,Bochum,Bundesliga,31,1992,20.9,19,14,11,6,2,10,17,58.8,7,41,29,12,31,50,130,0
Divock Origi,BEL,FW,Nott'ham Forest,Premier League,28,1995,6.7,6,4,5,0,1,0,0,,0,6,0,6,2,8,4,0
Gaetano Oristanio,ITA,"FW,MF",Cagliari,Serie A,20,2002,12.3,20,10,5,14,1,5,17,29.4,12,11,0,11,9,29,8,0
Aimar Oroz,ESP,MF,Osasuna,La Liga,21,2001,26.0,43,26,18,20,5,13,37,35.1,24,27,2,25,16,59,11,0
Riccardo Orsolini,ITA,"FW,MF",Bologna,Serie A,26,1997,19.9,23,14,13,4,6,9,30,30.0,21,25,3,22,8,31,19,1
Stefan Ortega,GER,GK,Manchester City,Premier League,30,1992,7.1,0,0,0,0,0,0,0,,0,0,0,0,0,0,2,1
Eneko Ortiz,ESP,DF,Alavés,La Liga,20,2003,0.2,0,0,0,0,0,0,0,,0,0,0,0,0,0,0,0
Asier Osambela,ESP,MF,Osasuna,La Liga,19,2004,0.1,2,1,0,1,1,0,0,,0,0,0,0,0,2,0,0
Ben Osborn,ENG,"DF,MF",Sheffield Utd,Premier League,28,1994,15.2,22,9,11,9,2,8,17,47.1,9,18,2,16,8,30,30,0
Gabriel Osho,NGA,DF,Luton Town,Premier League,24,1998,20.5,41,22,21,19,1,16,27,59.3,11,37,20,17,31,72,92,0
Victor Osimhen,NGA,FW,Napoli,Serie A,24,1998,22.0,9,5,0,4,5,2,4,50.0,2,5,1,4,2,11,18,0
Milutin Osmajić,MNE,MF,Cádiz,La Liga,24,1999,0.1,0,0,0,0,0,0,0,,0,0,0,0,0,0,0,0
Patrick Osterhage,GER,MF,Bochum,Bundesliga,23,2000,20.7,38,26,14,23,1,17,36,47.2,19,36,9,27,27,65,32,1
William Osula,DEN,FW,Sheffield Utd,Premier League,19,2003,8.7,2,2,1,0,1,1,2,50.0,1,3,1,2,2,4,9,0
Dango Ouattara,BFA,"FW,DF",Bournemouth,Premier League,21,2002,13.7,45,27,22,11,12,19,34,55.9,15,18,3,15,22,67,35,0
Kassoum Ouattara,FRA,"DF,FW",Monaco,Ligue 1,18,2004,7.1,17,12,8,5,4,9,20,45.0,11,11,0,11,13,30,20,0
Remi Oudin,FRA,"MF,FW",Lecce,Serie A,26,1996,20.2,26,14,12,12,2,12,19,63.2,7,13,1,12,20,46,22,0
Alexandre Oukidja,ALG,GK,Metz,Ligue 1,35,1988,33.2,2,1,2,0,0,1,2,50.0,1,1,0,1,3,5,24,3
Azzedine Ounahi,MAR,MF,Marseille,Ligue 1,23,2000,13.4,25,11,9,14,2,11,32,34.4,21,6,1,5,11,36,8,0
Adam Ounas,ALG,FW,Lille,Ligue 1,26,1996,4.6,4,3,2,2,0,2,7,28.6,5,2,0,2,6,10,1,0
Patrick Ouotro,CIV,FW,Strasbourg,Ligue 1,17,2005,0.1,0,0,0,0,0,0,0,,0,0,0,0,0,0,0,0
Aiham Ousou,SYR,DF,Cádiz,La Liga,23,2000,4.8,8,5,6,2,0,5,5,100.0,0,1,0,1,7,15,15,0
Jesús Owono,EQG,GK,Alavés,La Liga,22,2001,4.0,0,0,0,0,0,0,0,,0,0,0,0,0,0,3,0
Mikel Oyarzabal,ESP,"FW,MF",Real Sociedad,La Liga,26,1997,24.0,23,18,7,11,5,7,21,33.3,14,25,4,21,4,27,12,0
Anthony Oyono,GAB,DF,Frosinone,Serie A,22,2001,13.3,37,26,21,14,2,23,34,67.6,11,17,3,14,9,46,32,0
Salih Özcan,TUR,MF,Dortmund,Bundesliga,25,1998,13.2,20,12,11,8,1,10,18,55.6,8,28,3,25,17,37,18,1
Cenk Özkacar,TUR,DF,Valencia,La Liga,22,2000,17.8,26,15,22,4,0,15,23,65.2,8,18,7,11,18,44,84,1
David Ozoh,ENG,"MF,DF",Crystal Palace,Premier League,18,2005,1.7,10,6,3,6,1,5,6,83.3,1,2,0,2,0,10,2,0
Jon Pacheco,ESP,DF,Real Sociedad,La Liga,22,2001,17.0,25,15,21,4,0,14,22,63.6,8,17,6,11,10,35,53,1
Willian Pacho,ECU,DF,Eint Frankfurt,Bundesliga,21,2001,33.0,62,37,38,23,1,31,53,58.5,22,51,22,29,47,109,152,2
Gonçalo Paciência,POR,"FW,MF",Bochum,Bundesliga,28,1994,7.2,8,4,2,2,4,3,6,50.0,3,5,0,5,0,8,7,0
Simone Pafundi,ITA,MF,Udinese,Serie A,17,2006,0.1,0,0,0,0,0,0,0,,0,0,0,0,0,0,0,0
Riccardo Pagano,ITA,"MF,DF",Roma,Serie A,18,2004,0.6,2,2,1,1,0,0,6,0.0,6,3,2,1,0,2,2,0
Pablo Pagis,FRA,MF,Lorient,Ligue 1,20,2002,1.8,10,6,5,4,1,6,10,60.0,4,2,0,2,3,13,1,0
Exequiel Palacios,ARG,MF,Leverkusen,Bundesliga,24,1998,20.3,60,34,28,26,6,26,53,49.1,27,24,0,24,29,89,20,2
Isaac Palazón Camacho,ESP,"MF,FW",Rayo Vallecano,La Liga,28,1994,31.0,46,25,16,21,9,20,58,34.5,38,29,2,27,16,62,41,0
João Palhinha,POR,MF,Fulham,Premier League,28,1995,30.0,152,75,80,60,12,103,152,67.8,49,57,9,48,46,198,58,0
Nicolas Pallois,FRA,DF,Nantes,Ligue 1,35,1987,17.7,34,19,21,11,2,19,35,54.3,16,37,26,11,26,60,111,0
Cole Palmer,ENG,"FW,MF",Chelsea,Premier League,21,2002,29.0,23,12,9,6,8,8,19,42.1,11,20,2,18,20,43,13,2
Cole Palmer,ENG,MF,Manchester City,Premier League,21,2002,0.1,0,0,0,0,0,0,0,,0,0,0,0,0,0,0,0
Emerson Palmieri,ITA,DF,West Ham,Premier League,28,1994,34.9,106,68,48,42,16,57,90,63.3,33,47,15,32,43,149,96,0
Joaquín Panichelli,ARG,"FW,MF",Alavés,La Liga,20,2002,2.5,3,3,1,1,1,1,2,50.0,1,1,0,1,1,4,4,0
Miloš Pantović,SRB,MF,Union Berlin,Bundesliga,27,1996,0.2,0,0,0,0,0,0,0,,0,0,0,0,0,0,0,0
Antonios Papadopoulos,GER,DF,Dortmund,Bundesliga,23,1999,1.3,6,3,6,0,0,6,7,85.7,1,3,2,1,2,8,7,0
Christos Papadopoulos,GRE,FW,Genoa,Serie A,18,2004,0.0,0,0,0,0,0,0,1,0.0,1,0,0,0,0,0,0,0
Sokratis Papastathopoulos,GRE,DF,Betis,La Liga,35,1988,12.6,21,14,16,5,0,13,17,76.5,4,15,9,6,6,27,60,0
Merveille Papela,GER,"MF,DF",Mainz 05,Bundesliga,22,2001,2.9,5,4,2,3,0,0,4,0.0,4,1,0,1,4,9,2,0
Leart Paqarada,KVX,DF,Köln,Bundesliga,28,1994,11.9,21,11,9,9,3,11,22,50.0,11,17,5,12,10,31,30,1
Lucas Paquetá,BRA,"FW,MF",West Ham,Premier League,25,1997,29.1,71,48,38,26,7,25,52,48.1,27,28,1,27,21,92,28,2
Victor Parada,ESP,"FW,MF",Alavés,La Liga,21,2002,0.0,1,1,0,1,0,1,1,100.0,0,0,0,0,0,1,0,0
Aitor Paredes,ESP,DF,Athletic Club,La Liga,23,2000,30.0,20,11,11,9,0,7,14,50.0,7,23,11,12,33,53,104,0
Kevin Paredes,USA,"FW,MF",Wolfsburg,Bundesliga,20,2003,15.9,42,21,22,13,7,20,34,58.8,14,27,2,25,23,65,26,0
Leandro Paredes,ARG,MF,Roma,Serie A,29,1994,29.3,57,36,30,22,5,33,77,42.9,44,26,7,19,29,86,43,1
Daniel Parejo,ESP,MF,Villarreal,La Liga,34,1989,28.7,43,30,16,21,6,20,46,43.5,26,25,9,16,21,64,29,3
Fabiano Parisi,ITA,DF,Fiorentina,Serie A,22,2000,16.2,30,15,11,12,7,15,26,57.7,11,21,5,16,17,47,26,0
Ben Parkinson,ENG,FW,Newcastle Utd,Premier League,18,2005,0.3,0,0,0,0,0,0,0,,0,1,0,1,0,0,1,0
Thomas Partey,GHA,"MF,DF",Arsenal,Premier League,30,1993,8.8,14,11,9,4,1,5,10,50.0,5,9,3,6,11,25,9,0
Mario Pašalić,CRO,MF,Atalanta,Serie A,28,1995,22.8,28,17,9,18,1,14,31,45.2,17,29,6,23,16,44,34,0
Triantafyllos Pasaridīs,GRE,DF,Salernitana,Serie A,27,1996,5.0,11,7,9,2,0,9,14,64.3,5,7,3,4,3,14,19,0
Pascu,ESP,FW,Villarreal,La Liga,20,2003,0.2,0,0,0,0,0,0,0,,0,0,0,0,0,0,0,0
Felix Passlack,GER,DF,Bochum,Bundesliga,25,1998,10.7,21,14,9,10,2,14,24,58.3,10,13,2,11,10,31,21,0
Patric,ESP,DF,Lazio,Serie A,30,1993,17.9,13,8,10,3,0,8,18,44.4,10,15,9,6,6,19,44,0
Rui Patrício,POR,GK,Roma,Serie A,35,1988,23.0,0,0,0,0,0,0,1,0.0,1,1,0,1,0,0,3,1
Nathan Patterson,SCO,DF,Everton,Premier League,21,2001,11.2,34,24,21,11,2,14,37,37.8,23,14,3,11,9,43,33,0
Gabriel Paulista,BRA,DF,Atlético Madrid,La Liga,32,1990,4.5,7,5,4,3,0,3,4,75.0,1,5,3,2,4,11,27,0
Gabriel Paulista,BRA,DF,Valencia,La Liga,32,1990,15.5,10,7,8,2,0,6,11,54.5,5,15,7,8,24,34,78,0
Benjamin Pavard,FRA,DF,Inter,Serie A,27,1996,18.6,34,21,21,11,2,20,24,83.3,4,25,15,10,32,66,44,1
Jiří Pavlenka,CZE,GK,Werder Bremen,Bundesliga,31,1992,7.0,0,0,0,0,0,0,0,,0,0,0,0,0,0,2,0
Aleksandar Pavlovic,GER,MF,Bayern Munich,Bundesliga,19,2004,13.6,28,16,10,14,4,17,33,51.5,16,13,3,10,17,45,12,0
Leonardo Pavoletti,ITA,FW,Cagliari,Serie A,34,1988,7.0,1,1,0,0,1,0,1,0.0,1,2,1,1,0,1,7,0
Martín Payero,ARG,MF,Udinese,Serie A,24,1998,20.0,54,32,28,19,7,19,46,41.3,27,25,7,18,15,69,21,0
Nicolás Paz,ARG,"MF,FW",Real Madrid,La Liga,18,2004,0.3,0,0,0,0,0,0,0,,0,2,0,2,1,1,0,0
Myles Peart-Harris,ENG,"DF,MF",Brentford,Premier League,20,2002,0.1,0,0,0,0,0,0,0,,0,0,0,0,0,0,1,0
Sydie Peck,ENG,MF,Sheffield Utd,Premier League,18,2004,0.1,0,0,0,0,0,0,0,,0,0,0,0,0,0,0,0
Mads Pedersen,DEN,DF,Augsburg,Bundesliga,26,1996,19.8,64,39,31,27,6,24,44,54.5,20,20,3,17,19,83,46,0
Marcus Pedersen,NOR,DF,Sassuolo,Serie A,23,2000,17.9,36,24,25,5,6,21,25,84.0,4,19,5,14,10,46,51,0
Alfonso Pedraza,ESP,DF,Villarreal,La Liga,27,1996,12.4,25,9,18,5,2,9,17,52.9,8,16,7,9,13,38,19,0
Pedri,ESP,"MF,FW",Barcelona,La Liga,20,2002,16.4,33,24,16,13,4,8,27,29.6,19,27,3,24,14,47,10,0
Pedro,ESP,"FW,MF",Lazio,Serie A,36,1987,9.1,16,12,5,7,4,3,12,25.0,9,16,2,14,3,19,1,0
Adrià Pedrosa,ESP,DF,Sevilla,La Liga,25,1998,19.5,46,26,28,14,4,23,34,67.6,11,26,6,20,15,61,54,0
Jordan Pefok,USA,FW,Gladbach,Bundesliga,27,1996,15.8,10,4,0,8,2,3,8,37.5,5,12,3,9,5,15,28,0
Jordan Pefok,USA,FW,Union Berlin,Bundesliga,27,1996,0.3,0,0,0,0,0,0,0,,0,1,1,0,0,0,0,0
Dženan Pejčinović,GER,FW,Wolfsburg,Bundesliga,18,2005,0.4,0,0,0,0,0,0,0,,0,1,0,1,0,0,0,0
Pejiño,ESP,FW,Las Palmas,La Liga,27,1996,5.6,12,8,3,6,3,6,18,33.3,12,4,0,4,2,14,5,0
Pietro Pellegri,ITA,FW,Torino,Serie A,22,2001,8.4,5,1,1,4,0,1,5,20.0,4,4,1,3,2,7,3,0
Lorenzo Pellegrini,ITA,MF,Roma,Serie A,27,1996,20.7,35,20,14,16,5,17,51,33.3,34,28,5,23,20,55,22,0
Luca Pellegrini,ITA,DF,Lazio,Serie A,24,1999,8.7,18,13,7,10,1,9,17,52.9,8,7,3,4,9,27,20,0
Marco Pellegrino,,DF,Salernitana,Serie A,,,6.1,8,6,4,3,1,5,10,50.0,5,11,6,5,10,18,28,0
Marco Pellegrino,,DF,Milan,Serie A,,,0.8,1,1,0,0,1,0,2,0.0,2,1,1,0,1,2,2,0
Facundo Pellistri,URU,"FW,MF",Manchester Utd,Premier League,21,2001,1.9,5,3,4,1,0,1,3,33.3,2,7,1,6,1,6,5,0
Facundo Pellistri,URU,"MF,FW",Granada,La Liga,21,2001,13.7,29,19,12,10,7,6,21,28.6,15,18,0,18,4,33,7,0
Andy Pelmard,FRA,DF,Clermont Foot,Ligue 1,23,2000,33.2,51,38,41,9,1,32,40,80.0,8,37,20,17,33,84,99,2
Aurélien Pelon,FRA,DF,Lorient,Ligue 1,19,2004,1.0,1,0,1,0,0,0,2,0.0,2,2,2,0,0,1,7,0
Faris Pemi Moumbagna,CMR,FW,Marseille,Ligue 1,23,2000,6.1,2,1,0,2,0,0,3,0.0,3,4,0,4,3,5,1,0
Iñaki Peña,ESP,GK,Barcelona,La Liga,24,1999,10.0,0,0,0,0,0,0,1,0.0,1,0,0,0,0,0,5,1
Marcos Peña,ESP,MF,Almería,La Liga,18,2005,4.9,19,14,12,7,0,6,12,50.0,6,9,3,6,13,32,8,0
Rubén Peña,ESP,"DF,FW",Osasuna,La Liga,32,1991,23.2,47,25,22,18,7,20,49,40.8,29,37,8,29,30,77,39,3
Pepín,EQG,"MF,FW",Monza,Serie A,26,1996,2.7,6,1,1,4,1,2,4,50.0,2,5,2,3,0,6,6,0
Alberto Perea,ESP,"MF,FW",Granada,La Liga,32,1990,0.0,0,0,0,0,0,0,2,0.0,2,0,0,0,0,0,0,0
Andreas Pereira,BRA,MF,Fulham,Premier League,27,1996,29.0,25,12,4,12,9,11,41,26.8,30,16,2,14,4,29,12,0
Danilo Pereira,POR,DF,Paris S-G,Ligue 1,31,1991,22.2,22,12,14,6,2,9,17,52.9,8,29,26,3,23,45,100,1
Mathias Pereira Lage,POR,"FW,MF",Brest,Ligue 1,26,1996,13.2,21,15,7,8,6,7,28,25.0,21,14,5,9,10,31,13,0
Pedro Pereira,POR,DF,Monza,Serie A,25,1998,9.3,19,13,14,4,1,9,17,52.9,8,15,2,13,4,23,18,0
Daniel Peretz,ISR,GK,Bayern Munich,Bundesliga,23,2000,0.2,0,0,0,0,0,0,0,,0,0,0,0,0,0,0,0
Roberto Pereyra,ARG,"FW,MF",Udinese,Serie A,32,1991,20.6,19,9,11,5,3,11,29,37.9,18,20,4,16,7,26,18,0
Ayoze Pérez,ESP,FW,Betis,La Liga,30,1993,25.5,59,32,16,33,10,21,49,42.9,28,42,4,38,22,81,18,0
Carles Pérez,ESP,"MF,DF",Celta Vigo,La Liga,25,1998,8.6,13,5,6,5,2,7,18,38.9,11,14,1,13,5,18,8,0
Francisco Perez,ESP,"MF,FW",Valencia,La Liga,20,2002,22.8,30,17,10,14,6,15,44,34.1,29,19,0,19,14,44,5,0
Kike Pérez,ESP,"MF,FW",Rayo Vallecano,La Liga,26,1997,9.3,27,11,11,15,1,11,23,47.8,12,11,0,11,8,35,6,0
Nehuén Pérez,ARG,DF,Udinese,Serie A,23,2000,36.0,72,48,42,28,2,39,48,81.3,9,53,26,27,45,117,158,1
Matteo Perez Vinlöf,SWE,FW,Bayern Munich,Bundesliga,17,2005,0.2,0,0,0,0,0,0,0,,0,0,0,0,1,1,0,0
Simone Perilli,ITA,GK,Hellas Verona,Serie A,28,1995,1.0,0,0,0,0,0,0,0,,0,0,0,0,0,0,0,0
Mattia Perin,ITA,GK,Juventus,Serie A,30,1992,2.5,0,0,0,0,0,0,0,,0,0,0,0,0,0,1,0
Samuele Perisan,ITA,GK,Empoli,Serie A,25,1997,1.0,0,0,0,0,0,0,0,,0,0,0,0,0,0,0,0
Ivan Perišić,CRO,FW,Tottenham,Premier League,34,1989,1.1,3,2,1,1,1,3,5,60.0,2,1,0,1,2,5,1,0
Romain Perraud,FRA,"DF,FW",Nice,Ligue 1,25,1997,4.1,7,6,5,1,1,4,11,36.4,7,4,0,4,6,13,15,1
Lucas Perrin,FRA,DF,Strasbourg,Ligue 1,24,1998,30.3,47,30,33,14,0,28,46,60.9,18,45,32,13,28,75,113,0
Máximo Perrone,ARG,MF,Las Palmas,La Liga,20,2003,18.0,42,21,17,22,3,19,39,48.7,20,27,4,23,24,66,21,0
Pavao Pervan,AUT,GK,Wolfsburg,Bundesliga,35,1987,9.0,0,0,0,0,0,0,0,,0,0,0,0,0,0,4,0
Matteo Pessina,ITA,MF,Monza,Serie A,26,1997,35.8,44,25,20,20,4,23,49,46.9,26,29,11,18,27,71,46,1
Andrea Petagna,ITA,FW,Cagliari,Serie A,28,1995,11.1,4,2,1,0,3,1,2,50.0,1,6,3,3,1,5,4,0
Denis Petrić,SRB,GK,Nantes,Ligue 1,35,1988,0.3,0,0,0,0,0,0,0,,0,0,0,0,0,0,0,0
Njegoš Petrović,SRB,"MF,FW",Granada,La Liga,24,1999,1.7,5,2,4,1,0,2,3,66.7,1,2,0,2,1,6,3,0
Đorđe Petrović,SRB,GK,Chelsea,Premier League,23,1999,22.1,0,0,0,0,0,0,0,,0,0,0,0,0,0,12,3
Jens Petter Hauge,NOR,"MF,FW",Eint Frankfurt,Bundesliga,23,1999,1.6,2,1,1,0,1,2,7,28.6,5,5,1,4,0,2,1,0
Germán Pezzella,ARG,DF,Betis,La Liga,32,1991,30.7,34,24,24,10,0,23,38,60.5,15,31,18,13,31,65,150,0
Giuseppe Pezzella,ITA,DF,Empoli,Serie A,25,1997,12.1,25,14,19,5,1,20,28,71.4,8,17,6,11,2,27,35,0
Luca Pfeiffer,GER,"FW,MF",Darmstadt 98,Bundesliga,26,1996,18.0,11,6,2,6,3,5,11,45.5,6,5,1,4,2,13,21,0
Patric Pfeiffer,GER,DF,Augsburg,Bundesliga,23,1999,5.7,11,7,6,4,1,5,6,83.3,1,10,6,4,11,22,21,0
Maximilian Philipp,GER,"FW,MF",Freiburg,Bundesliga,29,1994,3.6,8,5,4,4,0,1,6,16.7,5,7,0,7,1,9,3,0
Kalvin Phillips,ENG,MF,West Ham,Premier League,27,1995,3.4,11,6,2,8,1,5,9,55.6,4,4,1,3,4,15,2,1
Kalvin Phillips,ENG,MF,Manchester City,Premier League,27,1995,1.0,3,3,1,1,1,0,0,,0,0,0,0,2,5,2,0
Jaden Philogene Bidace,ENG,FW,Aston Villa,Premier League,21,2002,0.0,0,0,0,0,0,0,0,,0,0,0,0,0,0,0,0
Kamil Piątkowski,POL,DF,Granada,La Liga,23,2000,5.6,18,10,16,1,1,10,14,71.4,4,6,5,1,8,26,28,1
Roberto Piccoli,ITA,FW,Empoli,Serie A,22,2001,0.4,1,1,0,0,1,1,1,100.0,0,0,0,0,0,1,0,0
Roberto Piccoli,ITA,FW,Lecce,Serie A,22,2001,15.3,10,6,3,5,2,1,4,25.0,3,17,1,16,4,14,16,0
Florian Pick,GER,"MF,FW",Heidenheim,Bundesliga,27,1995,3.6,4,4,3,0,1,2,3,66.7,1,2,0,2,2,6,2,0
Jordan Pickford,ENG,GK,Everton,Premier League,29,1994,38.0,1,0,1,0,0,1,1,100.0,0,3,0,3,0,1,19,1
Amos Pieper,GER,DF,Werder Bremen,Bundesliga,25,1998,6.6,14,11,8,6,0,7,13,53.8,6,12,7,5,9,23,36,1
Marvin Pieringer,GER,"MF,FW",Heidenheim,Bundesliga,23,1999,16.8,19,12,5,11,3,8,20,40.0,12,28,4,24,12,31,21,0
Santiago Pierotti,ARG,"MF,FW",Lecce,Serie A,22,2001,2.2,8,8,2,5,1,2,8,25.0,6,5,0,5,1,9,0,0
Niccolò Pierozzi,ITA,DF,Salernitana,Serie A,21,2001,9.7,17,11,13,4,0,11,22,50.0,11,24,7,17,11,28,36,0
Ronaël Pierre-Gabriel,FRA,DF,Nantes,Ligue 1,25,1998,6.6,15,9,12,2,1,5,7,71.4,2,13,4,9,8,23,25,0
Andrea Pinamonti,ITA,FW,Sassuolo,Serie A,24,1999,34.2,13,8,1,6,6,5,22,22.7,17,19,2,17,1,14,40,0
Ethan Pinnock,JAM,DF,Brentford,Premier League,30,1993,28.0,35,23,22,13,0,9,20,45.0,11,40,24,16,43,78,170,3
Yeremi Pino,ESP,"MF,FW",Villarreal,La Liga,20,2002,5.3,25,18,12,10,3,9,18,50.0,9,11,1,10,5,30,5,0
Carlo Pinsoglio,ITA,GK,Juventus,Serie A,33,1990,0.5,0,0,0,0,0,0,0,,0,0,0,0,0,0,0,0
Lorenzo Pirola,ITA,DF,Salernitana,Serie A,21,2002,22.1,39,23,25,14,0,15,28,53.6,13,46,30,16,25,64,93,1
Niccolò Pisilli,ITA,MF,Roma,Serie A,18,2004,0.1,0,0,0,0,0,0,0,,0,0,0,0,0,0,0,0
Alassane Pléa,FRA,"FW,MF",Gladbach,Bundesliga,30,1993,21.3,17,7,5,8,4,7,15,46.7,8,11,0,11,2,19,6,0
Tommaso Pobega,ITA,MF,Milan,Serie A,24,1999,3.5,16,9,11,5,0,6,13,46.2,7,10,2,8,6,22,7,0
Paul Pogba,FRA,MF,Juventus,Serie A,30,1993,0.6,1,1,0,1,0,1,1,100.0,0,0,0,0,1,2,1,0
Ole Pohlmann,GER,MF,Dortmund,Bundesliga,22,2001,0.6,1,0,0,1,0,1,2,50.0,1,0,0,0,0,1,1,0
Matteo Politano,ITA,FW,Napoli,Serie A,29,1993,26.2,19,8,8,7,4,11,34,32.4,23,9,1,8,15,34,11,1
Sebastian Polter,GER,FW,Darmstadt 98,Bundesliga,32,1991,5.0,1,0,1,0,0,0,1,0.0,1,5,1,4,0,1,4,0
Julien Ponceau,FRA,MF,Lorient,Ligue 1,22,2000,24.9,32,15,12,14,6,9,30,30.0,21,22,1,21,19,51,20,0
Marin Pongračić,CRO,DF,Lecce,Serie A,25,1997,35.8,43,30,22,20,1,19,25,76.0,6,37,26,11,51,94,130,1
Nick Pope,ENG,GK,Newcastle Utd,Premier League,31,1992,14.9,0,0,0,0,0,0,1,0.0,1,0,0,0,0,0,7,2
Pedro Porro,ESP,DF,Tottenham,Premier League,23,1999,34.3,91,63,43,34,14,62,120,51.7,58,63,18,45,34,125,102,3
Portu,ESP,FW,Getafe,La Liga,31,1992,1.1,5,3,4,0,1,5,6,83.3,1,0,0,0,0,5,0,0
Portu,ESP,"MF,FW",Girona,La Liga,31,1992,13.2,18,13,3,10,5,3,18,16.7,15,9,1,8,4,22,6,0
Stefan Posch,AUT,DF,Bologna,Serie A,26,1997,26.8,77,46,35,38,4,49,88,55.7,39,27,8,19,18,95,72,0
Yussuf Poulsen,DEN,FW,RB Leipzig,Bundesliga,29,1994,13.5,13,8,1,9,3,4,14,28.6,10,13,3,10,4,17,15,0
José Pozo,ESP,MF,Rayo Vallecano,La Liga,27,1996,0.2,1,1,0,1,0,1,1,100.0,0,1,0,1,0,1,0,0
Alejandro Pozo Pozo,ESP,"DF,MF",Almería,La Liga,24,1999,10.8,19,12,11,6,2,12,20,60.0,8,14,4,10,7,26,21,0
Beñat Prados,ESP,"MF,DF",Athletic Club,La Liga,22,2001,16.1,45,28,11,23,11,23,42,54.8,19,32,5,27,23,68,27,0
Matteo Prati,ITA,MF,Cagliari,Serie A,19,2003,21.9,45,25,15,27,3,26,42,61.9,16,29,6,23,15,60,26,1
Abdón Prats,ESP,"FW,MF",Mallorca,La Liga,30,1992,14.1,6,4,2,2,2,3,5,60.0,2,6,3,3,2,8,12,0
Sanjin Prcić,BIH,MF,Strasbourg,Ligue 1,29,1993,1.0,0,0,0,0,0,0,1,0.0,1,2,1,1,3,3,1,0
Grischa Prömel,GER,MF,Hoffenheim,Bundesliga,28,1995,23.8,32,18,11,15,6,14,32,43.8,18,22,6,16,22,54,36,0
Ivan Provedel,ITA,GK,Lazio,Serie A,29,1994,30.0,1,0,1,0,0,1,3,33.3,2,0,0,0,0,1,12,1
Marc Pubill,ESP,DF,Almería,La Liga,20,2003,20.9,47,23,35,8,4,22,39,56.4,17,20,8,12,15,62,83,1
Gustavo Puerta,COL,"DF,MF",Leverkusen,Bundesliga,20,2003,0.5,5,3,2,2,1,1,2,50.0,1,2,0,2,0,5,0,0
Antonio Puertas,ESP,"MF,FW",Granada,La Liga,31,1992,8.1,12,8,6,5,1,6,15,40.0,9,5,0,5,6,18,4,0
Arnau Puigmal,ESP,"FW,DF",Almería,La Liga,22,2001,2.8,2,1,1,1,0,1,3,33.3,2,3,0,3,3,5,2,0
Christian Pulisic,USA,"FW,MF",Milan,Serie A,24,1998,28.9,35,26,14,11,10,17,30,56.7,13,20,1,19,10,45,10,1
George Pușcaș,ROU,FW,Genoa,Serie A,27,1996,2.1,0,0,0,0,0,0,3,0.0,3,1,0,1,0,0,1,0
Jarell Quansah,ENG,DF,Liverpool,Premier League,20,2003,13.2,25,22,17,7,1,14,20,70.0,6,16,8,8,17,42,39,1
Domingos Quina,POR,MF,Udinese,Serie A,23,1999,0.1,1,1,1,0,0,0,0,,0,0,0,0,0,1,0,0
Adrien Rabiot,FRA,MF,Juventus,Serie A,28,1995,29.5,58,39,22,30,6,30,45,66.7,15,26,6,20,25,83,34,0
Uroš Račić,SRB,MF,Sassuolo,Serie A,25,1998,9.1,10,4,6,4,0,0,9,0.0,9,16,7,9,7,17,22,0
Nemanja Radonjić,SRB,"MF,FW",Torino,Serie A,27,1996,4.2,1,1,0,0,1,1,3,33.3,2,3,0,3,0,1,0,0
Nemanja Radonjić,SRB,"MF,DF",Mallorca,La Liga,27,1996,3.9,4,2,1,3,0,1,4,25.0,3,2,0,2,3,7,3,0
Aleksandar Radovanović,SRB,DF,Almería,La Liga,29,1993,6.3,8,7,7,1,0,6,6,100.0,0,8,8,0,11,19,48,0
Ionuț Radu,ROU,GK,Bournemouth,Premier League,26,1997,2.0,0,0,0,0,0,0,0,,0,0,0,0,0,0,0,0
Boris Radunović,SRB,GK,Cagliari,Serie A,27,1996,7.0,0,0,0,0,0,0,0,,0,0,0,0,1,1,1,2
Hamza Rafia,TUN,MF,Lecce,Serie A,24,1999,13.4,44,31,13,27,4,13,30,43.3,17,27,1,26,11,55,13,0
Abdellah Raihani,MAR,FW,Atlético Madrid,La Liga,19,2004,0.1,0,0,0,0,0,0,1,0.0,1,0,0,0,0,0,0,0
Antonio Raillo,ESP,DF,Mallorca,La Liga,31,1991,24.4,30,23,18,12,0,17,23,73.9,6,44,30,14,37,67,104,2
Luca Raimund,GER,"FW,MF",Stuttgart,Bundesliga,18,2005,0.3,3,1,2,1,0,0,0,,0,2,0,2,0,3,0,0
Predrag Rajković,SRB,GK,Mallorca,La Liga,27,1995,36.0,2,1,2,0,0,2,2,100.0,0,0,0,0,0,2,14,0
Jesurun Rak Sakyi,ENG,"MF,FW",Crystal Palace,Premier League,20,2002,1.5,4,1,3,1,0,2,3,66.7,1,2,0,2,3,7,1,0
Ivan Rakitić,CRO,MF,Sevilla,La Liga,35,1988,15.8,30,16,9,12,9,11,19,57.9,8,16,5,11,14,44,12,0
Ylber Ramadani,ALB,MF,Lecce,Serie A,27,1996,33.0,68,41,32,29,7,37,96,38.5,59,54,13,41,44,112,44,0
Largie Ramazani,BEL,"FW,MF",Almería,La Liga,22,2001,17.3,12,7,5,6,1,6,26,23.1,20,16,2,14,34,46,10,0
Benito Ramírez,ESP,"FW,MF",Las Palmas,La Liga,28,1995,4.3,5,3,2,3,0,3,6,50.0,3,7,1,6,3,8,0,0
Sandro Ramírez,ESP,FW,Las Palmas,La Liga,28,1995,20.1,12,8,4,6,2,6,15,40.0,9,13,1,12,4,16,14,1
Chris Ramos,ESP,"FW,MF",Cádiz,La Liga,26,1997,29.0,28,15,9,15,4,8,27,29.6,19,23,7,16,9,37,44,0
Gonçalo Ramos,POR,FW,Paris S-G,Ligue 1,22,2001,15.8,25,15,4,12,9,6,20,30.0,14,12,2,10,5,30,16,0
Sergio Ramos,ESP,DF,Sevilla,La Liga,37,1986,28.0,45,30,32,11,2,27,40,67.5,13,35,30,5,41,86,156,0
Aaron Ramsdale,ENG,GK,Arsenal,Premier League,25,1998,6.0,0,0,0,0,0,0,0,,0,0,0,0,0,0,3,2
Aaron Ramsey,ENG,"MF,FW",Burnley,Premier League,20,2003,5.9,17,14,7,5,5,8,16,50.0,8,11,2,9,1,18,10,0
Jacob Ramsey,ENG,"FW,MF",Aston Villa,Premier League,22,2001,9.5,16,8,7,6,3,5,15,33.3,10,15,2,13,3,19,8,0
Luca Ranieri,ITA,DF,Fiorentina,Serie A,24,1999,22.9,14,10,11,1,2,8,13,61.5,5,25,11,14,29,43,64,0
Filippo Ranocchia,ITA,"MF,DF",Empoli,Serie A,22,2001,5.3,16,11,7,9,0,7,16,43.8,9,9,1,8,3,19,14,0
Grant Ranos,ARM,"MF,FW",Gladbach,Bundesliga,20,2003,0.5,1,0,0,0,1,0,0,,0,0,0,0,0,1,0,0
Raphinha,BRA,"FW,MF",Barcelona,La Liga,26,1996,15.2,14,8,6,6,2,4,18,22.2,14,17,1,16,13,27,11,0
Nicolai Rapp,GER,DF,Werder Bremen,Bundesliga,26,1996,0.8,3,2,2,1,0,2,2,100.0,0,2,0,2,2,5,8,0
Elba Rashani,KVX,"MF,FW",Clermont Foot,Ligue 1,30,1993,13.1,30,18,4,17,9,11,24,45.8,13,17,3,14,12,42,15,0
Marcus Rashford,ENG,FW,Manchester Utd,Premier League,25,1997,25.2,19,12,9,4,6,9,26,34.6,17,15,1,14,4,23,21,0
Giacomo Raspadori,ITA,"FW,MF",Napoli,Serie A,23,2000,17.6,21,10,6,10,5,6,15,40.0,9,15,1,14,3,24,7,0
Andrei Ratiu,ROU,"DF,MF",Rayo Vallecano,La Liga,25,1998,7.0,12,4,6,5,1,8,15,53.3,7,4,1,3,0,12,12,0
Raúl,ESP,FW,Osasuna,La Liga,22,2000,15.1,10,4,4,2,4,2,10,20.0,8,9,1,8,5,15,11,0
David Raum,GER,DF,RB Leipzig,Bundesliga,25,1998,30.4,58,35,24,29,5,34,58,58.6,24,51,9,42,27,85,82,2
Federico Ravaglia,ITA,GK,Bologna,Serie A,23,1999,5.9,0,0,0,0,0,0,0,,0,0,0,0,0,0,2,0
David Raya,ESP,GK,Arsenal,Premier League,27,1995,32.0,1,1,1,0,0,1,1,100.0,0,0,0,0,0,1,8,5
Tim Ream,USA,DF,Fulham,Premier League,35,1987,16.7,20,9,13,5,2,9,18,50.0,9,23,15,8,25,45,61,2
Abderrahman Rebbach,ALG,"FW,MF",Alavés,La Liga,24,1998,8.0,9,5,4,2,3,5,15,33.3,10,10,1,9,3,12,7,0
Nathan Redmond,ENG,"FW,MF",Burnley,Premier League,29,1994,1.6,2,1,0,0,2,1,4,25.0,3,1,0,1,0,2,3,0
Harrison Reed,ENG,MF,Fulham,Premier League,28,1995,14.7,29,18,9,17,3,13,31,41.9,18,19,9,10,11,40,24,0
Sergio Reguilón,ESP,DF,Manchester Utd,Premier League,26,1996,4.6,13,8,6,2,5,8,17,47.1,9,10,0,10,5,18,7,0
Sergio Reguilón,ESP,DF,Brentford,Premier League,26,1996,12.4,45,20,26,18,1,24,40,60.0,16,23,6,17,16,61,41,1
Bobby Reid,JAM,FW,Fulham,Premier League,30,1993,15.8,22,14,5,15,2,4,16,25.0,12,24,2,22,5,27,14,0
Tijjani Reijnders,NED,MF,Milan,Serie A,25,1998,31.3,46,25,10,31,5,21,43,48.8,22,26,8,18,18,64,26,0
Pepe Reina,ESP,GK,Villarreal,La Liga,40,1982,2.0,0,0,0,0,0,0,0,,0,0,0,0,0,0,1,0
Reinier,BRA,"MF,FW",Frosinone,Serie A,21,2002,11.8,21,10,6,12,3,5,17,29.4,12,24,4,20,10,31,5,0
Rocco Reitz,GER,MF,Gladbach,Bundesliga,21,2002,23.7,61,36,28,29,4,28,55,50.9,27,61,20,41,44,105,31,1
Álex Remiro,ESP,GK,Real Sociedad,La Liga,28,1995,36.4,0,0,0,0,0,0,0,,0,0,0,0,0,0,24,2
Guillaume Restes,FRA,GK,Toulouse,Ligue 1,18,2005,34.0,0,0,0,0,0,0,3,0.0,3,0,0,0,0,0,19,1
Mateo Retegui,ITA,FW,Genoa,Serie A,24,1999,24.6,17,9,7,8,2,6,20,30.0,14,18,2,16,0,17,30,0
Marco Reus,GER,"MF,FW",Dortmund,Bundesliga,34,1989,17.8,37,25,20,14,3,12,27,44.4,15,17,2,15,5,42,18,0
Elvis Rexhbeçaj,KVX,MF,Augsburg,Bundesliga,25,1997,22.1,30,19,14,13,3,18,36,50.0,18,32,7,25,20,50,20,0
Gio Reyna,USA,"FW,MF",Nott'ham Forest,Premier League,20,2002,2.6,7,3,4,0,3,3,6,50.0,3,3,0,3,2,9,0,0
Gio Reyna,USA,"MF,FW",Dortmund,Bundesliga,20,2002,3.1,9,6,3,4,2,2,5,40.0,3,5,1,4,2,11,5,0
Chadi Riad,MAR,DF,Betis,La Liga,20,2003,24.0,35,24,17,18,0,17,27,63.0,10,23,14,9,23,58,108,0
Alexsandro Ribeiro,BRA,DF,Lille,Ligue 1,23,1999,24.7,32,22,24,8,0,16,31,51.6,15,25,15,10,35,67,116,5
Rodrigo Ribeiro,POR,"MF,FW",Nott'ham Forest,Premier League,18,2005,0.2,0,0,0,0,0,0,1,0.0,1,1,0,1,1,1,0,0
Samuele Ricci,ITA,MF,Torino,Serie A,21,2001,26.6,33,18,17,12,4,15,23,65.2,8,21,3,18,27,60,25,0
Declan Rice,ENG,MF,Arsenal,Premier League,24,1999,35.8,83,51,37,38,8,32,57,56.1,25,37,11,26,44,127,52,0
Chris Richards,USA,"DF,MF",Crystal Palace,Premier League,23,2000,23.3,46,28,21,22,3,20,30,66.7,10,32,12,20,27,73,109,0
Amir Richardson,MAR,MF,Reims,Ligue 1,21,2002,15.0,33,23,12,18,3,10,22,45.5,12,26,5,21,15,48,30,0
Richarlison,BRA,FW,Tottenham,Premier League,26,1997,16.6,16,11,4,8,4,2,10,20.0,8,32,6,26,8,24,23,0
Marco Richter,GER,"MF,FW",Mainz 05,Bundesliga,25,1997,8.0,10,4,5,3,2,4,11,36.4,7,9,0,9,2,12,1,0
Diego Rico,ESP,DF,Getafe,La Liga,30,1993,28.2,64,48,32,23,9,41,76,53.9,35,25,8,17,41,105,76,0
Clemens Riedel,GER,DF,Darmstadt 98,Bundesliga,20,2003,8.4,22,13,16,5,1,15,24,62.5,9,11,3,8,11,33,26,0
Fabian Rieder,SUI,MF,Rennes,Ligue 1,21,2002,4.1,13,7,2,9,2,6,11,54.5,5,3,1,2,5,18,2,0
Jaïro Riedewald,NED,"MF,FW",Crystal Palace,Premier League,26,1996,2.6,9,3,2,4,3,3,6,50.0,3,0,0,0,2,11,2,0
Manuel Riemann,GER,GK,Bochum,Bundesliga,34,1988,33.0,2,1,2,0,0,2,4,50.0,2,0,0,0,1,3,25,1
Luis Rioja,ESP,"FW,MF",Alavés,La Liga,29,1993,27.8,27,19,10,12,5,14,43,32.6,29,28,1,27,16,43,28,0
Rémy Riou,FRA,GK,Lyon,Ligue 1,35,1987,3.0,0,0,0,0,0,0,1,0.0,1,0,0,0,0,0,1,1
Rodrigo Riquelme,ESP,"DF,MF",Atlético Madrid,La Liga,23,2000,17.0,30,19,18,4,8,18,46,39.1,28,19,0,19,9,39,20,0
Alberto Risco,ESP,MF,Getafe,La Liga,17,2005,1.5,2,2,1,1,0,0,4,0.0,4,0,0,0,0,2,1,0
Mihailo Ristić,SRB,"DF,MF",Celta Vigo,La Liga,27,1995,9.0,15,9,9,6,0,9,12,75.0,3,9,2,7,10,25,23,0
Matt Ritchie,SCO,"FW,MF",Newcastle Utd,Premier League,33,1989,1.4,5,3,2,2,1,2,4,50.0,2,3,2,1,1,6,5,0
Gorka Rivera Alonso,ESP,DF,Getafe,La Liga,18,2004,0.0,0,0,0,0,0,0,0,,0,0,0,0,0,0,0,0
Sergi Roberto,ESP,"MF,DF",Barcelona,La Liga,31,1992,9.6,15,10,4,10,1,3,11,27.3,8,7,2,5,8,23,7,1
Lucas Robertone,ARG,MF,Almería,La Liga,26,1997,26.5,61,33,28,23,10,25,50,50.0,25,43,9,34,51,112,43,0
Connor Roberts,WAL,DF,Burnley,Premier League,27,1995,9.1,12,5,6,4,2,8,17,47.1,9,8,6,2,4,16,25,2
Andrew Robertson,SCO,DF,Liverpool,Premier League,29,1994,18.8,35,24,21,11,3,26,43,60.5,17,20,6,14,13,48,40,0
Antonee Robinson,USA,DF,Fulham,Premier League,25,1997,36.3,93,58,60,26,7,52,110,47.3,58,56,8,48,80,173,117,3
Jack Robinson,ENG,DF,Sheffield Utd,Premier League,29,1993,32.1,43,28,29,14,0,25,39,64.1,14,49,33,16,33,76,132,2
Marc Roca,ESP,MF,Betis,La Liga,26,1996,22.0,52,36,17,29,6,30,53,56.6,23,29,6,23,17,69,23,1
Sebastian Rode,GER,MF,Eint Frankfurt,Bundesliga,32,1990,0.7,6,4,0,5,1,4,6,66.7,2,0,0,0,1,7,1,0
Sergio Rodelas,ESP,"FW,DF",Granada,La Liga,18,2004,1.4,3,2,1,0,2,0,3,0.0,3,0,0,0,0,3,0,0
Rodri,ESP,MF,Manchester City,Premier League,27,1996,32.6,70,43,25,33,12,29,60,48.3,31,32,8,24,26,96,41,4
Rodri,ESP,"FW,MF",Betis,La Liga,23,2000,11.7,17,10,6,7,4,8,21,38.1,13,11,0,11,8,25,2,0
Álvaro Rodríguez,URU,FW,Real Madrid,La Liga,19,2004,0.0,0,0,0,0,0,0,0,,0,0,0,0,0,0,1,0
Óscar Rodríguez Arnaiz,ESP,"MF,FW",Getafe,La Liga,25,1998,10.7,24,13,2,15,7,9,15,60.0,6,12,1,11,5,29,5,0
Damián Rodríguez,ESP,MF,Celta Vigo,La Liga,20,2003,2.9,6,3,1,3,2,1,3,33.3,2,4,2,2,1,7,2,0
Dani Rodríguez,ESP,MF,Mallorca,La Liga,35,1988,29.1,47,24,21,20,6,21,45,46.7,24,34,5,29,15,62,21,0
Guido Rodríguez,ARG,MF,Betis,La Liga,29,1994,20.5,53,30,21,24,8,34,55,61.8,21,27,6,21,29,82,44,0
Jay Rodriguez,ENG,FW,Burnley,Premier League,34,1989,9.1,14,9,7,4,3,7,13,53.8,6,11,1,10,1,15,8,0
Kirian Rodríguez,ESP,MF,Las Palmas,La Liga,27,1996,35.7,52,32,22,25,5,24,67,35.8,43,39,3,36,28,80,23,1
Miguel Rodríguez,ESP,MF,Celta Vigo,La Liga,20,2003,3.3,6,3,3,1,2,3,9,33.3,6,8,0,8,4,10,0,0
Ricardo Rodríguez,SUI,DF,Torino,Serie A,30,1992,30.8,45,26,21,22,2,28,45,62.2,17,22,9,13,24,69,64,2
Rodrygo,BRA,FW,Real Madrid,La Liga,22,2001,26.4,16,15,2,9,5,5,19,26.3,14,14,0,14,8,24,6,0
Mads Roerslev,DEN,DF,Brentford,Premier League,24,1999,22.1,48,31,34,9,5,27,54,50.0,27,15,3,12,19,67,71,0
Rogério,BRA,DF,Wolfsburg,Bundesliga,25,1998,10.1,14,6,7,5,2,10,14,71.4,4,16,5,11,5,19,23,1
Morgan Rogers,ENG,"MF,FW",Aston Villa,Premier League,21,2002,7.1,8,1,3,2,3,2,11,18.2,9,11,0,11,3,11,11,0
Merlin Röhl,GER,"MF,FW",Freiburg,Bundesliga,21,2002,16.4,21,13,10,9,2,8,21,38.1,13,27,3,24,9,30,22,0
Alessio Romagnoli,ITA,DF,Lazio,Serie A,28,1995,26.8,25,18,14,11,0,16,24,66.7,8,29,17,12,29,54,115,0
Simone Romagnoli,ITA,DF,Frosinone,Serie A,33,1990,30.2,35,15,23,11,1,15,20,75.0,5,51,36,15,29,64,147,0
Carlos Romero,ESP,DF,Villarreal,La Liga,21,2001,2.9,11,5,8,1,2,7,12,58.3,5,3,0,3,1,12,11,0
Cristian Romero,ARG,DF,Tottenham,Premier League,25,1998,31.0,66,40,35,25,6,32,44,72.7,12,46,22,24,44,110,106,1
Isaac Romero,ESP,FW,Sevilla,La Liga,23,2000,11.5,6,3,2,2,2,5,9,55.6,4,12,0,12,0,6,11,0
Luka Romero,ARG,"FW,MF",Milan,Serie A,18,2004,1.0,0,0,0,0,0,0,3,0.0,3,2,0,2,0,0,0,0
Luka Romero,ARG,FW,Almería,La Liga,18,2004,4.9,5,1,2,3,0,2,4,50.0,2,12,1,11,1,6,2,1
Oriol Romeu,ESP,MF,Barcelona,La Liga,31,1991,10.4,34,20,17,14,3,13,24,54.2,11,12,2,10,10,44,18,0
Valentin Rongier,FRA,MF,Marseille,Ligue 1,28,1994,9.5,23,12,9,12,2,14,26,53.8,12,16,4,12,15,38,18,0
Frank Ronstadt,GER,"DF,MF",Darmstadt 98,Bundesliga,26,1997,0.8,1,0,0,1,0,0,1,0.0,1,1,0,1,1,2,3,0
Marten de Roon,NED,"MF,DF",Atalanta,Serie A,32,1991,28.9,80,43,36,32,12,35,82,42.7,47,36,10,26,40,120,54,0
Unai Ropero,ESP,MF,Alavés,La Liga,21,2001,0.1,0,0,0,0,0,0,0,,0,0,0,0,0,0,0,0
Vitor Roque,BRA,FW,Barcelona,La Liga,18,2005,3.6,3,2,2,0,1,0,2,0.0,2,3,0,3,0,3,5,0
Pablo Rosario,NED,"MF,DF",Nice,Ligue 1,26,1997,22.3,36,25,15,16,5,23,34,67.6,11,27,13,14,29,65,39,0
Valentin Rosier,FRA,"DF,MF",Nice,Ligue 1,26,1996,0.6,1,0,1,0,0,0,0,,0,1,0,1,2,3,5,0
Francesco Rossi,ITA,GK,Atalanta,Serie A,32,1991,0.1,0,0,0,0,0,0,0,,0,0,0,0,0,0,0,0
Joe Rothwell,ENG,MF,Bournemouth,Premier League,28,1995,4.3,7,2,4,2,1,2,8,25.0,6,4,2,2,3,10,2,0
Anthony Rouault,FRA,DF,Stuttgart,Bundesliga,22,2001,11.2,21,12,14,5,2,13,21,61.9,8,14,8,6,8,29,28,0
Jérôme Roussillon,FRA,DF,Union Berlin,Bundesliga,30,1993,8.4,16,9,6,7,3,8,12,66.7,4,13,4,9,5,21,26,0
Nicolò Rovella,ITA,MF,Lazio,Serie A,21,2001,14.6,46,28,25,17,4,16,36,44.4,20,27,6,21,23,69,29,0
Amir Rrahmani,KVX,DF,Napoli,Serie A,29,1994,28.9,33,27,17,14,2,16,32,50.0,16,24,10,14,20,53,90,0
Ruan,BRA,DF,Sassuolo,Serie A,24,1999,16.8,25,15,11,10,4,10,18,55.6,8,18,15,3,24,49,68,2
Pelly Ruddock Mpanzu,COD,MF,Luton Town,Premier League,30,1993,12.2,13,5,6,6,1,5,9,55.6,4,15,7,8,9,22,16,3
Antonio Rüdiger,GER,DF,Real Madrid,La Liga,30,1993,30.1,26,15,18,4,4,16,20,80.0,4,27,20,7,11,37,89,0
Fabian Rüdlin,GER,MF,Freiburg,Bundesliga,26,1997,0.1,1,0,0,0,1,0,0,,0,0,0,0,0,1,0,0
Javier Rueda Garcia,ESP,"MF,DF",Celta Vigo,La Liga,21,2002,0.2,0,0,0,0,0,0,0,,0,0,0,0,0,0,0,0
Daniele Rugani,ITA,DF,Juventus,Serie A,29,1994,13.2,11,9,7,3,1,4,5,80.0,1,11,4,7,9,20,42,0
Matteo Ruggeri,ITA,DF,Atalanta,Serie A,21,2002,27.2,29,15,14,7,8,16,30,53.3,14,46,4,42,23,52,44,0
Mário Rui,POR,DF,Napoli,Serie A,32,1991,13.4,27,15,17,5,5,14,21,66.7,7,17,2,15,15,42,19,0
Aitor Ruibal,ESP,"DF,FW",Betis,La Liga,27,1996,11.3,46,27,28,13,5,32,59,54.2,27,12,1,11,14,60,33,1
Fabián Ruiz Peña,ESP,MF,Paris S-G,Ligue 1,27,1996,13.3,34,23,17,14,3,23,42,54.8,19,8,2,6,11,45,21,2
Sergio Ruiz,ESP,MF,Granada,La Liga,28,1994,27.7,83,46,43,36,4,38,84,45.2,46,24,6,18,28,111,43,1
Julian Ryerson,NOR,DF,Dortmund,Bundesliga,25,1997,19.6,41,23,26,11,4,27,47,57.4,20,31,7,24,10,51,35,3
Frederik Rønnow,DEN,GK,Union Berlin,Bundesliga,30,1992,33.0,1,1,1,0,0,0,0,,0,0,0,0,1,2,20,2
José Sá,POR,GK,Wolves,Premier League,30,1993,33.7,0,0,0,0,0,0,1,0.0,1,3,0,3,0,0,21,5
Youssouf Sabaly,SEN,DF,Betis,La Liga,30,1993,11.6,16,11,12,3,1,8,12,66.7,4,6,3,3,11,27,27,0
Emmanuel Sabbi,USA,"FW,MF",Le Havre,Ligue 1,25,1997,17.6,38,19,15,15,8,16,39,41.0,23,26,2,24,19,57,7,0
Stefano Sabelli,ITA,DF,Genoa,Serie A,30,1993,27.0,50,24,28,19,3,15,46,32.6,31,27,6,21,23,73,35,0
Marcel Sabitzer,AUT,MF,Dortmund,Bundesliga,29,1994,21.8,39,24,18,20,1,23,42,54.8,19,31,12,19,12,51,34,0
Falaye Sacko,MLI,DF,Montpellier,Ligue 1,28,1995,15.4,28,16,13,10,5,21,32,65.6,11,19,7,12,24,52,37,0
Dominic Sadi,ENG,FW,Bournemouth,Premier League,19,2003,0.0,0,0,0,0,0,0,0,,0,0,0,0,0,0,0,0
Umar Sadiq,NGA,FW,Real Sociedad,La Liga,26,1997,12.0,15,10,2,8,5,4,8,50.0,4,9,0,9,0,15,10,0
Alexis Saelemaekers,BEL,"FW,MF",Bologna,Serie A,24,1999,21.0,32,22,13,14,5,12,27,44.4,15,13,1,12,13,45,10,1
Pablo Saenz,ESP,MF,Granada,La Liga,22,2001,0.2,3,3,2,0,1,1,3,33.3,2,0,0,0,0,3,0,0
Modibo Sagnan,MLI,DF,Montpellier,Ligue 1,24,1999,11.7,34,22,23,9,2,15,25,60.0,10,13,9,4,15,49,67,0
Wesley Saïd,FRA,"FW,MF",Lens,Ligue 1,28,1995,11.3,8,4,1,2,5,2,9,22.2,7,4,0,4,4,12,3,0
Théo Sainte-Luce,FRA,DF,Montpellier,Ligue 1,24,1998,3.8,17,7,10,6,1,11,19,57.9,8,9,4,5,3,20,15,0
Bukayo Saka,ENG,FW,Arsenal,Premier League,21,2001,32.4,66,35,22,24,20,26,59,44.1,33,43,2,41,15,81,24,1
Mamadou Sakho,FRA,DF,Montpellier,Ligue 1,33,1990,0.1,1,1,1,0,0,1,1,100.0,0,0,0,0,0,1,1,0
Ibrahim Salah,MAR,"FW,MF",Rennes,Ligue 1,21,2001,5.8,15,7,5,6,4,11,18,61.1,7,4,0,4,10,25,5,0
Mohamed Salah,EGY,FW,Liverpool,Premier League,31,1992,28.2,17,11,1,8,8,6,21,28.6,15,19,1,18,2,19,1,0
Amine Salama,FRA,FW,Reims,Ligue 1,23,2000,3.5,0,0,0,0,0,0,0,,0,1,0,1,1,1,1,0
Kike Salas,ESP,DF,Sevilla,La Liga,21,2002,17.8,41,23,26,12,3,22,36,61.1,14,25,14,11,26,67,91,1
William Saliba,FRA,DF,Arsenal,Premier League,22,2001,38.0,41,26,28,12,1,20,27,74.1,7,32,17,15,29,70,81,3
Mohammed Salisu,GHA,DF,Monaco,Ligue 1,24,1999,11.5,27,12,11,13,3,17,26,65.4,9,21,12,9,22,49,44,0
Roland Sallai,HUN,"MF,FW",Freiburg,Bundesliga,26,1997,20.4,17,10,5,5,7,8,20,40.0,12,21,1,20,6,23,23,0
Yoann Salmier,GUF,DF,Le Havre,Ligue 1,30,1992,17.4,22,10,13,6,3,13,20,65.0,7,21,15,6,21,43,57,0
Salvi,ESP,MF,Rayo Vallecano,La Liga,32,1991,0.3,0,0,0,0,0,0,4,0.0,4,0,0,0,1,1,0,0
Lazar Samardzic,SRB,MF,Udinese,Serie A,21,2002,26.4,40,19,18,18,4,16,39,41.0,23,26,6,20,10,50,25,0
Diadie Samassékou,MLI,MF,Cádiz,La Liga,27,1996,1.0,5,3,2,2,1,5,6,83.3,1,0,0,0,3,8,1,0
Diadie Samassékou,MLI,MF,Hoffenheim,Bundesliga,27,1996,0.0,0,0,0,0,0,0,0,,0,0,0,0,1,1,0,0
Mama Samba Baldé,GNB,"FW,MF",Lyon,Ligue 1,27,1995,6.1,8,5,1,2,5,3,9,33.3,6,0,0,0,3,11,1,1
Brice Samba,FRA,GK,Lens,Ligue 1,29,1994,33.0,1,1,1,0,0,1,1,100.0,0,0,0,0,0,1,10,3
Albert Sambi Lokonga,BEL,MF,Luton Town,Premier League,23,1999,14.5,29,18,14,12,3,17,24,70.8,7,23,13,10,11,40,14,0
Junior Sambia,FRA,"DF,MF",Salernitana,Serie A,26,1996,11.5,12,5,8,1,3,6,11,54.5,5,15,7,8,11,23,28,0
Fede San Emeterio,ESP,MF,Cádiz,La Liga,26,1997,1.7,3,2,2,1,0,1,4,25.0,3,3,2,1,2,5,1,0
Antonio Sanabria,PAR,"FW,MF",Torino,Serie A,27,1996,23.7,18,15,5,9,4,4,9,44.4,5,7,1,6,6,24,12,0
Oihan Sancet,ESP,MF,Athletic Club,La Liga,23,2000,21.9,19,11,3,10,6,8,21,38.1,13,5,1,4,10,29,5,0
Renato Sanches,POR,MF,Roma,Serie A,25,1997,1.6,2,1,1,1,0,2,3,66.7,1,2,0,2,0,2,1,0
Ricard Sánchez,ESP,DF,Granada,La Liga,23,2000,25.5,29,18,15,8,6,12,24,50.0,12,32,4,28,13,42,64,0
Alexis Sánchez,CHI,"FW,MF",Inter,Serie A,34,1988,8.5,7,6,0,5,2,1,4,25.0,3,4,1,3,1,8,3,0
Antonio Sánchez,ESP,MF,Mallorca,La Liga,26,1997,16.1,25,11,13,10,2,11,32,34.4,21,24,5,19,13,38,13,0
Davinson Sánchez,COL,DF,Tottenham,Premier League,27,1996,0.9,0,0,0,0,0,0,0,,0,3,2,1,1,1,2,0
Juanlu Sánchez,ESP,DF,Sevilla,La Liga,19,2003,13.1,56,35,34,18,4,34,58,58.6,24,24,7,17,12,68,36,0
Manu Sánchez,ESP,"DF,MF",Celta Vigo,La Liga,22,2000,19.7,54,28,21,25,8,31,55,56.4,24,23,3,20,19,73,65,0
Robert Sánchez,ESP,GK,Chelsea,Premier League,25,1997,15.9,0,0,0,0,0,0,0,,0,0,0,0,0,0,11,3
Jadon Sancho,ENG,"FW,MF",Manchester Utd,Premier League,23,2000,0.9,1,0,1,0,0,1,3,33.3,2,1,0,1,1,2,0,0
Jadon Sancho,ENG,"FW,MF",Dortmund,Bundesliga,23,2000,10.5,5,4,1,3,1,0,4,0.0,4,11,0,11,4,9,6,0
Alex Sandro,BRA,DF,Juventus,Serie A,32,1991,8.0,13,7,7,6,0,4,5,80.0,1,13,7,6,15,28,23,0
Ibou Sané,SEN,"MF,FW",Metz,Ligue 1,18,2005,1.4,6,4,2,1,3,2,2,100.0,0,3,0,3,1,7,2,0
Leroy Sané,GER,FW,Bayern Munich,Bundesliga,27,1996,23.7,15,8,6,6,3,4,19,21.1,15,12,0,12,7,22,3,0
Sadibou Sané,SEN,DF,Metz,Ligue 1,19,2004,9.4,19,12,16,2,1,6,7,85.7,1,14,9,5,8,27,64,0
Arouna Sangante,SEN,DF,Le Havre,Ligue 1,21,2002,29.9,53,33,27,23,3,24,40,60.0,16,35,18,17,66,119,93,2
Ibrahim Sangaré,CIV,MF,Nott'ham Forest,Premier League,25,1997,11.5,42,23,25,13,4,12,29,41.4,17,24,7,17,16,58,21,0
Morgan Sanson,FRA,MF,Nice,Ligue 1,28,1994,21.8,26,19,12,7,7,12,31,38.7,19,34,5,29,20,46,16,0
Nicola Sansone,ITA,"FW,MF",Lecce,Serie A,31,1991,8.5,11,6,6,2,3,5,16,31.3,11,7,1,6,4,15,5,2
Baptiste Santamaria,FRA,MF,Rennes,Ligue 1,28,1995,21.4,52,33,21,25,6,29,46,63.0,17,15,6,9,34,86,33,1
Jesús Santiago,ESP,MF,Getafe,La Liga,19,2004,7.3,17,8,8,5,4,4,7,57.1,3,3,0,3,0,17,8,0
Andrey Santos,BRA,MF,Nott'ham Forest,Premier League,19,2004,0.1,0,0,0,0,0,0,0,,0,1,0,1,0,0,0,0
Andrey Santos,BRA,MF,Strasbourg,Ligue 1,19,2004,9.2,29,18,15,13,1,17,26,65.4,9,8,0,8,10,39,11,1
Tiago Santos,POR,DF,Lille,Ligue 1,21,2002,26.3,63,42,31,19,13,30,52,57.7,22,24,5,19,15,78,37,0
Paco Sanz,ESP,DF,Almería,La Liga,18,2004,0.3,0,0,0,0,0,0,1,0.0,1,0,0,0,0,0,4,0
Riccardo Saponara,ITA,"FW,MF",Hellas Verona,Serie A,31,1991,3.8,3,1,2,0,1,1,7,14.3,6,4,0,4,0,3,2,0
Pablo Sarabia,ESP,"MF,FW",Wolves,Premier League,31,1992,19.4,20,13,8,8,4,12,36,33.3,24,17,1,16,10,30,9,0
Amin Sarr,SWE,"FW,MF",Lyon,Ligue 1,22,2001,1.1,1,0,0,1,0,0,0,,0,1,0,1,0,1,1,0
Amin Sarr,SWE,"FW,MF",Wolfsburg,Bundesliga,22,2001,4.3,3,2,1,2,0,1,2,50.0,1,6,1,5,2,5,1,0
Bouna Sarr,SEN,DF,Bayern Munich,Bundesliga,31,1992,1.2,2,0,1,1,0,2,2,100.0,0,3,0,3,0,2,1,0
Ismaila Sarr,SEN,"FW,MF",Marseille,Ligue 1,25,1998,16.1,14,8,2,10,2,6,17,35.3,11,21,6,15,13,27,11,0
Mamadou Sarr,FRA,DF,Lyon,Ligue 1,17,2005,0.1,0,0,0,0,0,0,0,,0,0,0,0,0,0,0,0
Martin Satriano,URU,FW,Brest,Ligue 1,22,2001,20.7,24,16,6,13,5,10,25,40.0,15,19,7,12,7,31,28,0
Téji Savanier,FRA,MF,Montpellier,Ligue 1,31,1991,30.7,37,20,16,15,6,14,63,22.2,49,36,8,28,33,70,28,1
Stefan Savić,MNE,DF,Atlético Madrid,La Liga,32,1991,18.1,27,19,16,7,4,15,30,50.0,15,29,15,14,27,54,61,1
Sávio,BRA,"FW,MF",Girona,La Liga,19,2004,33.1,42,25,14,22,6,16,28,57.1,12,34,0,34,18,60,11,1
Zanos Savva,CYP,"DF,MF",Torino,Serie A,17,2005,0.3,1,1,0,1,0,1,3,33.3,2,0,0,0,0,1,1,0
Saba Sazonov,GEO,DF,Torino,Serie A,21,2002,4.0,9,7,4,5,0,3,3,100.0,0,8,5,3,3,12,22,0
Joe Scally,USA,DF,Gladbach,Bundesliga,20,2002,24.8,41,28,21,17,3,23,40,57.5,17,31,11,20,18,59,78,2
Giorgio Scalvini,ITA,DF,Atalanta,Serie A,19,2003,28.3,53,33,29,19,5,19,40,47.5,21,44,17,27,59,112,71,0
Gianluca Scamacca,ITA,FW,Atalanta,Serie A,24,1999,16.1,15,9,4,5,6,7,14,50.0,7,7,1,6,4,19,9,0
Dane Scarlett,ENG,FW,Tottenham,Premier League,19,2004,0.2,1,1,0,0,1,0,1,0.0,1,0,0,0,0,1,0,0
Kevin Schade,GER,"FW,MF",Brentford,Premier League,21,2001,3.7,3,1,1,2,0,0,5,0.0,5,2,0,2,1,4,4,0
András Schäfer,HUN,MF,Union Berlin,Bundesliga,24,1999,13.5,29,16,9,15,5,11,20,55.0,9,25,4,21,20,49,25,0
Fabian Schär,SUI,DF,Newcastle Utd,Premier League,31,1991,33.9,42,24,27,13,2,18,40,45.0,22,50,38,12,36,78,133,1
Patrik Schick,CZE,FW,Leverkusen,Bundesliga,27,1996,11.8,6,4,0,3,3,1,5,20.0,4,2,0,2,1,7,7,0
Stefan Schimmer,GER,"MF,FW",Heidenheim,Bundesliga,29,1994,1.7,1,1,0,1,0,0,3,0.0,3,2,0,2,1,2,6,0
Xaver Schlager,AUT,MF,RB Leipzig,Bundesliga,25,1997,27.5,81,50,35,38,8,21,53,39.6,32,41,8,33,19,100,27,0
Keven Schlotterbeck,GER,DF,Bochum,Bundesliga,26,1997,24.3,42,22,26,14,2,25,30,83.3,5,33,23,10,33,75,104,2
Nico Schlotterbeck,GER,DF,Dortmund,Bundesliga,23,1999,31.8,70,50,36,27,7,41,65,63.1,24,52,25,27,45,115,101,3
Jeffrey Schlupp,GHA,"FW,MF",Crystal Palace,Premier League,30,1992,15.0,38,24,14,16,8,9,18,50.0,9,13,2,11,8,46,24,0
Romano Schmid,AUT,"MF,FW",Werder Bremen,Bundesliga,23,2000,28.9,35,20,7,22,6,14,46,30.4,32,36,7,29,11,46,17,2
Kenneth Schmidt,GER,DF,Freiburg,Bundesliga,21,2002,0.8,2,2,2,0,0,2,4,50.0,2,1,0,1,1,3,2,0
Niklas Schmidt,GER,MF,Toulouse,Ligue 1,25,1998,14.1,36,21,13,19,4,16,33,48.5,17,14,7,7,4,40,13,0
Benno Schmitz,GER,DF,Köln,Bundesliga,28,1994,12.8,27,15,20,7,0,17,34,50.0,17,19,4,15,7,34,29,0
Fabian Schnellhardt,GER,MF,Darmstadt 98,Bundesliga,29,1994,2.6,4,1,2,1,1,1,3,33.3,2,1,0,1,4,8,5,0
Jan Schöppner,GER,MF,Heidenheim,Bundesliga,24,1999,22.2,48,26,26,20,2,21,42,50.0,21,37,7,30,26,74,57,0
Marcel Schuhen,GER,GK,Darmstadt 98,Bundesliga,30,1993,31.0,1,0,1,0,0,1,3,33.3,2,0,0,0,2,3,11,4
Perr Schuurs,NED,DF,Torino,Serie A,23,1999,8.6,20,12,11,8,1,3,9,33.3,6,10,2,8,9,29,23,0
Marvin Schwäbe,GER,GK,Köln,Bundesliga,28,1995,34.0,1,0,1,0,0,1,1,100.0,0,0,0,0,0,1,10,1
Alexander Schwolow,GER,GK,Union Berlin,Bundesliga,31,1992,1.0,0,0,0,0,0,0,0,,0,0,0,0,0,0,2,0
Alex Scott,ENG,MF,Bournemouth,Premier League,19,2003,11.3,24,15,8,10,6,12,28,42.9,16,14,4,10,12,36,18,2
Simone Scuffet,ITA,GK,Cagliari,Serie A,27,1996,31.0,1,0,1,0,0,1,2,50.0,1,1,0,1,1,2,9,0
Jérémy Sebas,MTQ,"FW,MF",Strasbourg,Ligue 1,20,2003,4.4,7,1,2,3,2,3,5,60.0,2,3,1,2,1,8,1,0
Demba Seck,SEN,MF,Torino,Serie A,22,2001,4.7,5,3,1,4,0,3,4,75.0,1,1,0,1,1,6,0,0
Demba Seck,SEN,"FW,MF",Frosinone,Serie A,22,2001,3.3,7,4,2,3,2,4,5,80.0,1,3,0,3,1,8,1,0
Aleksandar Sedlar,SRB,DF,Alavés,La Liga,31,1991,10.5,14,10,10,4,0,10,16,62.5,6,8,4,4,13,27,43,0
Alidu Seidu,GHA,DF,Rennes,Ligue 1,23,2000,6.6,21,9,17,3,1,14,19,73.7,5,11,3,8,10,31,13,0
Alidu Seidu,GHA,DF,Clermont Foot,Ligue 1,23,2000,12.6,32,24,17,15,0,24,31,77.4,7,15,7,8,25,57,37,0
Nicolas Seiwald,AUT,MF,RB Leipzig,Bundesliga,22,2001,8.0,33,18,16,15,2,16,25,64.0,9,12,2,10,8,41,15,0
Nikola Sekulov,ITA,FW,Juventus,Serie A,21,2002,0.1,0,0,0,0,0,0,0,,0,0,0,0,0,0,0,0
Davie Selke,GER,FW,Köln,Bundesliga,28,1995,14.1,4,2,1,3,0,0,2,0.0,2,5,3,2,0,4,20,0
Matz Sels,BEL,GK,Nott'ham Forest,Premier League,31,1992,16.0,0,0,0,0,0,0,0,,0,0,0,0,0,0,11,1
Matz Sels,BEL,GK,Strasbourg,Ligue 1,31,1992,19.0,0,0,0,0,0,0,0,,0,2,0,2,0,0,13,1
Nélson Semedo,POR,"DF,MF",Wolves,Premier League,29,1993,34.3,79,48,52,19,8,38,64,59.4,26,44,8,36,36,115,85,1
Vivaldo Semedo,POR,FW,Udinese,Serie A,18,2005,0.1,0,0,0,0,0,0,0,,0,0,0,0,0,0,0,0
Antoine Semenyo,GHA,FW,Bournemouth,Premier League,23,2000,23.4,24,17,7,9,8,9,27,33.3,18,39,2,37,6,30,21,0
Marvin Senaya,TOG,"DF,MF",Strasbourg,Ligue 1,22,2001,23.8,72,53,38,25,9,42,68,61.8,26,40,13,27,41,113,68,0
Marcos Senesi,ARG,DF,Bournemouth,Premier League,26,1997,24.9,55,32,28,23,4,24,56,42.9,32,50,23,27,35,90,109,1
Stefano Sensi,ITA,MF,Inter,Serie A,27,1995,0.5,1,1,0,1,0,1,3,33.3,2,1,0,1,1,2,0,0
Suat Serdar,GER,MF,Hellas Verona,Serie A,26,1997,18.4,51,39,24,23,4,22,45,48.9,23,29,7,22,20,71,25,1
Benjamin Šeško,SVN,FW,RB Leipzig,Bundesliga,20,2003,17.0,13,5,2,7,4,2,9,22.2,7,23,2,21,3,16,27,0
Kevin Sessa,GER,"MF,FW",Heidenheim,Bundesliga,23,2000,11.2,17,10,9,6,2,7,16,43.8,9,12,1,11,4,21,17,0
Aaron Seydel,GER,FW,Darmstadt 98,Bundesliga,27,1996,6.9,3,2,0,2,1,0,3,0.0,3,8,2,6,1,4,9,0
Andres Sfait,ROU,"DF,MF",Salernitana,Serie A,18,2004,0.3,1,1,1,0,0,1,2,50.0,1,0,0,0,0,1,0,0
Stephan El Shaarawy,ITA,"FW,DF",Roma,Serie A,30,1992,19.3,21,13,14,4,3,6,15,40.0,9,11,4,7,13,34,15,2
Luke Shaw,ENG,DF,Manchester Utd,Premier League,28,1995,10.7,11,8,7,3,1,9,15,60.0,6,18,11,7,6,17,39,0
James Shea,ENG,GK,Luton Town,Premier League,32,1991,0.2,0,0,0,0,0,0,0,,0,0,0,0,0,0,2,0
Eldor Shomurodov,UZB,"FW,MF",Cagliari,Serie A,28,1995,10.4,11,4,2,6,3,6,10,60.0,4,5,0,5,4,15,4,0
Steven Shpendi,ALB,"FW,MF",Empoli,Serie A,20,2003,4.6,0,0,0,0,0,0,4,0.0,4,2,1,1,1,1,0,0
Sofiane Sidi Ali,FRA,MF,Marseille,Ligue 1,28,1995,0.2,2,0,0,2,0,1,2,50.0,1,1,0,1,2,4,0,0
Vincent Sierro,SUI,MF,Toulouse,Ligue 1,27,1995,25.1,41,24,15,20,6,27,77,35.1,50,37,13,24,27,68,33,0
Tim Siersleben,GER,DF,Heidenheim,Bundesliga,23,2000,10.1,27,11,21,6,0,8,20,40.0,12,16,10,6,21,48,29,1
Kiliann Sildillia,FRA,DF,Freiburg,Bundesliga,21,2002,20.1,43,19,28,8,7,26,42,61.9,16,33,15,18,22,65,64,0
André Silva,POR,FW,Real Sociedad,La Liga,27,1995,8.1,2,2,0,0,2,0,4,0.0,4,3,0,3,1,3,3,0
Bernardo Silva,POR,"MF,FW",Manchester City,Premier League,28,1994,28.6,51,23,13,25,13,25,57,43.9,32,32,4,28,17,68,15,1
Caio Henrique Oliveira Silva,BRA,DF,Monaco,Ligue 1,26,1997,6.9,13,7,3,7,3,6,9,66.7,3,8,2,6,6,19,9,0
Fábio Silva,POR,FW,Wolves,Premier League,21,2002,2.9,7,4,3,4,0,2,3,66.7,1,1,0,1,2,9,0,0
Rui Silva,POR,GK,Betis,La Liga,29,1994,27.5,0,0,0,0,0,0,3,0.0,3,0,0,0,1,1,13,1
Thiago Silva,BRA,DF,Chelsea,Premier League,38,1984,28.1,29,15,22,6,1,20,34,58.8,14,33,24,9,26,55,153,4
Marco Silvestri,ITA,GK,Udinese,Serie A,32,1991,17.0,0,0,0,0,0,0,3,0.0,3,1,0,1,0,0,5,3
Mohamed Simakan,FRA,DF,RB Leipzig,Bundesliga,23,2000,23.8,48,29,28,19,1,32,44,72.7,12,36,14,22,29,77,69,0
Giovanni Simeone,ARG,FW,Napoli,Serie A,28,1995,8.9,12,4,1,3,8,3,12,25.0,9,11,0,11,1,13,7,0
Giuliano Simeone,ARG,FW,Alavés,La Liga,20,2002,7.0,7,5,2,3,2,5,17,29.4,12,10,0,10,5,12,3,0
Jan-Carlo Simic,SRB,DF,Milan,Serie A,18,2005,1.6,1,1,1,0,0,0,0,,0,5,4,1,0,1,3,0
Moses Simon,NGA,"FW,MF",Nantes,Ligue 1,28,1995,19.9,7,5,2,5,0,2,8,25.0,6,9,1,8,3,10,5,1
Unai Simón,ESP,GK,Athletic Club,La Liga,26,1997,35.4,2,1,1,1,0,2,3,66.7,1,0,0,0,1,3,9,0
Xavi Simons,NED,MF,RB Leipzig,Bundesliga,20,2003,29.5,30,17,10,11,9,15,31,48.4,16,23,0,23,16,46,4,0
Wilfried Singo,CIV,DF,Monaco,Ligue 1,22,2000,24.3,34,25,18,14,2,17,26,65.4,9,27,14,13,51,85,81,2
Luis Sinisterra,COL,"FW,MF",Bournemouth,Premier League,24,1999,7.8,23,12,9,10,4,9,16,56.3,7,18,0,18,8,31,4,0
Daley Sinkgraven,NED,DF,Las Palmas,La Liga,28,1995,4.2,11,5,6,5,0,2,8,25.0,6,5,3,2,6,17,9,0
Jailson Siqueira,BRA,"DF,MF",Celta Vigo,La Liga,27,1995,10.0,27,18,22,5,0,13,24,54.2,11,13,5,8,12,39,32,0
Ayanda Sishuba,BEL,"MF,FW",Lens,Ligue 1,18,2005,0.7,3,1,0,2,1,1,2,50.0,1,1,0,1,0,3,0,0
Ibrahima Sissoko,MLI,MF,Strasbourg,Ligue 1,25,1997,18.2,47,33,13,25,9,23,30,76.7,7,21,8,13,19,66,30,0
Moussa Sissoko,FRA,MF,Nantes,Ligue 1,33,1989,20.2,27,16,13,8,6,12,25,48.0,13,8,2,6,12,39,31,0
Antonio Sivera,ESP,GK,Alavés,La Liga,26,1996,34.0,0,0,0,0,0,0,1,0.0,1,0,0,0,0,0,17,1
Tim Skarke,GER,"FW,DF",Darmstadt 98,Bundesliga,26,1996,26.7,26,16,12,10,4,10,28,35.7,18,25,2,23,6,32,20,0
Ellyes Skhiri,TUN,MF,Eint Frankfurt,Bundesliga,28,1995,24.1,44,24,18,19,7,19,36,52.8,17,33,4,29,39,83,47,2
Oliver Skipp,ENG,"MF,DF",Tottenham,Premier League,22,2000,7.9,18,12,9,6,3,11,18,61.1,7,12,1,11,3,21,9,0
Leo Skiri Østigård,NOR,DF,Napoli,Serie A,23,1999,18.1,24,12,13,10,1,6,11,54.5,5,18,12,6,16,40,65,0
Łukasz Skorupski,POL,GK,Bologna,Serie A,32,1991,32.0,2,2,2,0,0,2,3,66.7,1,0,0,0,1,3,11,3
Robert Skov,DEN,"DF,FW",Hoffenheim,Bundesliga,27,1996,14.0,24,16,15,8,1,17,36,47.2,19,17,4,13,10,34,23,1
Milan Škriniar,SVK,DF,Paris S-G,Ligue 1,28,1995,18.1,24,18,17,7,0,14,22,63.6,8,19,10,9,12,36,51,2
Naatan Skyttä,FIN,"MF,FW",Toulouse,Ligue 1,21,2002,1.3,4,4,2,1,1,1,1,100.0,0,0,0,0,0,4,0,0
Chris Smalling,ENG,DF,Roma,Serie A,33,1989,4.3,1,1,1,0,0,1,4,25.0,3,6,5,1,5,6,8,0
Adam Smith,ENG,DF,Bournemouth,Premier League,32,1991,23.9,37,23,18,11,8,19,39,48.7,20,28,11,17,21,58,62,0
Emile Smith Rowe,ENG,MF,Arsenal,Premier League,23,2000,3.9,4,1,2,2,0,2,4,50.0,2,3,1,2,3,7,1,0
Hrvoje Smolčić,CRO,DF,Eint Frankfurt,Bundesliga,22,2000,3.9,7,3,7,0,0,4,5,80.0,1,3,1,2,6,13,23,1
Cédric Soares,POR,DF,Arsenal,Premier League,31,1991,0.7,0,0,0,0,0,0,0,,0,0,0,0,0,0,0,0
Danilo Soares,BRA,DF,Bochum,Bundesliga,31,1991,3.9,10,6,5,3,2,5,8,62.5,3,6,0,6,7,17,11,0
Eduard Sobol,UKR,DF,Strasbourg,Ligue 1,28,1995,0.3,0,0,0,0,0,0,0,,0,0,0,0,0,0,1,0
Rubén Sobrino,ESP,"MF,FW",Cádiz,La Liga,31,1992,18.3,52,28,18,26,8,22,51,43.1,29,26,2,24,16,68,18,0
Andrea Sodero,ITA,MF,Empoli,Serie A,18,2004,0.1,0,0,0,0,0,0,0,,0,0,0,0,0,0,0,0
Emran Soglo,ENG,"MF,DF",Marseille,Ligue 1,18,2005,1.2,2,1,0,2,0,1,3,33.3,2,6,0,6,1,3,3,0
Alex Sola,ESP,"FW,MF",Alavés,La Liga,24,1999,14.0,27,15,11,9,7,14,26,53.8,12,18,2,16,11,38,16,0
Alex Sola,ESP,"DF,MF",Real Sociedad,La Liga,24,1999,0.3,0,0,0,0,0,0,0,,0,0,0,0,1,1,2,0
Dominic Solanke,ENG,FW,Bournemouth,Premier League,25,1997,36.9,23,11,3,13,7,10,29,34.5,19,24,5,19,7,30,43,0
Ola Solbakken,NOR,FW,Roma,Serie A,24,1998,0.3,0,0,0,0,0,0,0,,0,0,0,0,0,0,0,0
Carlos Soler,ESP,"MF,DF",Paris S-G,Ligue 1,26,1997,12.1,15,10,9,2,4,6,21,28.6,15,10,3,7,5,20,11,1
Jhon Solis,COL,MF,Girona,La Liga,18,2004,4.3,10,8,4,5,1,4,12,33.3,8,8,3,5,8,18,7,1
Manor Solomon,ISR,FW,Tottenham,Premier League,24,1999,2.2,3,3,1,1,1,1,2,50.0,1,4,0,4,3,6,2,0
Daniele Sommariva,ITA,GK,Genoa,Serie A,26,1997,0.1,0,0,0,0,0,0,0,,0,0,0,0,0,0,0,0
Yann Sommer,SUI,GK,Inter,Serie A,34,1988,34.0,2,1,2,0,0,2,2,100.0,0,1,0,1,0,2,7,1
Brandon Soppy,FRA,DF,Torino,Serie A,21,2002,2.0,2,2,1,1,0,2,6,33.3,4,2,0,2,0,2,3,1
David Soria,ESP,GK,Getafe,La Liga,30,1993,37.9,0,0,0,0,0,0,2,0.0,2,0,0,0,0,0,21,6
Alberto Soro,ESP,MF,Granada,La Liga,24,1999,0.1,0,0,0,0,0,0,0,,0,0,0,0,0,0,0,0
Alessandro Sorrentino,ITA,GK,Monza,Serie A,21,2002,6.1,0,0,0,0,0,0,0,,0,0,0,0,0,0,0,0
Borna Sosa,CRO,"FW,DF",Stuttgart,Bundesliga,25,1998,0.5,0,0,0,0,0,0,1,0.0,1,0,0,0,0,0,0,0
Hugo Sotelo,ESP,MF,Celta Vigo,La Liga,19,2003,8.0,19,17,3,13,3,8,20,40.0,12,7,1,6,2,21,5,0
Florian Sotoca,FRA,"MF,FW",Lens,Ligue 1,32,1990,28.9,33,22,9,21,3,17,38,44.7,21,41,4,37,20,53,34,0
Riccardo Sottil,ITA,FW,Fiorentina,Serie A,24,1999,12.3,10,5,5,1,4,3,8,37.5,5,12,0,12,2,12,2,0
Tomáš Souček,CZE,MF,West Ham,Premier League,28,1995,31.9,53,35,24,26,3,21,47,44.7,26,55,28,27,37,90,109,0
Matìas Soulé,ARG,"FW,MF",Frosinone,Serie A,20,2003,34.7,41,27,12,14,15,19,40,47.5,21,38,4,34,18,59,9,0
Boubakary Soumaré,FRA,MF,Sevilla,La Liga,24,1999,25.4,39,28,24,14,1,14,26,53.8,12,25,7,18,26,65,20,1
Issa Soumaré,SEN,"FW,MF",Le Havre,Ligue 1,22,2000,2.6,2,0,2,0,0,0,4,0.0,4,0,0,0,0,2,2,0
Vinicius Souza,BRA,MF,Sheffield Utd,Premier League,24,1999,29.6,125,76,59,51,15,41,74,55.4,33,57,17,40,32,157,75,1
Djibril Sow,SUI,MF,Sevilla,La Liga,26,1997,16.2,28,21,15,8,5,9,25,36.0,16,20,3,17,17,45,8,1
Saidou Sow,GUI,DF,Strasbourg,Ligue 1,21,2002,8.0,20,12,17,3,0,9,13,69.2,4,7,4,3,12,32,36,3
Çağlar Söyüncü,TUR,DF,Atlético Madrid,La Liga,27,1996,1.3,1,1,1,0,0,0,0,,0,1,0,1,1,2,7,0
Djed Spence,ENG,DF,Genoa,Serie A,22,2000,9.5,16,10,12,4,0,8,10,80.0,2,20,5,15,8,24,28,0
Stijn Spierings,NED,MF,Toulouse,Ligue 1,27,1996,16.8,53,40,26,20,7,29,52,55.8,23,22,5,17,26,79,32,0
Stijn Spierings,NED,MF,Lens,Ligue 1,27,1996,1.3,1,0,0,1,0,1,1,100.0,0,2,1,1,2,3,1,0
Leonardo Spinazzola,ITA,DF,Roma,Serie A,30,1993,14.6,15,7,10,5,0,8,18,44.4,10,8,2,6,3,18,15,0
Marco Sportiello,ITA,GK,Milan,Serie A,31,1992,7.0,0,0,0,0,0,0,0,,0,0,0,0,0,0,2,0
Anton Stach,GER,MF,Hoffenheim,Bundesliga,24,1998,25.8,73,42,40,27,6,33,63,52.4,30,38,12,26,72,145,67,1
Anton Stach,GER,MF,Mainz 05,Bundesliga,24,1998,1.9,3,0,2,0,1,2,4,50.0,2,5,0,5,2,5,5,0
Jens Stage,DEN,MF,Werder Bremen,Bundesliga,26,1996,25.9,52,22,21,23,8,18,50,36.0,32,42,23,19,23,75,55,0
Benjamin Stambouli,FRA,MF,Reims,Ligue 1,32,1990,3.2,9,7,3,5,1,6,11,54.5,5,3,1,2,2,11,8,0
Josip Stanišić,CRO,DF,Leverkusen,Bundesliga,23,2000,14.0,38,20,19,13,6,22,33,66.7,11,18,3,15,9,47,26,0
Carl Starfelt,SWE,DF,Celta Vigo,La Liga,28,1995,24.6,36,30,30,5,1,19,28,67.9,9,35,28,7,34,70,159,2
Niklas Stark,GER,DF,Werder Bremen,Bundesliga,28,1995,12.1,26,15,13,11,2,12,18,66.7,6,14,7,7,19,45,61,1
Jason Steele,ENG,GK,Brighton,Premier League,32,1990,17.0,0,0,0,0,0,0,3,0.0,3,0,0,0,0,0,8,1
Pascal Stenzel,GER,DF,Stuttgart,Bundesliga,27,1996,11.8,18,8,7,9,2,10,30,33.3,20,22,8,14,15,33,26,0
Leonidas Stergiou,SUI,DF,Stuttgart,Bundesliga,21,2002,6.6,15,8,7,7,1,9,13,69.2,4,8,1,7,5,20,13,0
Raheem Sterling,ENG,"FW,MF",Chelsea,Premier League,28,1994,22.0,21,10,7,8,6,12,26,46.2,14,13,0,13,13,34,9,1
Trivante Stewart,JAM,"FW,MF",Salernitana,Serie A,23,2000,1.1,0,0,0,0,0,0,0,,0,1,0,1,0,0,0,0
Angelo Stiller,GER,MF,Hoffenheim,Bundesliga,22,2001,0.9,0,0,0,0,0,0,1,0.0,1,2,0,2,0,0,3,0
Angelo Stiller,GER,MF,Stuttgart,Bundesliga,22,2001,29.9,55,33,15,34,6,24,42,57.1,18,41,13,28,28,83,25,2
Kevin Stöger,AUT,MF,Bochum,Bundesliga,29,1993,29.6,49,30,21,21,7,25,63,39.7,38,46,4,42,19,68,18,0
Filip Stojilković,SUI,"FW,MF",Darmstadt 98,Bundesliga,23,2000,1.7,1,1,0,0,1,0,0,,0,0,0,0,0,1,1,0
John Stones,ENG,"DF,MF",Manchester City,Premier League,29,1994,11.8,2,1,1,0,1,0,3,0.0,3,11,7,4,10,12,21,0
Thomas Strakosha,ALB,GK,Brentford,Premier League,28,1995,1.5,0,0,0,0,0,0,0,,0,0,0,0,0,0,0,0
Jørgen Strand Larsen,NOR,FW,Celta Vigo,La Liga,23,2000,31.8,21,11,1,15,5,8,38,21.1,30,15,1,14,5,26,17,0
Gabriel Strefezza,BRA,FW,Lecce,Serie A,26,1997,12.4,24,17,8,7,9,14,20,70.0,6,17,0,17,7,31,11,0
Kevin Strootman,NED,MF,Genoa,Serie A,33,1990,13.4,34,19,13,18,3,15,31,48.4,16,20,6,14,7,41,22,0
Cristhian Stuani,URU,FW,Girona,La Liga,36,1986,8.9,14,11,4,6,4,4,7,57.1,3,9,2,7,5,19,13,0
Álex Suárez,ESP,DF,Las Palmas,La Liga,30,1993,28.5,53,36,33,15,5,31,37,83.8,6,33,14,19,18,71,84,0
Damián Suárez,URU,DF,Getafe,La Liga,35,1988,14.4,36,21,16,16,4,26,45,57.8,19,13,3,10,10,46,31,0
Denis Suárez,ESP,"MF,FW",Villarreal,La Liga,29,1994,1.5,0,0,0,0,0,0,2,0.0,2,2,2,0,0,0,4,0
Gabriel Suazo,CHI,DF,Toulouse,Ligue 1,25,1997,26.2,66,32,40,19,7,38,86,44.2,48,37,4,33,26,92,33,0
Isaac Success,NGA,"FW,MF",Udinese,Serie A,27,1996,9.8,6,4,0,5,1,1,3,33.3,2,6,1,5,2,8,11,0
Niklas Süle,GER,DF,Dortmund,Bundesliga,27,1995,16.8,18,10,14,3,1,11,16,68.8,5,25,14,11,25,43,58,2
Ibrahim Sulemana,GHA,MF,Cagliari,Serie A,20,2003,14.9,36,14,15,15,6,17,27,63.0,10,24,5,19,7,43,23,0
Tomáš Suslov,SVK,"MF,FW",Hellas Verona,Serie A,21,2002,23.2,42,30,11,22,9,15,47,31.9,32,15,0,15,6,48,8,0
Suso,ESP,"MF,FW",Sevilla,La Liga,29,1993,16.9,24,17,14,8,2,8,28,28.6,20,9,0,9,5,29,4,0
Mattias Svanberg,SWE,MF,Wolfsburg,Bundesliga,24,1999,19.1,37,17,8,19,10,12,38,31.6,26,25,5,20,21,58,28,0
Max Svensson,ESP,FW,Osasuna,La Liga,,,0.0,1,0,0,0,1,0,0,,0,0,0,0,0,1,0,0
Mile Svilar,SRB,GK,Roma,Serie A,23,1999,15.0,0,0,0,0,0,0,0,,0,0,0,0,0,0,2,1
Williot Swedberg,SWE,"FW,MF",Celta Vigo,La Liga,19,2004,4.9,9,4,3,6,0,5,8,62.5,3,11,1,10,0,9,4,0
Karol Świderski,POL,"FW,MF",Hellas Verona,Serie A,26,1997,5.6,7,3,1,3,3,2,3,66.7,1,6,4,2,1,8,8,0
Abakar Sylla,CIV,DF,Strasbourg,Ligue 1,20,2002,19.9,54,23,30,19,5,29,40,72.5,11,40,11,29,26,80,70,2
Dembo Sylla,GUI,DF,Lorient,Ligue 1,20,2002,0.5,1,1,0,1,0,0,0,,0,0,0,0,1,2,2,0
Issiaga Sylla,GUI,"DF,FW",Montpellier,Ligue 1,29,1994,16.2,28,17,20,6,2,16,34,47.1,18,21,7,14,23,51,53,0
Mamadou Sylla,SEN,"FW,MF",Alavés,La Liga,29,1994,0.2,0,0,0,0,0,0,0,,0,1,1,0,0,0,1,0
Attila Szalai,HUN,DF,Hoffenheim,Bundesliga,25,1998,3.2,3,1,3,0,0,1,4,25.0,3,6,2,4,1,4,7,0
Attila Szalai,HUN,DF,Freiburg,Bundesliga,25,1998,1.1,1,1,1,0,0,1,2,50.0,1,5,2,3,1,2,11,1
Wojciech Szczęsny,POL,GK,Juventus,Serie A,33,1990,35.0,0,0,0,0,0,0,0,,0,0,0,0,1,1,11,2
Dominik Szoboszlai,HUN,MF,Liverpool,Premier League,22,2000,23.4,32,19,12,12,8,16,50,32.0,34,37,2,35,15,47,16,1
Przemysław Szymiński,POL,MF,Frosinone,Serie A,29,1994,0.1,0,0,0,0,0,0,0,,0,1,1,0,0,0,0,0
Alexander Sørloth,NOR,FW,Villarreal,La Liga,27,1995,27.7,6,3,1,2,3,2,6,33.3,4,9,4,5,0,6,26,0
Musa Al-Taamari,JOR,FW,Montpellier,Ligue 1,26,1997,21.4,20,16,10,5,5,9,21,42.9,12,18,2,16,4,24,5,0
Nicolás Tagliafico,ARG,DF,Lyon,Ligue 1,30,1992,23.6,54,34,23,22,9,22,49,44.9,27,25,8,17,28,82,43,0
Jonathan Tah,GER,DF,Leverkusen,Bundesliga,27,1996,29.2,19,9,10,7,2,5,16,31.3,11,28,23,5,23,42,97,1
Montassar Talbi,TUN,DF,Lorient,Ligue 1,25,1998,24.5,38,22,23,13,2,19,32,59.4,13,39,23,16,32,70,114,0
Yassin Tallal,ESP,FW,Getafe,La Liga,18,2005,0.0,0,0,0,0,0,0,0,,0,0,0,0,0,0,0,0
Adrien Tameze,CMR,"DF,MF",Torino,Serie A,29,1994,23.8,35,16,13,18,4,18,37,48.6,19,24,11,13,47,82,25,2
Renato Tapia,PER,"MF,DF",Celta Vigo,La Liga,28,1995,14.9,41,29,19,19,3,14,25,56.0,11,31,7,24,21,62,50,1
Edmond Tapsoba,BFA,DF,Leverkusen,Bundesliga,24,1999,23.2,34,25,17,15,2,17,24,70.8,7,21,10,11,24,58,52,3
Matt Targett,ENG,DF,Newcastle Utd,Premier League,27,1995,0.9,2,0,1,1,0,1,1,100.0,0,1,0,1,0,2,2,0
Oussama Targhalline,MAR,MF,Le Havre,Ligue 1,21,2002,11.4,23,11,16,7,0,15,25,60.0,10,9,3,6,20,43,14,2
James Tarkowski,ENG,DF,Everton,Premier League,30,1992,38.0,61,42,46,14,1,27,48,56.3,21,82,56,26,56,117,191,2
César Tárrega,ESP,DF,Valencia,La Liga,21,2002,0.1,0,0,0,0,0,0,0,,0,0,0,0,0,0,2,0
Jimi Tauriainen,ENG,FW,Chelsea,Premier League,19,2004,0.0,0,0,0,0,0,0,0,,0,0,0,0,0,0,0,0
Nuno Tavares,POR,DF,Nott'ham Forest,Premier League,23,2000,5.1,11,7,9,1,1,8,9,88.9,1,6,0,6,1,12,21,0
Marcus Tavernier,ENG,FW,Bournemouth,Premier League,24,1999,23.5,53,34,25,22,6,26,48,54.2,22,31,3,28,5,58,23,0
Elayis Tavsan,NED,"MF,FW",Hellas Verona,Serie A,22,2001,0.6,0,0,0,0,0,0,1,0.0,1,0,0,0,0,0,1,0
Charlie Taylor,ENG,DF,Burnley,Premier League,29,1993,25.9,35,20,19,14,2,17,35,48.6,18,27,11,16,19,54,78,0
Marciano Tchami,GNB,"FW,MF",Almería,La Liga,19,2004,0.5,0,0,0,0,0,0,0,,0,0,0,0,0,0,0,0
Loum Tchaouna,FRA,"FW,MF",Salernitana,Serie A,19,2003,23.3,20,10,5,13,2,10,20,50.0,10,20,1,19,4,24,16,1
Jackson Tchatchoua,CMR,DF,Hellas Verona,Serie A,21,2001,19.2,39,26,25,12,2,23,48,47.9,25,17,7,10,23,62,49,2
Enzo Tchato,CMR,DF,Montpellier,Ligue 1,20,2002,12.5,26,17,18,4,4,11,25,44.0,14,20,7,13,11,37,25,0
Aurélien Tchouaméni,FRA,"MF,DF",Real Madrid,La Liga,23,2000,22.1,38,23,19,17,2,9,18,50.0,9,21,13,8,28,66,52,1
Mathys Tel,FRA,"FW,MF",Bayern Munich,Bundesliga,18,2005,11.7,12,2,3,4,5,4,6,66.7,2,11,0,11,6,18,6,0
Nathan Tella,NGA,"DF,MF",Leverkusen,Bundesliga,24,1999,9.1,13,8,6,5,2,5,10,50.0,5,10,0,10,3,16,8,0
Nahuel Tenaglia,ARG,DF,Alavés,La Liga,27,1996,12.7,29,19,22,4,3,16,28,57.1,12,14,8,6,12,41,59,0
Arnau Tenas,ESP,GK,Paris S-G,Ligue 1,22,2001,5.9,0,0,0,0,0,0,0,,0,0,0,0,0,0,0,0
Marc-André ter Stegen,GER,GK,Barcelona,La Liga,31,1992,28.0,0,0,0,0,0,0,0,,0,0,0,0,0,0,3,3
Filippo Terracciano,ITA,DF,Hellas Verona,Serie A,20,2003,14.4,30,19,23,6,1,17,31,54.8,14,24,6,18,20,50,17,0
Filippo Terracciano,ITA,"DF,FW",Milan,Serie A,20,2003,0.8,2,2,1,1,0,1,3,33.3,2,3,0,3,0,2,1,0
Pietro Terracciano,ITA,GK,Fiorentina,Serie A,33,1990,33.0,1,1,1,0,0,1,3,33.3,2,1,0,1,0,1,8,0
Ramón Terrats,ESP,"MF,DF",Villarreal,La Liga,22,2000,8.7,17,13,8,8,1,7,15,46.7,8,11,1,10,3,20,9,0
Martin Terrier,FRA,"FW,MF",Rennes,Ligue 1,26,1997,17.0,14,9,3,8,3,6,14,42.9,8,21,4,17,9,23,17,0
Kenny Tete,NED,DF,Fulham,Premier League,27,1995,9.6,27,17,19,6,2,11,19,57.9,8,10,3,7,16,43,35,0
Benjamin Tetteh,GHA,"FW,MF",Metz,Ligue 1,26,1997,3.1,6,6,1,5,0,4,7,57.1,3,0,0,0,0,6,1,0
Teddy Teuma,MLT,MF,Reims,Ligue 1,29,1993,23.5,54,36,19,21,14,25,62,40.3,37,33,4,29,20,74,6,0
Florian Thauvin,FRA,FW,Udinese,Serie A,30,1993,19.0,7,4,2,4,1,4,13,30.8,9,9,1,8,3,10,2,0
Arthur Theate,BEL,DF,Rennes,Ligue 1,23,2000,25.5,30,17,19,6,5,24,37,64.9,13,40,23,17,31,61,90,2
Norman Theuerkauf,GER,"MF,DF",Heidenheim,Bundesliga,36,1987,14.0,24,16,13,7,4,13,22,59.1,9,16,6,10,14,38,21,0
Malick Thiaw,GER,DF,Milan,Serie A,21,2001,18.0,34,17,15,17,2,12,25,48.0,13,23,13,10,13,47,55,0
Jan Thielmann,GER,"FW,DF",Köln,Bundesliga,21,2002,17.5,28,18,13,9,6,12,24,50.0,12,31,6,25,8,36,28,0
Denis Thomalla,GER,"MF,FW",Heidenheim,Bundesliga,30,1992,5.0,9,6,4,4,1,5,11,45.5,6,3,2,1,4,13,13,0
Luke Thomas,ENG,DF,Sheffield Utd,Premier League,22,2001,10.2,20,9,13,6,1,8,14,57.1,6,23,5,18,10,30,27,0
Adrien Thomasson,FRA,MF,Lens,Ligue 1,29,1993,13.3,25,14,4,16,5,11,34,32.4,23,14,0,14,9,34,10,1
Morten Thorsby,NOR,MF,Genoa,Serie A,27,1996,12.9,19,11,9,8,2,7,14,50.0,7,21,5,16,4,23,20,0
Kristian Thorstvedt,NOR,MF,Sassuolo,Serie A,24,1999,26.6,40,22,7,28,5,22,44,50.0,22,25,9,16,21,61,36,0
Khéphren Thuram,FRA,MF,Nice,Ligue 1,22,2001,23.4,42,29,13,23,6,20,40,50.0,20,21,10,11,18,60,37,0
Marcus Thuram,FRA,FW,Inter,Serie A,25,1997,29.9,23,15,9,9,5,4,13,30.8,9,26,3,23,4,27,19,0
Cheikh Tidiane Sabaly,SEN,"FW,MF",Metz,Ligue 1,24,1999,15.3,40,20,23,12,5,16,40,40.0,24,19,2,17,10,50,14,0
Youri Tielemans,BEL,"MF,FW",Aston Villa,Premier League,26,1997,18.0,41,20,17,18,6,16,40,40.0,24,23,3,20,15,56,9,0
Kieran Tierney,SCO,DF,Real Sociedad,La Liga,26,1997,13.8,37,24,16,18,3,18,27,66.7,9,22,8,14,10,47,45,0
Phillip Tietz,GER,FW,Augsburg,Bundesliga,26,1997,26.5,23,14,7,13,3,6,15,40.0,9,17,3,14,6,29,35,0
Steffen Tigges,GER,FW,Köln,Bundesliga,25,1998,8.1,10,6,4,5,1,3,7,42.9,4,4,2,2,1,11,12,0
Antonio Tikvić,CRO,DF,Udinese,Serie A,19,2004,0.0,0,0,0,0,0,0,0,,0,0,0,0,0,0,0,0
Jurriën Timber,NED,DF,Arsenal,Premier League,22,2001,0.8,2,2,1,1,0,0,0,,0,1,0,1,0,2,1,0
Jean-Clair Todibo,FRA,DF,Nice,Ligue 1,23,1999,29.5,58,28,35,17,6,34,56,60.7,22,34,15,19,38,96,97,1
Harry Toffolo,ENG,DF,Nott'ham Forest,Premier League,27,1995,16.2,26,14,20,6,0,15,24,62.5,9,34,13,21,14,40,49,0
Umut Tohumcu,GER,MF,Hoffenheim,Bundesliga,18,2004,11.2,16,12,9,7,0,6,19,31.6,13,11,1,10,6,22,12,0
Corentin Tolisso,FRA,MF,Lyon,Ligue 1,28,1994,19.3,33,21,13,11,9,14,33,42.4,19,26,9,17,10,43,18,0
Jeremy Toljan,GER,DF,Sassuolo,Serie A,28,1994,23.1,13,10,8,4,1,9,15,60.0,6,17,5,12,16,29,49,1
Rafael Tolói,ITA,DF,Atalanta,Serie A,32,1990,10.7,20,9,7,8,5,14,27,51.9,13,9,4,5,13,33,29,0
Raúl de Tomás,ESP,FW,Rayo Vallecano,La Liga,28,1994,14.1,9,5,4,3,2,3,6,50.0,3,3,0,3,1,10,8,0
Tiago Tomás,POR,"FW,MF",Wolfsburg,Bundesliga,21,2002,11.5,5,2,3,0,2,1,6,16.7,5,13,0,13,3,8,9,0
Takehiro Tomiyasu,JPN,DF,Arsenal,Premier League,24,1998,12.8,20,9,15,4,1,11,18,61.1,7,10,4,6,18,38,33,0
James Tomkins,ENG,DF,Crystal Palace,Premier League,34,1989,0.1,0,0,0,0,0,0,0,,0,0,0,0,1,1,0,0
Fikayo Tomori,ENG,DF,Milan,Serie A,25,1997,23.6,42,24,29,10,3,18,29,62.1,11,34,23,11,26,68,75,1
Sandro Tonali,ITA,MF,Newcastle Utd,Premier League,23,2000,4.9,7,7,4,2,1,3,9,33.3,6,3,0,3,2,9,4,0
Ivan Toney,ENG,FW,Brentford,Premier League,27,1996,16.1,15,5,2,7,6,6,14,42.9,8,5,1,4,10,25,18,0
Pablo Torre,ESP,"MF,FW",Girona,La Liga,20,2003,7.8,5,2,0,5,0,4,10,40.0,6,10,2,8,4,9,6,1
Raúl Torrente,ESP,DF,Granada,La Liga,21,2001,13.9,29,16,20,9,0,17,22,77.3,5,16,10,6,11,40,68,2
Ferrán Torres,ESP,FW,Barcelona,La Liga,23,2000,13.5,9,6,1,6,2,5,16,31.3,11,7,1,6,5,14,6,0
Óliver Torres,ESP,MF,Sevilla,La Liga,28,1994,18.0,37,22,17,15,5,22,57,38.6,35,40,4,36,6,43,6,0
Pau Torres,ESP,DF,Aston Villa,Premier League,26,1997,27.4,29,18,17,11,1,14,30,46.7,16,28,12,16,14,43,75,0
Lucas Torró,ESP,MF,Osasuna,La Liga,29,1994,19.9,25,15,11,8,6,11,28,39.3,17,10,2,8,33,58,37,0
Fabio Torsiello,ITA,"FW,DF",Darmstadt 98,Bundesliga,18,2005,1.7,1,0,1,0,0,1,8,12.5,7,1,0,1,1,2,1,0
Ahmed Touba,ALG,DF,Lecce,Serie A,25,1998,3.1,6,4,3,3,0,3,4,75.0,1,4,3,1,7,13,20,0
Abdoulaye Touré,GUI,MF,Le Havre,Ligue 1,29,1994,25.4,47,28,22,22,3,30,60,50.0,30,30,8,22,25,72,33,0
Souleymane Touré,FRA,DF,Lorient,Ligue 1,20,2003,22.8,25,12,16,9,0,8,14,57.1,6,38,20,18,36,61,101,2
Lucas Tousart,FRA,MF,Union Berlin,Bundesliga,26,1997,17.5,35,20,14,17,4,17,37,45.9,20,32,9,23,25,60,41,0
Andros Townsend,ENG,"MF,FW",Luton Town,Premier League,32,1991,13.4,21,13,11,2,8,13,27,48.1,14,12,0,12,5,26,10,0
James Trafford,ENG,GK,Burnley,Premier League,20,2002,28.0,2,1,2,0,0,2,2,100.0,0,0,0,0,1,3,18,1
Adama Traoré,ESP,"FW,MF",Fulham,Premier League,27,1996,4.2,4,3,1,2,1,3,6,50.0,3,2,0,2,1,5,2,0
Bénie Traoré,CIV,"FW,MF",Sheffield Utd,Premier League,20,2002,4.3,4,2,1,2,1,0,4,0.0,4,4,1,3,1,5,1,0
Bénie Traoré,CIV,"FW,MF",Nantes,Ligue 1,20,2002,5.6,8,4,2,5,1,3,7,42.9,4,3,0,3,1,9,1,0
Bertrand Traoré,BFA,"DF,FW",Aston Villa,Premier League,27,1995,0.1,1,1,1,0,0,0,0,,0,0,0,0,0,1,1,0
Bertrand Traoré,BFA,MF,Villarreal,La Liga,27,1995,6.3,5,4,2,1,2,1,4,25.0,3,6,0,6,1,6,2,0
Boubacar Traoré,MLI,MF,Wolves,Premier League,21,2001,9.1,35,23,16,17,2,9,21,42.9,12,12,2,10,5,40,7,0
Chaka Traorè,CIV,FW,Milan,Serie A,18,2004,0.2,2,1,2,0,0,1,2,50.0,1,1,1,0,0,2,0,0
Daouda Traoré,FRA,MF,Nice,Ligue 1,17,2006,0.2,0,0,0,0,0,0,0,,0,0,0,0,0,0,0,0
Hamari Traoré,MLI,DF,Real Sociedad,La Liga,31,1992,25.5,44,19,24,17,3,25,43,58.1,18,27,8,19,24,68,59,2
Ismaël Traoré,CIV,DF,Metz,Ligue 1,36,1986,24.7,19,12,13,6,0,8,21,38.1,13,33,20,13,30,49,86,0
Omar Traoré,GER,DF,Heidenheim,Bundesliga,25,1998,27.5,60,33,33,21,6,32,56,57.1,24,32,7,25,40,100,54,1
Kevin Trapp,GER,GK,Eint Frankfurt,Bundesliga,33,1990,32.0,0,0,0,0,0,0,0,,0,0,0,0,1,1,9,1
Mark Travers,IRL,GK,Bournemouth,Premier League,24,1999,4.0,0,0,0,0,0,0,0,,0,0,0,0,0,0,2,0
Óscar Trejo,ARG,"FW,MF",Rayo Vallecano,La Liga,35,1988,15.3,27,15,11,9,7,13,21,61.9,8,21,1,20,5,32,9,0
Mike Trésor,BEL,"FW,MF",Burnley,Premier League,24,1999,4.7,10,6,9,1,0,8,18,44.4,10,5,0,5,1,11,1,0
Manu Trigueros,ESP,MF,Villarreal,La Liga,31,1991,3.4,7,5,6,1,0,4,10,40.0,6,1,1,0,3,10,9,0
Christopher Trimmel,AUT,DF,Union Berlin,Bundesliga,36,1987,18.3,23,15,12,10,1,13,33,39.4,20,16,3,13,13,36,57,0
Kieran Trippier,ENG,DF,Newcastle Utd,Premier League,32,1990,24.8,57,27,30,16,11,37,77,48.1,40,41,8,33,24,81,57,3
Leandro Trossard,BEL,"FW,MF",Arsenal,Premier League,28,1994,18.3,27,16,8,9,10,9,25,36.0,16,27,1,26,8,35,6,0
Adrien Truffert,FRA,DF,Rennes,Ligue 1,21,2001,23.8,39,21,23,10,6,25,40,62.5,15,31,5,26,19,58,49,0
Auston Trusty,USA,DF,Sheffield Utd,Premier League,24,1998,28.6,47,30,31,13,3,21,43,48.8,22,41,22,19,35,82,153,3
Kostas Tsimikas,GRE,DF,Liverpool,Premier League,27,1996,7.5,19,13,9,6,4,9,15,60.0,6,9,1,8,6,25,10,0
Viktor Tsyhankov,UKR,"MF,FW",Girona,La Liga,25,1997,22.8,29,20,11,13,5,14,26,53.8,12,18,1,17,12,41,24,0
Stefano Turati,ITA,GK,Frosinone,Serie A,21,2001,30.5,0,0,0,0,0,0,0,,0,0,0,0,0,0,6,3
Matt Turner,USA,GK,Nott'ham Forest,Premier League,29,1994,17.0,0,0,0,0,0,0,0,,0,0,0,0,0,0,8,4
Beñat Turrientes,ESP,MF,Real Sociedad,La Liga,21,2002,18.7,31,17,6,20,5,13,30,43.3,17,19,8,11,6,37,17,0
Tuta,BRA,DF,Eint Frankfurt,Bundesliga,24,1999,28.9,63,33,38,19,6,39,59,66.1,20,29,12,17,36,99,99,0
Destiny Udogie,ITA,DF,Tottenham,Premier League,20,2002,26.6,68,33,41,16,11,27,49,55.1,22,27,8,19,37,105,80,5
Matthieu Udol,FRA,DF,Metz,Ligue 1,27,1996,30.0,55,37,38,12,5,38,56,67.9,18,62,16,46,50,105,108,0
Manuel Ugarte Ribeiro,URU,MF,Paris S-G,Ligue 1,22,2001,21.5,98,57,39,43,16,43,89,48.3,46,27,6,21,40,138,25,2
Lesley Ugochukwu,FRA,MF,Chelsea,Premier League,19,2004,3.3,14,10,4,8,2,4,10,40.0,6,6,2,4,1,15,5,0
Lukas Ullrich,GER,"DF,FW",Gladbach,Bundesliga,19,2004,0.5,1,0,1,0,0,1,4,25.0,3,0,0,0,0,1,1,0
Sven Ulreich,GER,GK,Bayern Munich,Bundesliga,34,1988,11.0,1,0,1,0,0,1,1,100.0,0,0,0,0,0,1,3,2
Samuel Umtiti,FRA,DF,Lille,Ligue 1,29,1993,2.1,1,1,0,1,0,1,4,25.0,3,0,0,0,2,3,4,0
Enes Ünal,TUR,"FW,MF",Bournemouth,Premier League,26,1997,3.6,6,4,2,3,1,2,5,40.0,3,4,2,2,1,7,6,0
Enes Ünal,TUR,"FW,MF",Getafe,La Liga,26,1997,1.6,0,0,0,0,0,0,0,,0,1,0,1,0,0,2,0
Deniz Undav,GER,"FW,MF",Stuttgart,Bundesliga,27,1996,23.2,28,13,6,8,14,4,15,26.7,11,17,0,17,6,34,5,0
Dayot Upamecano,FRA,DF,Bayern Munich,Bundesliga,24,1998,19.6,34,21,21,11,2,15,29,51.7,14,19,7,12,19,53,56,3
Kacper Urbanski,POL,"MF,FW",Bologna,Serie A,18,2004,10.3,16,10,5,10,1,6,13,46.2,7,15,1,14,4,20,14,0
Mark Uth,GER,"MF,FW",Köln,Bundesliga,31,1991,4.1,8,4,2,3,3,4,12,33.3,8,6,0,6,1,9,2,0
Myrto Uzuni,ALB,FW,Granada,La Liga,28,1995,27.2,18,14,8,7,3,6,27,22.2,21,19,3,16,4,22,7,0
Josha Vagnoman,GER,DF,Stuttgart,Bundesliga,22,2000,13.1,28,18,15,11,2,15,30,50.0,15,11,5,6,2,30,16,1
Óscar Valentín,ESP,MF,Rayo Vallecano,La Liga,28,1994,29.9,107,66,39,62,6,46,101,45.5,55,62,10,52,35,142,52,1
Emanuele Valeri,ITA,DF,Frosinone,Serie A,24,1998,13.1,19,16,10,5,4,10,21,47.6,11,14,3,11,9,28,22,0
Martin Valjent,SVK,DF,Mallorca,La Liga,27,1995,26.1,34,18,19,13,2,18,30,60.0,12,26,11,15,29,63,112,1
Jesús Vallejo,ESP,DF,Granada,La Liga,26,1997,1.2,3,1,1,2,0,2,2,100.0,0,3,2,1,0,3,1,1
Álvaro Vallés,ESP,GK,Las Palmas,La Liga,26,1997,36.3,3,2,3,0,0,3,8,37.5,5,0,0,0,0,3,40,1
Federico Valverde,URU,MF,Real Madrid,La Liga,25,1998,32.3,47,34,22,13,12,24,42,57.1,18,39,2,37,43,90,40,0
Kévin Van Den Kerkhof,ALG,"FW,MF",Metz,Ligue 1,27,1996,21.3,31,24,11,13,7,13,32,40.6,19,15,2,13,11,42,32,1
Siebe Van Der Heyden,BEL,DF,Mallorca,La Liga,25,1998,3.2,9,2,7,2,0,4,6,66.7,2,1,1,0,7,16,12,0
Virgil van Dijk,NED,DF,Liverpool,Premier League,32,1991,35.3,40,23,24,13,3,12,14,85.7,2,47,34,13,39,79,144,0
Vanderson,BRA,DF,Monaco,Ligue 1,22,2001,18.2,60,41,20,30,10,32,70,45.7,38,29,2,27,35,95,37,1
Raphaël Varane,FRA,DF,Manchester Utd,Premier League,30,1993,15.3,18,11,10,7,1,10,14,71.4,4,23,18,5,15,33,88,0
Ruben Vargas,SUI,"MF,FW",Augsburg,Bundesliga,24,1998,21.8,23,10,6,10,7,10,25,40.0,15,19,4,15,7,30,17,0
Johan Vásquez,MEX,DF,Genoa,Serie A,24,1998,31.7,51,33,38,11,2,32,50,64.0,18,50,26,24,45,96,113,0
José Luis García Vayá,ESP,MF,Valencia,La Liga,24,1998,36.7,78,53,36,36,6,37,71,52.1,34,41,10,31,49,127,71,0
Borja Vázquez,ESP,FW,Cádiz,La Liga,18,2005,0.0,1,0,1,0,0,1,1,100.0,0,0,0,0,0,1,1,0
Jesus Vazquez,ESP,"DF,MF",Valencia,La Liga,20,2003,8.0,24,12,13,8,3,10,16,62.5,6,17,4,13,3,27,24,0
Kevin Vázquez,ESP,DF,Celta Vigo,La Liga,30,1993,7.8,15,13,7,7,1,12,21,57.1,9,11,3,8,5,20,25,0
Lucas Vázquez,ESP,DF,Real Madrid,La Liga,32,1991,15.8,37,25,22,14,1,18,25,72.0,7,27,5,22,12,49,36,0
Matías Vecino,URU,MF,Lazio,Serie A,31,1991,12.8,32,17,12,20,0,20,31,64.5,11,17,5,12,12,44,21,0
Gabriel Veiga,ESP,FW,Celta Vigo,La Liga,21,2002,0.2,0,0,0,0,0,0,0,,0,0,0,0,0,0,0,0
Alejo Véliz,ARG,FW,Tottenham,Premier League,19,2003,0.6,1,0,1,0,0,0,0,,0,0,0,0,0,1,0,0
Alejo Véliz,ARG,FW,Sevilla,La Liga,19,2003,0.4,1,0,0,1,0,1,2,50.0,1,0,0,0,0,1,1,0
Miloš Veljković,SRB,DF,Werder Bremen,Bundesliga,27,1995,21.3,31,15,17,13,1,16,31,51.6,15,31,20,11,17,48,57,0
Joël Veltman,NED,DF,Brighton,Premier League,31,1992,17.6,54,41,32,17,5,39,58,67.2,19,17,7,10,18,72,57,1
Micky van de Ven,NED,DF,Tottenham,Premier League,22,2001,26.0,49,35,34,12,3,24,33,72.7,9,25,15,10,18,67,78,1
Lorenzo Venuti,ITA,DF,Lecce,Serie A,28,1995,4.0,6,4,5,1,0,6,10,60.0,4,4,3,1,5,11,14,0
Bart Verbruggen,NED,GK,Brighton,Premier League,20,2002,21.0,1,1,1,0,0,1,2,50.0,1,0,0,0,0,1,11,3
Simone Verdi,ITA,FW,Torino,Serie A,31,1992,0.0,0,0,0,0,0,0,0,,0,0,0,0,0,0,0,0
Jordan Veretout,FRA,MF,Marseille,Ligue 1,30,1993,24.3,38,22,19,13,6,18,39,46.2,21,20,4,16,13,51,25,0
Arthur Vermeeren,BEL,MF,Atlético Madrid,La Liga,18,2005,1.8,1,0,0,1,0,0,1,0.0,1,5,0,5,6,7,2,0
Yorbe Vertessen,BEL,"FW,MF",Union Berlin,Bundesliga,22,2001,6.6,3,2,0,3,0,1,4,25.0,3,8,0,8,1,4,3,0
Mikel Vesga,ESP,MF,Athletic Club,La Liga,30,1993,17.0,40,20,11,23,6,19,49,38.8,30,19,7,12,32,72,35,1
Guglielmo Vicario,ITA,GK,Tottenham,Premier League,26,1996,38.0,0,0,0,0,0,0,1,0.0,1,0,0,0,1,1,31,2
Carlos Vicente,ESP,FW,Alavés,La Liga,24,1999,12.4,16,6,7,7,2,10,25,40.0,15,4,0,4,4,20,9,0
Nacho Vidal,ESP,"DF,FW",Osasuna,La Liga,28,1995,1.1,5,4,2,2,1,2,5,40.0,3,2,0,2,0,5,6,0
Nacho Vidal,ESP,DF,Mallorca,La Liga,28,1995,4.6,12,5,4,5,3,6,13,46.2,7,5,2,3,3,15,9,0
Fabio Vieira,POR,"MF,FW",Arsenal,Premier League,23,2000,3.3,3,2,2,0,1,3,3,100.0,0,0,0,0,2,5,2,0
Fran Vieites,ESP,GK,Betis,La Liga,24,1999,3.5,1,0,1,0,0,1,1,100.0,0,0,0,0,0,1,2,1
Jonathan Viera,ESP,"MF,FW",Las Palmas,La Liga,33,1989,6.9,6,3,1,2,3,1,9,11.1,8,0,0,0,0,6,1,0
Jonathan Viera,ESP,MF,Almería,La Liga,33,1989,10.1,19,9,6,9,4,10,19,52.6,9,4,0,4,4,23,1,0
Emanuel Vignato,ITA,"MF,FW",Salernitana,Serie A,22,2000,3.5,10,7,4,5,1,5,6,83.3,1,1,0,1,1,11,7,0
Samuele Vignato,ITA,"MF,FW",Monza,Serie A,19,2004,3.8,6,4,2,3,1,2,3,66.7,1,2,0,2,1,7,1,0
Oscar Vilhelmsson,SWE,"FW,MF",Darmstadt 98,Bundesliga,19,2003,15.3,13,6,3,7,3,7,10,70.0,3,15,5,10,3,16,19,0
Toni Villa,ESP,FW,Girona,La Liga,28,1995,0.1,0,0,0,0,0,0,0,,0,0,0,0,0,0,0,0
Asier Villalibre,ESP,FW,Athletic Club,La Liga,25,1997,5.7,2,1,0,0,2,2,2,100.0,0,2,1,1,0,2,6,0
Gonzalo Villar,ESP,MF,Granada,La Liga,25,1998,20.0,51,33,26,20,5,26,41,63.4,15,32,10,22,6,57,26,1
Iván Villar,ESP,GK,Celta Vigo,La Liga,26,1997,11.3,0,0,0,0,0,0,1,0.0,1,0,0,0,0,0,6,0
Matías Viña,URU,DF,Sassuolo,Serie A,25,1997,11.3,34,21,22,7,5,20,36,55.6,16,12,2,10,9,43,34,0
Rúben Vinagre,POR,"DF,FW",Hellas Verona,Serie A,24,1999,3.1,4,2,1,1,2,3,4,75.0,1,6,3,3,1,5,4,0
Carlos Vinícius,BRA,FW,Fulham,Premier League,28,1995,3.5,3,2,0,1,2,0,4,0.0,4,4,0,4,0,3,1,0
Nicolas Viola,ITA,"MF,FW",Cagliari,Serie A,33,1989,13.4,13,9,2,8,3,7,17,41.2,10,9,0,9,2,15,6,0
Alan Virginius,FRA,FW,Lille,Ligue 1,20,2003,0.8,1,1,1,0,0,0,1,0.0,1,0,0,0,0,1,0,0
Alan Virginius,FRA,FW,Clermont Foot,Ligue 1,20,2003,10.4,9,5,4,4,1,4,11,36.4,7,7,0,7,3,12,7,0
Ricardo Visus,ESP,DF,Betis,La Liga,22,2001,1.8,2,2,1,1,0,2,2,100.0,0,2,2,0,2,4,9,1
Mattia Viti,ITA,DF,Sassuolo,Serie A,21,2002,10.9,24,15,14,7,3,10,22,45.5,12,20,10,10,10,34,44,0
Vitinha,POR,"FW,MF",Genoa,Serie A,23,2000,3.2,2,2,1,0,1,1,2,50.0,1,2,0,2,0,2,2,0
Vitinha,POR,FW,Marseille,Ligue 1,23,2000,10.3,14,8,3,5,6,3,12,25.0,9,11,2,9,5,19,8,0
Vitinha,POR,MF,Paris S-G,Ligue 1,23,2000,23.6,39,24,12,16,11,16,48,33.3,32,29,11,18,23,62,30,2
Vitinho,BRA,"DF,MF",Burnley,Premier League,24,1999,25.7,64,34,36,22,6,43,86,50.0,43,44,6,38,12,76,47,4
Daniel Vivian,ESP,DF,Athletic Club,La Liga,24,1999,32.0,42,28,29,11,2,28,45,62.2,17,49,25,24,31,73,104,0
Odisseas Vlachodimos,GRE,GK,Nott'ham Forest,Premier League,29,1994,5.0,0,0,0,0,0,0,1,0.0,1,0,0,0,0,0,1,0
Dušan Vlahović,SRB,FW,Juventus,Serie A,23,2000,25.6,9,5,0,6,3,4,11,36.4,7,4,2,2,1,10,11,0
Nikola Vlašić,CRO,"MF,FW",Torino,Serie A,25,1997,29.0,28,16,6,14,8,4,30,13.3,26,26,7,19,11,39,16,0
Alessandro Vogliacco,ITA,DF,Genoa,Serie A,24,1998,13.0,23,15,14,8,1,12,15,80.0,3,16,10,6,30,53,40,1
Kevin Vogt,GER,DF,Hoffenheim,Bundesliga,31,1991,14.7,14,10,7,7,0,8,13,61.5,5,16,13,3,9,23,54,0
Kevin Vogt,GER,DF,Union Berlin,Bundesliga,31,1991,14.7,10,9,6,4,0,6,12,50.0,6,22,15,7,7,17,72,2
Mërgim Vojvoda,KVX,DF,Torino,Serie A,28,1995,15.3,17,8,7,6,4,11,16,68.8,5,12,2,10,13,30,28,0
Kevin Volland,GER,"FW,MF",Union Berlin,Bundesliga,31,1992,14.9,22,9,8,8,6,8,20,40.0,12,8,0,8,6,28,12,0
Cristian Volpato,ITA,"MF,FW",Sassuolo,Serie A,19,2003,7.2,16,8,9,6,1,9,25,36.0,16,7,0,7,1,17,5,0
Aster Vranckx,BEL,MF,Wolfsburg,Bundesliga,20,2002,12.8,32,15,11,11,10,15,28,53.6,13,17,6,11,14,46,29,0
Stefan de Vrij,NED,DF,Inter,Serie A,31,1992,17.6,18,13,13,4,1,8,15,53.3,7,22,10,12,24,42,51,0
Elye Wahi,FRA,FW,Montpellier,Ligue 1,20,2003,0.2,0,0,0,0,0,0,0,,0,0,0,0,0,0,0,0
Elye Wahi,FRA,FW,Lens,Ligue 1,20,2003,18.8,6,4,1,3,2,2,10,20.0,8,5,1,4,3,9,3,0
Walace,BRA,MF,Udinese,Serie A,28,1995,36.0,66,43,40,26,0,36,77,46.8,41,43,6,37,43,109,66,1
Luca Waldschmidt,GER,"MF,FW",Köln,Bundesliga,27,1996,12.7,19,12,4,12,3,5,16,31.3,11,18,3,15,6,25,8,1
Kyle Walker,ENG,DF,Manchester City,Premier League,33,1990,30.7,38,24,19,17,2,19,39,48.7,20,19,6,13,27,65,40,1
Sebastian Walukiewicz,POL,DF,Empoli,Serie A,23,2000,22.8,39,28,33,6,0,28,41,68.3,13,50,31,19,15,54,121,0
Aaron Wan-Bissaka,ENG,DF,Manchester Utd,Premier League,25,1997,19.8,42,25,18,20,4,19,26,73.1,7,29,15,14,41,83,68,1
Joel Ward,ENG,DF,Crystal Palace,Premier League,33,1989,22.0,45,28,26,18,1,30,47,63.8,17,17,10,7,14,59,94,1
James Ward-Prowse,ENG,MF,West Ham,Premier League,28,1994,33.3,45,29,14,23,8,18,44,40.9,26,31,9,22,38,83,49,0
Lewis Warrington,ENG,FW,Everton,Premier League,20,2002,0.0,0,0,0,0,0,0,0,,0,0,0,0,0,0,0,0
Deivid Washington,BRA,"DF,FW",Chelsea,Premier League,18,2005,0.1,1,1,1,0,0,0,1,0.0,1,0,0,0,0,1,0,0
Kjell-Arik Wätjen,GER,"MF,FW",Dortmund,Bundesliga,17,2006,1.2,3,2,2,1,0,2,5,40.0,3,1,1,0,0,3,3,0
Ollie Watkins,ENG,FW,Aston Villa,Premier League,27,1995,35.7,12,7,0,5,7,5,11,45.5,6,26,4,22,4,16,20,0
Timothy Weah,USA,"DF,FW",Juventus,Serie A,23,2000,14.0,27,20,16,8,3,15,20,75.0,5,12,1,11,5,32,15,0
Adam Webster,ENG,DF,Brighton,Premier League,28,1995,12.7,14,12,8,5,1,6,18,33.3,12,16,12,4,16,30,43,1
Wout Weghorst,NED,FW,Hoffenheim,Bundesliga,30,1992,22.0,13,6,4,7,2,9,15,60.0,6,25,8,17,6,19,24,0
Julian Weigl,GER,MF,Gladbach,Bundesliga,27,1995,30.7,66,40,28,32,6,41,67,61.2,26,47,14,33,48,114,61,1
Nelson Weiper,GER,"FW,MF",Mainz 05,Bundesliga,18,2005,1.4,2,1,2,0,0,2,3,66.7,1,1,0,1,1,3,0,0
Mitchell Weiser,GER,"DF,MF",Werder Bremen,Bundesliga,29,1994,29.3,64,38,29,25,10,31,53,58.5,22,36,6,30,20,84,43,0
Noah Weißhaupt,GER,"DF,FW",Freiburg,Bundesliga,21,2001,8.4,9,4,6,0,3,5,11,45.5,6,8,1,7,8,17,12,0
Shon Weissman,ISR,"FW,DF",Salernitana,Serie A,27,1996,5.5,4,3,2,0,2,0,4,0.0,4,2,1,1,3,7,4,0
Shon Weissman,ISR,FW,Granada,La Liga,27,1996,0.9,1,1,0,0,1,1,4,25.0,3,3,0,3,0,1,1,0
Danny Welbeck,ENG,"FW,MF",Brighton,Premier League,32,1990,18.8,35,17,9,17,9,10,17,58.8,7,12,0,12,9,44,17,1
Timo Werner,GER,FW,Tottenham,Premier League,27,1996,9.0,7,4,3,4,0,5,18,27.8,13,12,0,12,3,10,2,0
Timo Werner,GER,"FW,MF",RB Leipzig,Bundesliga,27,1996,2.3,2,1,0,1,1,0,0,,0,1,0,1,1,3,0,0
Adam Wharton,ENG,MF,Crystal Palace,Premier League,19,2004,14.4,48,32,18,22,8,23,46,50.0,23,17,3,14,20,68,24,1
Ethan Wheatley,ENG,FW,Manchester Utd,Premier League,17,2006,0.2,1,1,0,1,0,1,1,100.0,0,2,0,2,2,3,0,0
Ben White,ENG,DF,Arsenal,Premier League,25,1997,33.2,48,28,20,22,6,26,58,44.8,32,48,22,26,32,80,77,1
Joe White,ENG,MF,Newcastle Utd,Premier League,20,2002,0.1,1,1,1,0,0,0,0,,0,0,0,0,0,1,0,0
Silvan Widmer,SUI,DF,Mainz 05,Bundesliga,30,1993,13.8,23,10,12,8,3,17,28,60.7,11,18,5,13,16,39,37,0
Mateusz Wieteska,POL,DF,Cagliari,Serie A,26,1997,10.7,14,11,9,3,2,3,10,30.0,7,10,5,5,14,28,48,0
Mateusz Wieteska,POL,DF,Clermont Foot,Ligue 1,26,1997,1.9,4,1,3,1,0,3,5,60.0,2,4,2,2,5,9,8,0
Iñaki Williams,GHA,FW,Athletic Club,La Liga,29,1994,31.6,24,17,6,8,10,13,34,38.2,21,42,8,34,14,38,29,0
Neco Williams,WAL,DF,Nott'ham Forest,Premier League,22,2001,18.2,69,40,42,18,9,35,56,62.5,21,44,13,31,22,91,53,0
Nico Williams,ESP,FW,Athletic Club,La Liga,21,2002,25.1,31,12,9,15,7,13,36,36.1,23,18,2,16,3,34,4,1
Willian,BRA,FW,Fulham,Premier League,34,1988,22.8,18,11,6,7,5,3,21,14.3,18,13,0,13,9,27,12,1
Joe Willock,ENG,MF,Newcastle Utd,Premier League,23,1999,4.7,13,7,7,6,0,4,11,36.4,7,7,0,7,1,14,1,0
Callum Wilson,ENG,FW,Newcastle Utd,Premier League,31,1992,11.0,5,3,0,2,3,0,4,0.0,4,6,0,6,2,7,4,0
Harry Wilson,WAL,FW,Fulham,Premier League,26,1997,18.0,21,14,9,8,4,11,28,39.3,17,27,3,24,10,31,12,0
Josh Wilson-Esbrand,ENG,"DF,MF",Reims,Ligue 1,20,2002,5.1,5,4,2,3,0,2,8,25.0,6,5,2,3,6,11,7,0
Patrick Wimmer,AUT,"FW,MF",Wolfsburg,Bundesliga,22,2001,6.5,14,5,5,5,4,8,18,44.4,10,14,0,14,3,17,7,0
Jonas Wind,DEN,FW,Wolfsburg,Bundesliga,24,1999,29.5,13,10,4,6,3,7,17,41.2,10,13,4,9,3,16,21,0
Florian Wirtz,GER,MF,Leverkusen,Bundesliga,20,2003,26.4,27,18,7,14,6,9,29,31.0,20,36,2,34,9,36,3,0
Yoane Wissa,COD,FW,Brentford,Premier League,26,1996,27.7,28,16,13,10,5,5,20,25.0,15,24,3,21,9,37,15,0
Axel Witsel,BEL,DF,Atlético Madrid,La Liga,34,1989,30.9,35,21,23,12,0,17,24,70.8,7,40,21,19,16,51,119,0
Maximilian Wittek,GER,"DF,FW",Bochum,Bundesliga,27,1995,11.9,23,17,9,11,3,13,21,61.9,8,12,1,11,18,41,23,0
Maximilian Wöber,AUT,DF,Gladbach,Bundesliga,25,1998,23.0,66,31,40,25,1,31,53,58.5,22,47,26,21,38,104,111,0
Marius Wolf,GER,DF,Dortmund,Bundesliga,28,1995,13.0,20,12,8,11,1,11,23,47.8,12,12,2,10,8,28,20,0
Nick Woltemade,GER,"FW,MF",Werder Bremen,Bundesliga,21,2002,13.2,34,23,7,20,7,15,21,71.4,6,12,0,12,5,39,17,0
Jeong Woo-yeong,KOR,"MF,FW",Stuttgart,Bundesliga,23,1999,7.0,15,9,6,8,1,6,8,75.0,2,5,0,5,7,22,5,0
Chris Wood,NZL,FW,Nott'ham Forest,Premier League,31,1991,20.1,7,4,1,4,2,3,9,33.3,6,11,3,8,1,8,26,0
Cauley Woodrow,ENG,"FW,MF",Luton Town,Premier League,28,1994,4.7,16,10,8,4,4,9,16,56.3,7,7,1,6,1,17,14,0
Christopher Wooh,CMR,DF,Rennes,Ligue 1,21,2001,15.4,18,12,12,6,0,8,15,53.3,7,19,9,10,18,36,51,0
Joe Worrall,ENG,DF,Nott'ham Forest,Premier League,26,1997,4.9,7,5,6,1,0,3,6,50.0,3,5,4,1,3,10,32,1
Xeber,ESP,"FW,MF",Alavés,La Liga,26,1997,3.4,5,5,3,2,0,3,7,42.9,4,2,1,1,1,6,2,0
Granit Xhaka,SUI,MF,Leverkusen,Bundesliga,30,1992,31.3,29,21,11,14,4,9,30,30.0,21,29,8,21,19,48,42,0
Antal Yaakobishvili,HUN,DF,Girona,La Liga,19,2004,0.7,2,1,1,1,0,1,1,100.0,0,0,0,0,3,5,3,0
Lamine Yamal,ESP,FW,Barcelona,La Liga,16,2007,24.5,61,37,32,15,14,18,48,37.5,30,32,0,32,19,80,11,0
Roman Yaremchuk,UKR,FW,Valencia,La Liga,27,1995,10.3,5,2,1,2,2,3,6,50.0,3,4,0,4,1,6,9,0
Yehor Yarmoliuk,UKR,MF,Brentford,Premier League,19,2004,7.6,17,11,6,8,3,7,17,41.2,10,17,4,13,6,23,5,0
Ryan Yates,ENG,MF,Nott'ham Forest,Premier League,25,1997,22.1,66,39,39,21,6,19,34,55.9,15,42,15,27,21,87,44,1
Yusuf Yazıcı,TUR,"MF,FW",Lille,Ligue 1,26,1997,14.6,19,11,6,9,4,4,15,26.7,11,10,1,9,5,24,5,0
Kelvin Yeboah,ITA,FW,Montpellier,Ligue 1,23,2000,3.1,4,2,2,2,0,1,3,33.3,2,3,2,1,1,5,3,0
Bertuğ Yıldırım,TUR,FW,Rennes,Ligue 1,21,2002,5.2,7,5,2,3,2,3,8,37.5,5,8,0,8,0,7,4,0
Kenan Yıldız,TUR,"FW,MF",Juventus,Serie A,18,2005,10.6,13,9,5,6,2,4,8,50.0,4,6,0,6,1,14,4,0
Darlin Yongwa,CMR,DF,Lorient,Ligue 1,22,2000,12.9,30,23,17,11,2,14,25,56.0,11,14,2,12,15,45,36,0
Leny Yoro,FRA,DF,Lille,Ligue 1,17,2005,29.7,36,25,27,7,2,17,31,54.8,14,20,14,6,36,72,97,1
Ashley Young,ENG,"DF,MF",Everton,Premier League,38,1985,25.3,53,38,28,19,6,30,54,55.6,24,24,6,18,22,75,50,3
Etienne Youte Kinkoue,FRA,DF,Le Havre,Ligue 1,21,2002,21.6,15,9,13,2,0,7,11,63.6,4,21,16,5,44,59,104,0
Illia Zabarnyi,UKR,DF,Bournemouth,Premier League,20,2002,37.0,59,32,29,29,1,23,50,46.0,27,53,34,19,33,92,143,4
Mattia Zaccagni,ITA,"FW,MF",Lazio,Serie A,28,1995,21.7,27,16,11,15,1,9,21,42.9,12,26,2,24,21,48,15,0
Dan-Axel Zagadou,FRA,DF,Stuttgart,Bundesliga,24,1999,16.1,21,14,16,5,0,4,8,50.0,4,23,18,5,20,41,78,1
Yoram Zague,FRA,DF,Paris S-G,Ligue 1,17,2006,4.1,18,8,11,4,3,11,24,45.8,13,3,0,3,4,22,9,1
Warren Zaïre-Emery,FRA,"MF,DF",Paris S-G,Ligue 1,17,2006,21.8,51,28,18,24,9,28,51,54.9,23,32,8,24,15,66,22,2
Denis Zakaria,SUI,"MF,DF",Monaco,Ligue 1,26,1996,23.7,38,27,11,20,7,12,30,40.0,18,39,13,26,47,85,41,0
Arsen Zakharyan,RUS,"MF,FW",Real Sociedad,La Liga,20,2003,13.6,22,15,8,11,3,9,22,40.9,13,16,0,16,4,26,10,0
Joseba Zaldúa,ESP,DF,Cádiz,La Liga,31,1992,7.8,20,12,17,2,1,13,21,61.9,8,6,4,2,2,22,20,0
Nicola Zalewski,POL,"DF,FW",Roma,Serie A,21,2002,10.8,20,14,10,9,1,8,22,36.4,14,12,4,8,9,29,17,0
Andre-Frank Zambo Anguissa,CMR,MF,Napoli,Serie A,27,1995,31.0,61,33,21,29,11,34,69,49.3,35,40,5,35,28,89,19,1
Nicolò Zaniolo,ITA,"FW,MF",Aston Villa,Premier League,24,1999,9.3,19,9,10,7,2,9,17,52.9,8,13,0,13,1,20,11,0
Alessandro Zanoli,ITA,DF,Salernitana,Serie A,22,2000,10.2,16,13,9,7,0,7,12,58.3,5,10,2,8,1,17,17,0
Alessandro Zanoli,ITA,"DF,FW",Napoli,Serie A,22,2000,0.6,1,1,1,0,0,0,0,,0,0,0,0,1,2,1,0
Duván Zapata,COL,FW,Torino,Serie A,32,1991,32.0,18,7,9,2,7,3,12,25.0,9,20,6,14,7,25,26,0
Duván Zapata,COL,FW,Atalanta,Serie A,32,1991,1.2,0,0,0,0,0,0,1,0.0,1,0,0,0,0,0,1,0
Gabriele Zappa,ITA,DF,Cagliari,Serie A,23,1999,28.5,54,31,29,16,9,29,41,70.7,12,29,5,24,20,74,75,2
Davide Zappacosta,ITA,DF,Atalanta,Serie A,31,1992,20.7,30,20,15,10,5,16,34,47.1,18,29,4,25,5,35,19,0
Bryan Zaragoza,ESP,"MF,FW",Granada,La Liga,22,2001,18.2,18,9,8,6,4,8,23,34.8,15,9,0,9,3,21,3,0
Bryan Zaragoza,ESP,"FW,MF",Bayern Munich,Bundesliga,22,2001,2.0,4,4,2,1,1,3,3,100.0,0,0,0,0,2,6,0,0
Anass Zaroury,MAR,"FW,MF",Burnley,Premier League,22,2000,1.7,1,0,1,0,0,0,4,0.0,4,2,0,2,0,1,1,1
Oier Zarraga,ESP,MF,Udinese,Serie A,24,1999,4.5,3,3,2,1,0,1,5,20.0,4,5,2,3,5,8,16,1
Mehdi Zeffane,ALG,"DF,MF",Clermont Foot,Ligue 1,31,1992,13.7,31,20,17,11,3,17,34,50.0,17,14,3,11,16,47,34,0
Jordan Zemura,ZIM,DF,Udinese,Serie A,23,1999,11.5,24,16,13,7,4,11,19,57.9,8,5,1,4,13,37,21,0
Robin Zentner,GER,GK,Mainz 05,Bundesliga,28,1994,30.0,2,2,2,0,0,2,5,40.0,3,1,0,1,1,3,19,1
Alessio Zerbin,ITA,"DF,FW",Monza,Serie A,24,1999,7.6,18,10,13,2,3,4,13,30.8,9,16,3,13,3,21,5,0
Alessio Zerbin,ITA,"FW,DF",Napoli,Serie A,24,1999,1.7,5,2,1,3,1,2,7,28.6,5,1,0,1,0,5,0,0
Kevin Zeroli,ITA,MF,Milan,Serie A,18,2005,0.3,1,1,1,0,0,0,0,,0,1,0,1,0,1,1,0
Cedric Zesiger,SUI,DF,Wolfsburg,Bundesliga,25,1998,18.2,19,9,13,4,2,10,22,45.5,12,32,21,11,15,34,88,1
Michael Zetterer,GER,GK,Werder Bremen,Bundesliga,28,1995,27.0,3,1,3,0,0,3,3,100.0,0,0,0,0,0,3,7,3
Nathan Zeze,FRA,DF,Nantes,Ligue 1,18,2005,11.4,11,6,9,2,0,7,14,50.0,7,12,3,9,12,23,47,1
Edon Zhegrova,KVX,FW,Lille,Ligue 1,24,1999,25.4,32,18,9,15,8,14,36,38.9,22,17,1,16,8,40,8,0
Piotr Zieliński,POL,MF,Napoli,Serie A,29,1994,21.4,23,15,6,13,4,12,24,50.0,12,12,1,11,9,32,15,0
David Zima,CZE,DF,Torino,Serie A,22,2000,1.0,1,1,1,0,0,0,0,,0,0,0,0,3,4,7,0
Christoph Zimmermann,GER,DF,Darmstadt 98,Bundesliga,30,1993,13.6,33,21,26,7,0,19,39,48.7,20,21,14,7,21,54,66,1
Oleksandr Zinchenko,UKR,DF,Arsenal,Premier League,26,1996,19.1,50,30,19,24,7,35,52,67.3,17,18,3,15,20,70,26,2
Joshua Zirkzee,NED,FW,Bologna,Serie A,22,2001,30.7,32,20,8,15,9,13,24,54.2,11,25,2,23,3,35,36,0
Luc Zogbé,CIV,DF,Brest,Ligue 1,18,2005,0.1,0,0,0,0,0,0,1,0.0,1,1,1,0,1,1,0,0
Simon Zoller,GER,"FW,MF",Bochum,Bundesliga,32,1991,0.5,0,0,0,0,0,0,0,,0,1,0,1,0,0,0,0
Nadir Zortea,ITA,DF,Frosinone,Serie A,24,1999,14.0,21,14,8,13,0,10,22,45.5,12,13,5,8,4,25,29,1
Nadir Zortea,ITA,DF,Atalanta,Serie A,24,1999,1.7,5,4,3,1,1,1,4,25.0,3,2,0,2,1,6,3,0
Kurt Zouma,FRA,DF,West Ham,Premier League,28,1994,31.5,23,17,14,9,0,10,16,62.5,6,38,28,10,29,52,160,0
Igor Zubeldia,ESP,DF,Real Sociedad,La Liga,26,1997,28.0,32,25,20,10,2,19,26,73.1,7,28,19,9,32,64,97,3
Martín Zubimendi,ESP,MF,Real Sociedad,La Liga,24,1999,29.5,49,27,18,29,2,23,42,54.8,19,33,9,24,37,86,54,0
Szymon Żurkowski,POL,MF,Empoli,Serie A,25,1997,9.6,15,6,5,8,2,5,15,33.3,10,5,1,4,6,21,11,0
Lovro Zvonarek,CRO,"FW,MF",Bayern Munich,Bundesliga,18,2005,1.8,0,0,0,0,0,0,5,0.0,5,3,0,3,0,0,2,0
Martin Ødegaard,NOR,MF,Arsenal,Premier League,24,1998,34.3,49,17,18,21,10,17,58,29.3,41,23,1,22,15,64,5,0
Milan Đurić,BIH,FW,Hellas Verona,Serie A,33,1990,13.4,1,0,0,0,1,0,3,0.0,3,0,0,0,1,2,13,0
Milan Đurić,BIH,FW,Monza,Serie A,33,1990,14.0,5,5,0,5,0,2,4,50.0,2,6,2,4,0,5,27,0
Mateusz Łęgowski,POL,MF,Salernitana,Serie A,20,2003,12.7,23,12,8,12,3,11,26,42.3,15,13,2,11,7,30,16,0
