Player,Nation,Pos,Squad,Age,Born,90s,Tackles,TacklesWon,TacklesDef3rd,TacklesMid3rd,TacklesAtt3rd,DribTkl,DribTklAtt,DribTkl%,ChallengesLost,Blocks,ShotsBlocked,PassesBlocked,Int,Tkl+Int,Clr,ErrorsLeadingToShot
Nicolás Acevedo,URU,MF,Bahia,23,1999,21.9,73,46,24,43,6,41,86,47.7,45,31,1,30,27,100,22,1
Luiz Adriano,BRA,FW,Internacional,35,1987,14.8,12,7,0,6,6,2,7,28.6,5,10,2,8,9,21,18,0
Adriel,BRA,GK,Grêmio,22,2001,2.0,0,0,0,0,0,0,0,,0,0,0,0,0,0,0,0
Adryelson,BRA,DF,Botafogo (RJ),24,1998,33.3,34,20,23,10,1,17,26,65.4,9,43,30,13,61,95,202,2
Adson,BRA,"FW,MF",Corinthians,22,2000,9.5,34,26,22,9,3,12,21,57.1,9,15,2,13,8,42,1,0
Adyson,BRA,"FW,MF",América (MG),17,2005,2.7,8,5,3,3,2,3,6,50.0,3,1,0,1,5,13,0,0
Washington Aguerre,URU,GK,América (MG),29,1993,2.0,0,0,0,0,0,0,0,,0,0,0,0,0,0,3,0
Carlos Alberto,BRA,"FW,MF",Botafogo (RJ),20,2002,3.3,3,0,1,1,1,2,5,40.0,3,5,2,3,1,4,4,0
Yuri Alberto,BRA,FW,Corinthians,21,2001,30.2,23,14,6,8,9,9,21,42.9,12,22,2,20,4,27,17,0
Ale,BRA,MF,América (MG),32,1990,15.8,39,17,17,20,2,12,37,32.4,25,21,5,16,28,67,24,0
Alexandre Alemão,BRA,FW,Internacional,24,1998,3.8,5,5,1,3,1,1,5,20.0,4,5,1,4,1,6,2,0
Alerrandro,BRA,"FW,MF",Red Bull Bragantino,23,2000,4.5,2,2,1,1,0,0,1,0.0,1,3,0,3,0,2,6,0
Alesson,BRA,"FW,MF",Goiás,23,1999,7.3,17,10,12,3,2,12,27,44.4,15,5,1,4,1,18,7,0
Alex,BRA,DF,Santos,23,1999,5.1,9,7,8,0,1,2,4,50.0,2,3,2,1,8,17,10,0
Caio Alexandre,BRA,MF,Fortaleza,23,1999,29.2,76,42,31,39,6,44,104,42.3,60,51,7,44,24,100,22,0
Matheus Alexandre,BRA,DF,Cuiabá,23,1999,33.1,86,58,56,25,5,55,102,53.9,47,37,5,32,42,128,74,1
Alexsander,BRA,"MF,DF",Fluminense,19,2003,13.3,34,19,15,15,4,16,34,47.1,18,20,3,17,10,44,12,0
Alison,BRA,MF,Santos,29,1993,1.5,3,1,1,2,0,1,4,25.0,3,5,2,3,3,6,5,0
Alisson,BRA,"MF,DF",Atlético Mineiro,17,2005,0.5,2,2,0,1,1,0,0,,0,1,0,1,0,2,1,0
Alisson,BRA,"MF,FW",São Paulo,29,1993,23.9,47,32,15,26,6,25,67,37.3,42,32,11,21,28,75,35,1
Allan,BRA,MF,Flamengo,25,1997,5.4,12,7,5,6,1,3,16,18.8,13,5,1,4,8,20,4,0
Allano,BRA,FW,Goiás,27,1995,13.7,38,20,25,10,3,25,48,52.1,23,17,1,16,11,49,14,0
Henrique Almeida,BRA,FW,América (MG),31,1991,1.7,2,1,0,0,2,0,2,0.0,2,0,0,0,0,2,1,0
Rodrigo Alves,BRA,MF,Vasco da Gama,20,2002,3.9,11,5,7,4,0,6,14,42.9,8,1,0,1,3,14,5,1
Anderson,BRA,GK,Cruzeiro,24,1998,1.0,0,0,0,0,0,0,0,,0,0,0,0,0,0,0,0
Anderson,BRA,"FW,MF",Goiás,24,1998,14.3,24,16,11,10,3,15,26,57.7,11,8,0,8,3,27,5,0
André,BRA,DF,Bahia,19,2003,1.4,2,1,1,1,0,2,2,100.0,0,4,1,3,1,3,3,1
André,BRA,"MF,DF",Fluminense,21,2001,29.4,57,37,28,26,3,27,50,54.0,23,27,14,13,31,88,36,2
Ângelo,BRA,"FW,MF",Santos,18,2004,6.0,10,8,2,5,3,5,10,50.0,5,11,0,11,5,15,1,0
Maurício Antônio,BRA,DF,Coritiba,30,1992,2.0,0,0,0,0,0,0,0,,0,5,4,1,5,5,18,0
Apodi,BRA,"FW,MF",Goiás,36,1986,4.2,5,4,3,1,1,3,4,75.0,1,2,1,1,2,7,8,0
Guilherme Arana,BRA,DF,Atlético Mineiro,25,1997,26.5,42,29,25,16,1,15,26,57.7,11,32,11,21,32,74,57,0
Charles Aránguiz,CHI,MF,Internacional,33,1989,14.1,33,16,13,14,6,18,39,46.2,21,11,2,9,10,43,10,0
João Araújo,BRA,MF,Grêmio,17,2005,0.1,2,1,1,0,1,2,2,100.0,0,0,0,0,0,2,0,0
Luiz Araújo,BRA,FW,Flamengo,26,1996,8.7,19,16,8,6,5,8,21,38.1,13,13,1,12,8,27,10,0
Matheus Araújo,BRA,"MF,FW",Corinthians,20,2002,6.5,12,7,3,4,5,4,18,22.2,14,12,3,9,9,21,6,0
Michel Araujo,URU,"FW,MF",São Paulo,26,1996,19.6,37,25,15,18,4,20,48,41.7,28,28,2,26,11,48,19,1
Robert Arboleda,ECU,DF,São Paulo,31,1991,19.1,32,21,20,11,1,19,23,82.6,4,31,25,6,13,45,71,2
Jhon Arias,COL,"FW,MF",Fluminense,25,1997,26.5,54,31,25,21,8,25,60,41.7,35,47,2,45,9,63,18,1
Luciano Arriagada,CHI,"FW,MF",Ath Paranaense,20,2002,2.1,2,1,1,0,1,2,4,50.0,2,0,0,0,0,2,1,0
Arthur,BRA,"FW,MF",Cruzeiro,24,1998,15.0,9,7,5,4,0,3,9,33.3,6,17,0,17,5,14,3,0
Arthur,BRA,DF,América (MG),19,2003,1.0,2,1,0,2,0,0,0,,0,0,0,0,1,3,1,0
Arthur,BRA,"DF,FW",Fluminense,18,2004,0.2,2,1,1,0,1,2,2,100.0,0,0,0,0,0,2,0,0
Artur,BRA,FW,Palmeiras,24,1998,21.1,19,10,10,6,3,10,36,27.8,26,22,0,22,7,26,14,0
Eduard Atuesta,COL,MF,Palmeiras,25,1997,0.1,0,0,0,0,0,0,0,,0,0,0,0,0,0,0,0
Felipe Augusto,BRA,"FW,MF",Corinthians,18,2004,3.6,5,2,3,2,0,2,10,20.0,8,10,2,8,1,6,2,0
Filipe Augusto,BRA,MF,Cuiabá,29,1993,11.8,26,15,13,10,3,15,36,41.7,21,18,11,7,7,33,24,0
Renato Augusto,BRA,MF,Corinthians,34,1988,14.2,17,8,5,10,2,3,11,27.3,8,7,2,5,8,25,10,0
Danilo Avelar,BRA,DF,América (MG),33,1989,22.0,35,22,15,18,2,17,31,54.8,14,20,10,10,35,70,73,0
Felipe Azevedo,BRA,"FW,MF",América (MG),36,1987,19.4,17,10,7,5,5,11,26,42.3,15,16,3,13,10,27,17,0
Matheus Babi,BRA,FW,Goiás,25,1997,9.8,7,4,1,4,2,4,11,36.4,7,6,1,5,1,8,10,0
Matheus Bahia,BRA,"DF,MF",Bahia,23,1999,5.8,16,9,8,5,3,7,18,38.9,11,7,0,7,10,26,15,0
Fabián Balbuena,PAR,DF,Corinthians,31,1991,1.0,1,0,1,0,0,1,1,100.0,0,0,0,0,3,4,5,1
Robson Bambu,BRA,DF,Vasco da Gama,25,1997,14.2,21,13,15,5,1,13,28,46.4,15,27,16,11,12,33,70,1
Gabriel Baralhas,BRA,MF,Internacional,24,1998,2.6,7,5,3,4,0,5,8,62.5,3,4,1,3,5,12,2,0
Danilo Barbosa,BRA,"MF,DF",Botafogo (RJ),26,1996,11.2,18,9,10,5,3,5,12,41.7,7,16,7,9,16,34,37,0
Diogo Barbosa,BRA,DF,Fluminense,30,1992,12.4,16,11,7,7,2,8,20,40.0,12,5,1,4,10,26,28,0
Diogo Barbosa,BRA,DF,Grêmio,30,1992,4.3,4,4,1,3,0,3,9,33.3,6,5,3,2,5,9,14,0
Gabriel Barbosa,BRA,FW,Flamengo,26,1996,17.1,3,1,1,1,1,1,14,7.1,13,1,0,1,2,5,0,0
Lucas Barbosa,BRA,"FW,MF",Santos,21,2001,1.1,12,5,3,9,0,6,11,54.5,5,8,3,5,2,14,3,0
Lucas Barbosa,BRA,"MF,FW",Coritiba,21,2001,1.1,4,2,1,2,1,1,2,50.0,1,2,0,2,2,6,3,0
Chrystian Barletta,BRA,"FW,MF",Corinthians,21,2001,1.4,7,3,1,4,2,4,6,66.7,2,3,1,2,1,8,1,0
Cauan Barros,BRA,MF,Vasco da Gama,18,2004,2.6,6,3,0,5,1,4,12,33.3,8,3,0,3,1,7,9,0
Gabriel Barros,BRA,"FW,MF",Internacional,21,2001,2.0,2,1,1,1,0,0,0,,0,0,0,0,2,4,2,0
Bastos,ANG,DF,Botafogo (RJ),31,1991,1.3,4,2,1,2,1,2,3,66.7,1,4,1,3,0,4,4,0
Fellipe Bastos,BRA,MF,Goiás,32,1990,0.4,1,0,1,0,0,1,1,100.0,0,1,1,0,1,2,0,0
Diogo Batista,BRA,"DF,MF",Coritiba,19,2003,5.9,13,5,8,2,3,8,17,47.1,9,10,2,8,2,15,19,0
Rodrigo Battaglia,ARG,MF,Atlético Mineiro,31,1991,19.2,39,29,15,22,2,20,37,54.1,17,21,9,12,12,51,22,1
José Luis Rodríguez Bebanz,URU,DF,Vasco da Gama,25,1997,22.2,49,31,29,17,3,25,56,44.6,31,24,8,16,30,79,56,2
Matheus Belém,BRA,DF,São Paulo,19,2003,1.9,0,0,0,0,0,0,1,0.0,1,2,2,0,2,2,5,0
Lucas Belezi,BRA,DF,Ath Paranaense,19,2003,0.5,1,1,1,0,0,1,1,100.0,0,2,1,1,0,1,0,0
Ramiro Benetti,BRA,MF,Cruzeiro,29,1993,4.5,7,6,1,5,1,1,7,14.3,6,4,1,3,1,8,1,0
Martín Benítez,ARG,"MF,FW",América (MG),28,1994,12.4,11,7,5,3,3,4,14,28.6,10,7,0,7,6,17,3,0
Bento,BRA,GK,Ath Paranaense,23,1999,33.0,0,0,0,0,0,0,2,0.0,2,0,0,0,1,1,18,1
Lucas Beraldo,BRA,DF,São Paulo,19,2003,24.0,28,21,19,8,1,18,27,66.7,9,36,23,13,24,52,89,2
Lucas Besozzi,ARG,"FW,MF",Grêmio,20,2003,4.4,5,2,4,1,0,3,5,60.0,2,3,0,3,5,10,1,0
Matheus Bianqui,BRA,MF,Coritiba,25,1998,15.8,44,25,11,30,3,17,36,47.2,19,34,10,24,20,64,33,0
Raul Bicalho,BRA,DF,Bahia,23,1999,3.6,6,1,5,1,0,4,5,80.0,1,3,3,0,1,7,13,0
Matheus Bidu,BRA,DF,Corinthians,23,1999,18.4,27,20,18,6,3,13,22,59.1,9,24,6,18,32,59,56,0
Biel,BRA,"FW,MF",Bahia,21,2001,15.1,17,11,5,10,2,5,23,21.7,18,17,3,14,14,31,8,0
Rafael Bilu,BRA,FW,Cruzeiro,23,1999,1.0,2,0,0,1,1,0,0,,0,3,0,3,1,3,0,0
Biro,BRA,"FW,MF",Corinthians,18,2004,6.4,8,4,5,2,1,3,17,17.6,14,12,0,12,3,11,2,0
Bitelo,BRA,"MF,FW",Grêmio,23,2000,17.2,29,21,14,11,4,15,39,38.5,24,26,6,20,20,49,12,0
Paulinho Bóia,BRA,FW,América (MG),24,1998,1.5,2,2,0,2,0,2,3,66.7,1,0,0,0,0,2,0,0
Thiago Borbas,URU,FW,Red Bull Bragantino,20,2002,15.9,13,9,3,7,3,3,15,20.0,12,14,0,14,2,15,8,0
Daniel Borges,BRA,DF,América (MG),29,1993,8.9,18,12,9,7,2,8,14,57.1,6,9,3,6,14,32,30,0
Daniel Borges,BRA,DF,Botafogo (RJ),29,1993,0.5,3,2,3,0,0,2,4,50.0,2,2,0,2,1,4,3,0
Marllon Borges,BRA,DF,Cuiabá,30,1992,36.0,50,34,31,18,1,23,44,52.3,21,38,21,17,27,77,151,0
Pedro Borges,BRA,"MF,FW",Fortaleza,25,1997,6.3,16,12,7,7,2,7,12,58.3,5,7,2,5,4,20,12,1
Gabriel Boschilia,BRA,"MF,FW",Coritiba,26,1996,3.8,12,5,3,8,1,7,13,53.8,6,5,1,4,1,13,3,0
Lucas Braga,BRA,"DF,FW",Santos,26,1996,22.1,28,21,18,8,2,16,39,41.0,23,22,4,18,11,39,23,0
David Braz,BRA,DF,Fluminense,35,1987,9.6,11,8,5,4,2,6,10,60.0,4,11,6,5,8,19,50,1
Brenno,BRA,GK,Grêmio,23,1999,1.0,0,0,0,0,0,0,0,,0,0,0,0,0,0,0,0
Breno,BRA,MF,América (MG),19,2003,12.9,31,19,11,16,4,13,43,30.2,30,20,1,19,10,41,11,0
Breno,BRA,MF,Botafogo (RJ),22,2000,0.1,0,0,0,0,0,0,0,,0,1,0,1,0,0,0,0
Breno,BRA,FW,Palmeiras,27,1996,15.2,17,11,4,9,4,7,13,53.8,6,8,0,8,4,21,3,0
Emanuel Brítez,ARG,DF,Fortaleza,30,1992,30.7,37,25,24,10,3,23,46,50.0,23,37,26,11,31,68,147,0
Bruninho,BRA,"FW,MF",Red Bull Bragantino,19,2003,7.9,4,4,0,2,2,2,12,16.7,10,11,0,11,2,6,2,0
Fabrício Bruno,BRA,DF,Flamengo,26,1996,34.0,48,28,29,18,1,27,36,75.0,9,40,26,14,24,72,148,1
Vitor Bueno,BRA,"MF,FW",Ath Paranaense,28,1994,23.1,16,7,6,7,3,5,18,27.8,13,16,2,14,6,22,1,0
Esteban Burgos,ARG,DF,América (MG),31,1992,3.3,2,1,1,1,0,2,3,66.7,1,5,2,3,1,3,24,0
Fabricio Bustos,ARG,DF,Internacional,26,1996,27.8,68,48,38,19,11,39,58,67.2,19,35,11,24,16,84,70,0
Rafael Cabral,BRA,GK,Cruzeiro,32,1990,37.0,0,0,0,0,0,0,1,0.0,1,1,0,1,0,0,7,0
Cacá,BRA,DF,Ath Paranaense,23,1999,18.8,27,16,23,4,0,16,25,64.0,9,23,15,8,18,45,69,1
Cadu,BRA,DF,Santos,20,2002,0.2,0,0,0,0,0,0,0,,0,0,0,0,0,0,0,0
Caetano,BRA,DF,Corinthians,23,1999,13.4,12,8,10,2,0,5,8,62.5,3,19,14,5,19,31,62,1
Jonathan Cafu,BRA,"FW,MF",Cuiabá,31,1991,19.0,33,21,10,17,6,10,33,30.3,23,20,0,20,10,43,10,0
Júnior Caiçara,BRA,DF,Santos,33,1989,1.9,5,3,3,1,1,3,7,42.9,4,2,1,1,2,7,8,0
Rodrigo Caio,BRA,"MF,DF",Flamengo,29,1993,0.7,3,2,2,1,0,2,2,100.0,0,1,1,0,0,3,0,0
Caíque,BRA,GK,Grêmio,25,1997,4.0,0,0,0,0,0,0,0,,0,0,0,0,0,0,0,1
Calebe,BRA,"MF,FW",Fortaleza,22,2000,16.4,17,10,6,7,4,7,24,29.2,17,12,1,11,6,23,3,0
Jonathan Calleri,ARG,FW,São Paulo,29,1993,15.0,7,4,1,1,5,3,8,37.5,5,7,1,6,5,12,15,0
Patric Calmon PK,BRA,DF,Cuiabá,28,1994,5.8,12,9,8,1,3,7,13,53.8,6,9,1,8,9,21,19,0
Guilherme Camacho,BRA,MF,Santos,32,1990,5.0,15,9,7,7,1,6,16,37.5,10,14,4,10,5,20,11,0
Nathan Camargo,BRA,MF,Red Bull Bragantino,17,2005,0.1,1,1,1,0,0,1,1,100.0,0,0,0,0,0,1,0,0
Gustavo Campanharo,BRA,MF,Internacional,30,1992,7.7,26,16,12,10,4,12,32,37.5,20,10,1,9,12,38,16,0
Camilo Cándido,URU,DF,Bahia,27,1995,13.8,24,16,16,5,3,8,24,33.3,16,14,1,13,22,46,24,0
Luan Cândido,BRA,DF,Red Bull Bragantino,21,2001,12.0,19,12,12,5,2,7,13,53.8,6,24,8,16,13,32,45,0
Germán Cano,ARG,FW,Fluminense,34,1988,27.4,14,9,1,12,1,7,24,29.2,17,15,6,9,6,20,11,2
Agustín Canobbio,URU,"FW,MF",Ath Paranaense,24,1998,23.5,59,39,19,24,16,30,65,46.2,35,48,3,45,8,67,18,0
Víctor Cantillo,COL,MF,Corinthians,29,1993,3.0,7,6,4,3,0,3,10,30.0,7,7,2,5,6,13,11,0
Manuel Capasso,ARG,DF,Vasco da Gama,26,1996,6.2,8,4,6,2,0,3,9,33.3,6,11,8,3,8,16,20,0
Juninho Capixaba,BRA,DF,Red Bull Bragantino,25,1997,31.9,69,54,25,28,16,35,88,39.8,53,45,12,33,79,148,85,3
Gabriel Carabajal,ARG,MF,Vasco da Gama,31,1991,1.4,1,1,0,1,0,1,2,50.0,1,0,0,0,2,3,0,0
Felipe Carballo,URU,MF,Grêmio,26,1996,17.1,31,16,13,16,2,16,51,31.4,35,14,2,12,18,49,22,1
Johnny Cardoso,USA,MF,Internacional,21,2001,17.9,38,23,14,18,6,19,28,67.9,9,30,14,16,31,69,44,1
Ed Carlos,BRA,"MF,FW",Santos,21,2001,0.4,1,1,1,0,0,0,1,0.0,1,0,0,0,0,1,1,0
João Carlos,BRA,GK,Cuiabá,34,1988,3.0,0,0,0,0,0,0,0,,0,0,0,0,0,0,0,0
Ryan Carlos,BRA,DF,Bahia,20,2002,6.4,7,6,5,2,0,4,12,33.3,8,9,2,7,8,15,11,1
Alan Carvalho,CHN,MF,Fluminense,33,1989,0.5,0,0,0,0,0,0,1,0.0,1,2,0,2,0,0,1,0
Cássio,BRA,GK,Corinthians,35,1987,36.8,0,0,0,0,0,0,1,0.0,1,1,0,1,0,0,11,1
Luciano Castán,BRA,DF,Cruzeiro,33,1989,35.7,29,18,21,7,1,19,26,73.1,7,26,20,6,29,58,145,1
Iury de Castilho,BRA,FW,Cuiabá,27,1995,4.4,5,3,2,3,0,1,13,7.7,12,4,0,4,1,6,2,0
Matheus Cavichioli,BRA,GK,América (MG),36,1986,15.0,1,1,1,0,0,1,2,50.0,1,0,0,0,1,2,8,2
Juan Cazares,ECU,"MF,FW",América (MG),30,1992,3.1,4,2,2,2,0,1,5,20.0,4,3,0,3,0,4,0,0
Brayan Ceballos,COL,DF,Fortaleza,21,2001,2.3,2,2,1,1,0,0,0,,0,3,1,2,2,4,15,0
Pablo Ceppelini,URU,MF,Cuiabá,31,1991,11.1,14,6,6,7,1,6,33,18.2,27,10,1,9,9,23,10,0
Murilo Cerqueira,BRA,DF,Palmeiras,25,1997,24.1,29,20,15,13,1,16,29,55.2,13,25,17,8,28,57,78,0
Ricardo Cerqueira,BRA,MF,Cuiabá,20,2002,0.1,0,0,0,0,0,0,0,,0,0,0,0,0,0,0,0
Júlio César,BRA,DF,América (MG),19,2003,6.6,9,7,6,3,0,7,9,77.8,2,15,10,5,4,13,41,0
Reynaldo Cesar Moraes,BRA,DF,Cruzeiro,26,1997,0.7,0,0,0,0,0,0,0,,0,0,0,0,0,0,3,0
Reynaldo Cesar Moraes,BRA,DF,Coritiba,26,1997,2.7,4,3,4,0,0,1,2,50.0,1,2,2,0,7,11,19,0
Kayky Chagas,BRA,"FW,MF",Bahia,19,2003,4.6,8,4,4,4,0,4,13,30.8,9,7,0,7,2,10,2,0
Jhon Chancellor,VEN,DF,Coritiba,31,1992,3.4,6,4,6,0,0,4,4,100.0,0,5,4,1,2,8,21,0
Gabriel Chapecó,BRA,GK,Grêmio,22,2000,31.0,1,0,1,0,0,1,3,33.3,2,0,0,0,1,2,9,2
Gabriel Chaves,BRA,"FW,MF",Vasco da Gama,21,2001,29.0,42,26,20,17,5,16,52,30.8,36,32,0,32,13,55,16,0
Jhoanner Chávez,ECU,"DF,MF",Bahia,20,2002,6.5,14,9,3,11,0,10,21,47.6,11,6,0,6,7,21,14,0
Chiqueti,BRA,MF,Ath Paranaense,17,2005,0.2,0,0,0,0,0,0,0,,0,0,0,0,0,0,1,0
Christian,BRA,"MF,FW",Ath Paranaense,22,2000,15.1,23,13,5,15,3,8,19,42.1,11,15,1,14,10,33,9,1
Cicinho,BUL,DF,Bahia,34,1988,8.4,24,16,9,12,3,11,18,61.1,7,12,3,9,5,29,26,1
Cipriano,BRA,DF,Red Bull Bragantino,20,2002,0.8,1,1,1,0,0,1,1,100.0,0,0,0,0,2,3,11,0
Marcelo Cirino,BRA,"FW,MF",Ath Paranaense,31,1992,1.1,2,0,0,2,0,0,1,0.0,1,2,1,1,0,2,0,0
Léo Cittadini,BRA,MF,Bahia,28,1994,1.5,6,3,1,4,1,0,4,0.0,4,2,0,2,3,9,0,0
Léo Cittadini,BRA,"MF,FW",Ath Paranaense,28,1994,2.2,4,4,2,1,1,2,5,40.0,3,1,1,0,2,6,2,0
Mateus Claus,BRA,GK,Bahia,28,1994,0.6,0,0,0,0,0,0,0,,0,0,0,0,0,0,0,0
Clayson,BRA,"FW,MF",Cuiabá,27,1995,18.2,19,10,10,6,3,12,39,30.8,27,18,2,16,8,27,6,1
Mateus Cocão,BRA,MF,Vasco da Gama,20,2002,3.9,13,7,6,7,0,3,9,33.3,6,9,3,6,3,16,4,0
Diego Costa,ESP,FW,Botafogo (RJ),34,1988,5.7,7,5,2,3,2,0,1,0.0,1,4,0,4,3,10,4,0
Philippe Costa,BRA,FW,Goiás,22,2000,1.2,0,0,0,0,0,0,1,0.0,1,0,0,0,0,0,1,0
Talles Costa,BRA,"MF,FW",São Paulo,20,2002,1.5,4,1,3,0,1,1,1,100.0,0,2,1,1,2,6,0,0
Lucas Crispim,BRA,"MF,DF",Fortaleza,28,1994,5.4,7,5,3,3,1,3,10,30.0,7,4,3,1,3,10,7,0
Franco Cristaldo,ARG,"MF,FW",Grêmio,26,1996,23.7,33,17,13,15,5,17,54,31.5,37,31,0,31,12,45,7,0
Tomás Cuello,ARG,"MF,FW",Ath Paranaense,22,2000,22.8,54,25,22,27,5,29,51,56.9,22,19,2,17,37,91,29,1
Víctor Cuesta,ARG,DF,Botafogo (RJ),34,1988,35.0,46,31,22,19,5,22,36,61.1,14,37,26,11,58,104,123,1
Cuiabano,BRA,"DF,MF",Grêmio,19,2003,5.4,15,7,8,6,1,3,9,33.3,6,7,2,5,11,26,16,0
Lucas Cunha,BRA,DF,Red Bull Bragantino,26,1997,0.8,0,0,0,0,0,0,1,0.0,1,1,1,0,1,1,1,1
Matheus Cunha,BRA,GK,Flamengo,21,2001,17.6,0,0,0,0,0,0,0,,0,1,0,1,0,0,10,3
Ian Custódio,BRA,DF,Palmeiras,19,2003,0.2,0,0,0,0,0,0,0,,0,0,0,0,0,0,0,0
João Dalla Corte,BRA,DF,Internacional,16,2006,0.2,1,0,0,0,1,0,0,,0,0,0,0,1,2,0,0
Danielzinho,BRA,"FW,MF",Bahia,27,1996,0.9,1,1,0,1,0,1,3,33.3,2,1,0,1,0,1,0,0
Danielzinho,BRA,FW,Ath Paranaense,20,2002,0.0,0,0,0,0,0,0,0,,0,0,0,0,0,0,0,0
Danielzinho,BRA,MF,Fluminense,27,1996,6.8,17,9,9,6,2,11,17,64.7,6,9,4,5,9,26,6,0
David,BRA,"FW,MF",São Paulo,27,1995,8.1,7,2,3,1,3,2,8,25.0,6,8,1,7,0,7,2,0
Giorgian De Arrascaeta,URU,"MF,FW",Flamengo,28,1994,20.5,35,24,10,17,8,12,33,36.4,21,12,1,11,7,42,14,0
Sergio Antonio De Luiz Junior,BRA,"MF,DF",Vasco da Gama,27,1995,4.0,7,5,3,3,1,2,2,100.0,0,8,0,8,0,7,3,0
Denilson,BRA,MF,Cuiabá,21,2001,21.2,47,30,13,26,8,20,41,48.8,21,23,7,16,13,60,2,0
Denzel,BRA,FW,Goiás,20,2003,0.3,0,0,0,0,0,0,0,,0,0,0,0,0,0,0,0
Deyverson,BRA,FW,Cuiabá,31,1991,32.3,12,9,3,5,4,8,19,42.1,11,14,5,9,8,20,39,0
Leonel Di Plácido,ARG,DF,Botafogo (RJ),29,1994,26.2,79,51,46,28,5,54,120,45.0,66,41,7,34,48,127,56,0
Gabriel Dias,BRA,DF,Vasco da Gama,28,1994,0.1,1,1,1,0,0,0,0,,0,0,0,0,0,1,4,0
Jean Dias,BRA,"FW,MF",Internacional,32,1990,3.6,1,1,1,0,0,1,6,16.7,5,2,0,2,2,3,3,0
Luan Dias,BRA,"MF,FW",Santos,25,1997,2.1,8,6,2,5,1,1,8,12.5,7,3,1,2,1,9,0,0
Matheus Dias,BRA,"MF,FW",Internacional,25,1997,4.5,17,8,10,6,1,11,19,57.9,8,10,0,10,7,24,8,0
Diego,BRA,DF,São Paulo,23,1999,19.4,21,11,13,8,0,12,22,54.5,10,27,14,13,19,40,98,0
Dieguinho,BRA,"DF,FW",Goiás,27,1995,12.0,24,18,12,9,3,8,25,32.0,17,6,1,5,13,37,20,0
Diogo,BRA,"FW,MF",Coritiba,26,1996,8.4,18,13,9,7,2,7,14,50.0,7,8,0,8,4,22,6,0
Dodi,BRA,MF,Santos,26,1996,19.1,43,25,17,24,2,15,34,44.1,19,25,7,18,22,65,28,0
Dodô,BRA,DF,Atlético Mineiro,30,1992,0.7,0,0,0,0,0,0,0,,0,1,0,1,1,1,0,0
Dodô,BRA,DF,Santos,30,1992,15.8,20,15,11,7,2,12,23,52.2,11,18,5,13,29,49,44,1
Dodô,BRA,"MF,FW",Goiás,21,2001,3.6,4,4,1,2,1,2,6,33.3,4,1,0,1,1,5,2,0
Thiago Dombroski,BRA,DF,Coritiba,20,2002,5.6,2,2,1,1,0,1,4,25.0,3,4,2,2,6,8,28,0
Halerrandrio dos Santos,BRA,MF,Goiás,16,2006,0.3,2,2,2,0,0,1,2,50.0,1,1,0,1,0,2,0,0
Thiago dos Santos,BRA,"DF,MF",Fluminense,33,1989,9.1,17,14,12,5,0,10,19,52.6,9,14,8,6,16,33,34,0
Henrique Dourado,BRA,FW,Cruzeiro,33,1989,3.8,3,2,0,1,2,0,3,0.0,3,1,1,0,0,3,1,0
David Duarte,BRA,DF,Bahia,28,1995,9.6,8,5,4,4,0,6,8,75.0,2,8,6,2,11,19,50,1
Dudu,BRA,MF,Ath Paranaense,17,2006,0.0,0,0,0,0,0,0,0,,0,0,0,0,0,0,0,0
Dudu,BRA,FW,Palmeiras,31,1992,12.0,5,4,2,2,1,3,10,30.0,7,7,0,7,6,11,1,0
Éberth,BRA,FW,Coritiba,19,2003,0.3,0,0,0,0,0,0,0,,0,1,0,1,0,0,0,0
Edenílson,BRA,"MF,FW",Atlético Mineiro,33,1989,15.2,21,12,11,7,3,15,26,57.7,11,20,2,18,19,40,22,1
Eder,BRA,DF,América (MG),27,1995,17.4,23,14,14,7,2,15,21,71.4,6,34,21,13,19,42,99,1
EDU,BRA,DF,Goiás,22,2000,4.8,4,2,2,1,1,2,4,50.0,2,8,5,3,6,10,32,0
Edu,BRA,"FW,MF",Coritiba,29,1993,3.6,0,0,0,0,0,0,1,0.0,1,3,0,3,0,0,2,0
Carlos Eduardo,BRA,"MF,FW",Atlético Mineiro,18,2004,0.1,1,1,0,1,0,0,0,,0,0,0,0,0,1,0,0
Carlos Eduardo,BRA,MF,Botafogo (RJ),33,1989,29.7,18,11,4,13,1,9,28,32.1,19,12,0,12,13,31,19,0
Eguinaldo,BRA,"FW,MF",Vasco da Gama,18,2004,0.7,2,1,0,0,2,0,0,,0,1,1,0,0,2,0,0
Rafael Elias,BRA,FW,Cruzeiro,23,1999,6.0,8,5,0,3,5,2,5,40.0,3,3,0,3,1,9,3,0
Rodrigo Ely,BRA,DF,Grêmio,29,1993,7.4,6,2,5,1,0,1,2,50.0,1,6,6,0,3,9,46,0
Lucas Emmanuel,BRA,FW,Goiás,22,2000,0.6,1,0,0,0,1,0,1,0.0,1,1,0,1,0,1,0,0
Leandro Emmanuel Martínez,ARG,MF,América (MG),28,1994,28.2,61,41,21,36,4,25,92,27.2,67,51,11,40,31,92,22,1
Alan Empereur,BRA,DF,Cuiabá,28,1994,32.8,24,15,21,3,0,19,38,50.0,19,28,15,13,27,51,116,1
Endrick,BRA,FW,Palmeiras,16,2006,17.3,14,6,3,7,4,1,11,9.1,10,8,1,7,1,15,5,0
Erick,BRA,MF,Ath Paranaense,25,1997,27.8,48,27,18,26,4,21,44,47.7,23,33,12,21,42,90,32,0
Erison,BRA,"FW,MF",São Paulo,23,1999,4.3,3,0,0,2,1,1,2,50.0,1,2,0,2,0,3,2,0
Gonzalo Escobar,ARG,DF,Fortaleza,25,1997,6.4,18,14,5,9,4,10,16,62.5,6,8,2,6,15,33,15,0
Lucas Esquivel,ARG,DF,Ath Paranaense,21,2001,18.3,34,27,15,14,5,13,27,48.1,14,28,7,21,21,55,50,0
Estevão,BRA,MF,Internacional,20,2002,0.1,2,1,2,0,0,2,2,100.0,0,0,0,0,0,2,0,0
Estevão,BRA,DF,Palmeiras,16,2006,0.1,1,1,0,1,0,1,1,100.0,0,1,0,1,0,1,0,0
Vitor Eudes,BRA,GK,Fluminense,24,1998,1.0,0,0,0,0,0,0,0,,0,0,0,0,0,0,0,0
Lucas Evangelista,BRA,MF,Red Bull Bragantino,27,1995,30.2,51,28,20,22,9,15,46,32.6,31,31,6,25,26,77,20,0
Everaldo,BRA,"FW,MF",América (MG),28,1994,13.7,22,16,12,8,2,12,28,42.9,16,12,0,12,6,28,5,0
Éverson,BRA,GK,Atlético Mineiro,32,1990,36.0,0,0,0,0,0,0,0,,0,1,0,1,1,1,18,0
Everton,BRA,"FW,MF",Grêmio,25,1997,13.5,14,7,3,10,1,6,21,28.6,15,10,3,7,12,26,7,0
Bruno Fabiano Alves,BRA,DF,Grêmio,31,1991,27.2,33,17,17,15,1,13,21,61.9,8,42,26,16,29,62,110,0
Fabinho,BRA,MF,Palmeiras,20,2002,6.5,25,20,6,14,5,11,18,61.1,7,11,4,7,7,32,8,0
Fábio,BRA,GK,Fluminense,42,1980,35.0,0,0,0,0,0,0,1,0.0,1,0,0,0,0,0,15,2
Fábio,BRA,"DF,MF",Grêmio,32,1990,9.7,26,18,14,10,2,13,35,37.1,22,12,5,7,9,35,27,0
Fagner,BRA,DF,Corinthians,33,1989,23.3,43,27,29,8,6,24,44,54.5,20,23,11,12,17,60,66,0
Willian Farias,BRA,MF,Coritiba,33,1989,10.7,15,10,3,11,1,7,15,46.7,8,12,4,8,23,38,15,1
Luiz Felipe,BRA,DF,Santos,29,1993,0.0,0,0,0,0,0,0,0,,0,0,0,0,0,0,0,0
Marcos Felipe,BRA,GK,Bahia,26,1996,37.0,3,3,3,0,0,3,6,50.0,3,0,0,0,1,4,25,1
Matheus Felipe,BRA,DF,Ath Paranaense,24,1998,5.9,5,3,5,0,0,2,6,33.3,4,10,5,5,6,11,22,0
Danilo Fernandes,BRA,GK,Bahia,34,1988,0.4,0,0,0,0,0,0,0,,0,0,0,0,0,0,0,0
Lucas Fernandes,BRA,MF,Botafogo (RJ),25,1997,5.3,1,1,1,0,0,1,5,20.0,4,6,2,4,3,4,7,0
Matheus Fernandes,BRA,MF,Red Bull Bragantino,24,1998,26.0,106,63,40,52,14,44,92,47.8,48,36,10,26,32,138,23,1
Nathan Fernandes,BRA,"FW,MF",Grêmio,17,2005,4.2,4,1,1,1,2,1,3,33.3,2,3,0,3,1,5,1,0
Gatito Fernández,PAR,GK,Botafogo (RJ),34,1988,0.5,0,0,0,0,0,0,0,,0,0,0,0,0,0,1,0
Leonardo Fernández,URU,"MF,FW",Fluminense,24,1998,7.3,11,5,3,5,3,4,15,26.7,11,10,1,9,4,15,3,0
Rodrigo Fernández,URU,MF,Santos,27,1996,22.4,55,28,25,24,6,36,98,36.7,62,40,11,29,17,72,28,0
Fernandinho,BRA,MF,Ath Paranaense,37,1985,21.5,26,15,10,13,3,16,33,48.5,17,19,7,12,16,42,27,0
Fernando,BRA,DF,Ath Paranaense,23,1999,5.3,11,9,7,3,1,7,9,77.8,2,1,0,1,8,19,10,0
Nahuel Ferraresi,VEN,FW,São Paulo,24,1998,0.0,0,0,0,0,0,0,1,0.0,1,0,0,0,0,0,1,0
Ferreira,BRA,"FW,MF",Grêmio,25,1997,12.7,18,13,9,9,0,8,27,29.6,19,9,0,9,7,25,9,0
Sebastián Ferreira,PAR,"FW,MF",Vasco da Gama,24,1998,4.9,8,3,1,3,4,1,5,20.0,4,2,0,2,0,8,1,0
Figueiredo,BRA,"FW,MF",Vasco da Gama,21,2001,7.3,8,5,5,2,1,2,17,11.8,15,9,0,9,6,14,9,0
Tobias Figueiredo,POR,DF,Fortaleza,28,1994,3.8,4,1,2,2,0,2,2,100.0,0,2,1,1,2,6,13,1
Matheus França,BRA,"MF,FW",Flamengo,18,2004,4.1,7,6,2,2,3,1,8,12.5,7,6,0,6,5,12,2,0
Alan Franco,ECU,"MF,FW",Atlético Mineiro,24,1998,9.3,26,14,11,10,5,8,18,44.4,10,12,4,8,15,41,10,0
Alan Franco,ARG,DF,São Paulo,26,1996,12.5,14,10,9,3,2,11,16,68.8,5,10,8,2,13,27,37,0
Fransérgio,BRA,MF,Coritiba,32,1990,5.9,11,4,5,5,1,6,10,60.0,4,6,2,4,5,16,13,0
Marlon Freitas,BRA,MF,Botafogo (RJ),27,1995,32.3,41,30,22,18,1,20,48,41.7,28,43,12,31,39,80,59,0
Bruno Fuchs,BRA,DF,Atlético Mineiro,23,1999,12.1,13,6,11,2,0,4,8,50.0,4,11,5,6,16,29,53,0
Julio Furch,ARG,"FW,MF",Santos,33,1989,6.8,7,5,2,3,2,1,6,16.7,5,3,0,3,2,9,9,0
Gabriel,BRA,DF,Bahia,21,2001,10.9,21,9,14,6,1,15,22,68.2,7,10,8,2,29,50,65,1
Gabriel,BRA,MF,Internacional,30,1992,8.5,18,13,9,8,1,11,31,35.5,20,11,3,8,12,30,7,0
Gabriel,BRA,GK,Coritiba,30,1992,30.7,2,1,2,0,0,2,2,100.0,0,0,0,0,0,2,20,2
Gabriel,BRA,MF,Botafogo (RJ),29,1993,9.6,33,20,14,19,0,16,37,43.2,21,9,1,8,16,49,12,0
Eduardo Gabriel,BRA,DF,Santos,26,1996,3.0,1,0,1,0,0,1,1,100.0,0,5,4,1,6,7,20,0
Thalisson Gabriel,BRA,DF,Coritiba,21,2002,10.5,9,8,8,1,0,6,15,40.0,9,10,6,4,11,20,58,1
Zé Gabriel,BRA,MF,Vasco da Gama,24,1999,21.5,43,20,24,16,3,24,56,42.9,32,22,5,17,18,61,45,0
Ighor Gabryel,BRA,FW,América (MG),20,2003,0.3,0,0,0,0,0,0,0,,0,0,0,0,0,0,1,0
Matías Galarza,PAR,MF,Vasco da Gama,20,2002,4.5,15,7,10,4,1,7,17,41.2,10,10,2,8,6,21,3,0
Thiago Galhardo,BRA,"FW,MF",Fortaleza,33,1989,20.8,14,11,6,6,2,6,20,30.0,14,18,3,15,8,22,21,0
JP Galvão,BRA,DF,Botafogo (RJ),21,2001,2.2,8,5,5,3,0,6,11,54.5,5,3,1,2,3,11,9,0
Ganso,BRA,MF,Fluminense,33,1989,19.3,22,17,9,8,5,11,28,39.3,17,13,3,10,6,28,5,0
Maurício Garcez,BRA,"MF,FW",Coritiba,25,1997,6.6,12,7,4,5,3,6,8,75.0,2,5,1,4,0,12,11,0
García,BRA,DF,Palmeiras,21,2002,3.3,4,1,3,1,0,1,2,50.0,1,3,0,3,3,7,7,0
Bryan García,ECU,MF,Ath Paranaense,22,2001,0.0,0,0,0,0,0,0,0,,0,0,0,0,0,0,0,0
Luan Garcia,BRA,DF,Palmeiras,29,1993,20.2,12,6,6,5,1,6,12,50.0,6,22,19,3,26,38,68,0
Rafael Gava,BRA,MF,Cuiabá,29,1993,0.2,0,0,0,0,0,0,0,,0,1,0,1,0,0,0,0
Pedro Geromel,BRA,DF,Grêmio,37,1985,5.2,6,4,4,2,0,2,6,33.3,4,5,3,2,8,14,38,0
Gerson,BRA,MF,Flamengo,25,1997,29.9,39,22,18,16,5,17,45,37.8,28,27,7,20,15,54,30,0
Gil,BRA,DF,Corinthians,35,1987,32.0,46,30,34,12,0,26,41,63.4,15,52,36,16,27,73,126,0
Gilberto,BRA,FW,Cruzeiro,33,1989,12.1,11,8,3,5,3,3,9,33.3,6,7,3,4,1,12,6,0
Gilberto,BRA,DF,Bahia,29,1993,20.6,45,28,19,21,5,25,55,45.5,30,26,6,20,19,64,26,2
Giovane,BRA,FW,Corinthians,19,2003,1.5,0,0,0,0,0,0,0,,0,3,0,3,0,0,2,0
Giovani,BRA,FW,Palmeiras,19,2004,0.2,1,0,1,0,0,0,0,,0,0,0,0,0,1,0,0
Giovanni,BRA,"MF,DF",Fluminense,21,2002,1.1,0,0,0,0,0,0,2,0.0,2,1,1,0,1,1,0,0
Bruno Gomes,BRA,MF,Coritiba,21,2001,24.4,56,28,19,26,11,33,76,43.4,43,23,2,21,33,89,18,0
Igor Gomes,BRA,"MF,FW",Atlético Mineiro,23,1999,15.3,20,14,12,6,2,14,29,48.3,15,17,4,13,11,31,9,0
Igor Gomes,BRA,DF,Internacional,21,2001,16.3,34,25,23,11,0,22,40,55.0,18,18,7,11,15,49,63,0
Marlon Gomes,BRA,"MF,FW",Vasco da Gama,19,2003,12.7,39,29,16,19,4,12,30,40.0,18,22,2,20,34,73,23,1
William Gomes,BRA,FW,São Paulo,16,2006,0.8,2,2,2,0,0,0,1,0.0,1,3,0,3,1,3,0,0
Gustavo Gómez,PAR,DF,Palmeiras,29,1993,30.7,58,28,32,22,4,34,59,57.6,25,24,12,12,28,86,109,1
Sebastián Gómez,COL,MF,Coritiba,26,1996,15.9,23,14,8,10,5,13,34,38.2,21,18,3,15,15,38,12,0
Aloísio dos Santos Gonçalves,CHN,"FW,MF",América (MG),34,1988,8.0,5,4,1,2,2,2,16,12.5,14,5,1,4,2,7,4,0
Diego Gonçalves,BRA,"FW,MF",Goiás,28,1994,4.0,3,3,3,0,0,3,12,25.0,9,8,1,7,2,5,3,1
Mateus Gonçalves Martins,BRA,"MF,FW",América (MG),28,1994,0.7,2,2,0,1,1,1,1,100.0,0,1,0,1,0,2,1,0
Matheus Gonçalves,BRA,"FW,MF",Flamengo,17,2005,0.2,0,0,0,0,0,0,2,0.0,2,1,0,1,0,0,0,0
Matheus Gonçalves,BRA,"FW,MF",Red Bull Bragantino,17,2005,5.1,7,3,2,1,4,6,11,54.5,5,6,0,6,0,7,2,0
Yony González,COL,"FW,MF",Fluminense,28,1994,6.4,9,5,5,2,2,6,7,85.7,1,8,4,4,2,11,12,0
Roger Guedes,BRA,"FW,MF",Corinthians,26,1996,15.0,6,3,1,2,3,1,2,50.0,1,11,1,10,1,7,11,0
Guga,BRA,DF,Fluminense,24,1998,16.8,36,21,21,13,2,22,40,55.0,18,16,8,8,14,50,38,0
Guilherme,BRA,MF,Goiás,31,1991,20.6,27,16,12,10,5,13,28,46.4,15,21,7,14,12,39,14,1
Guilherme,BRA,"FW,MF",Fortaleza,27,1995,15.7,28,13,14,8,6,12,26,46.2,14,18,3,15,16,44,20,0
Guilherme,BRA,"DF,MF",Red Bull Bragantino,20,2002,2.9,7,4,3,2,2,4,4,100.0,0,4,1,3,3,10,11,0
Luis Guilherme,BRA,"FW,MF",Palmeiras,16,2006,6.4,3,1,0,0,3,1,10,10.0,9,4,0,4,6,9,2,0
Gustavinho,BRA,"MF,FW",Grêmio,21,2001,0.4,0,0,0,0,0,0,0,,0,0,0,0,0,0,0,0
Gustavinho,BRA,"MF,FW",Red Bull Bragantino,18,2004,7.4,13,5,5,1,7,6,23,26.1,17,8,2,6,7,20,5,0
Raphael Guzzo,POR,MF,Goiás,28,1995,6.4,6,3,1,3,2,2,7,28.6,5,9,4,5,2,8,10,0
Lucas Halter,BRA,DF,Goiás,22,2000,28.7,39,31,32,5,2,26,40,65.0,14,38,24,14,38,77,134,2
Hayner,BRA,"DF,MF",Coritiba,27,1995,3.4,5,4,3,2,0,2,3,66.7,1,5,1,4,1,6,9,0
Thiago Heleno,BRA,DF,Ath Paranaense,34,1988,30.9,41,26,28,12,1,27,39,69.2,12,35,19,16,41,82,138,1
Helinho,BRA,FW,Red Bull Bragantino,22,2000,15.4,24,16,8,11,5,8,19,42.1,11,18,0,18,8,32,11,0
Henrique,BRA,DF,Coritiba,36,1986,22.5,16,5,10,6,0,11,22,50.0,11,29,21,8,18,34,129,2
Bruno Henrique,BRA,"FW,MF",Flamengo,32,1990,17.1,29,19,10,10,9,13,28,46.4,15,20,3,17,2,31,21,0
Bruno Henrique,BRA,MF,Internacional,33,1989,11.7,15,7,3,11,1,5,20,25.0,15,12,0,12,5,20,12,0
Dalbert Henrique,BRA,DF,Internacional,29,1993,5.5,18,12,10,5,3,13,15,86.7,2,5,0,5,6,24,8,0
Fernando Henrique,BRA,MF,Cruzeiro,21,2001,1.5,4,2,0,4,0,1,1,100.0,0,3,1,2,1,5,1,0
Luis Henrique,BRA,"FW,MF",Botafogo (RJ),21,2001,15.3,5,3,2,2,1,2,8,25.0,6,17,0,17,4,9,9,0
Mateus Henrique,BRA,DF,América (MG),20,2002,6.0,12,8,9,3,0,6,15,40.0,9,14,5,9,5,17,22,0
Paulo Henrique,BRA,DF,Vasco da Gama,26,1996,9.5,31,21,12,15,4,17,30,56.7,13,11,4,7,9,40,25,0
Pedro Henrique,BRA,DF,Ath Paranaense,27,1995,9.5,8,5,6,2,0,1,6,16.7,5,21,14,7,12,20,30,0
Pedro Henrique,BRA,"FW,MF",Internacional,32,1990,14.1,27,20,15,6,6,8,16,50.0,8,11,0,11,5,32,8,0
Breno Herculano,BRA,"FW,MF",Goiás,23,1999,0.9,0,0,0,0,0,0,0,,0,1,0,1,0,0,1,0
Hércules,BRA,MF,Fortaleza,22,2000,8.6,27,18,9,15,3,10,28,35.7,18,16,2,14,5,32,9,0
Diego Hernández,URU,FW,Botafogo (RJ),22,2000,0.5,2,1,0,1,1,1,6,16.7,5,0,0,0,0,2,0,0
Nicolás Hernández,COL,DF,Internacional,25,1998,14.4,16,6,12,3,1,13,18,72.2,5,18,7,11,9,25,67,2
Lucca Holanda,BRA,FW,Internacional,19,2003,6.1,11,5,1,6,4,5,17,29.4,12,5,2,3,4,15,2,0
Hugo,BRA,DF,Goiás,25,1997,15.8,31,18,16,11,4,15,21,71.4,6,20,4,16,21,52,64,0
Hugo,BRA,DF,Botafogo (RJ),21,2001,15.5,56,31,33,18,5,27,51,52.9,24,11,1,10,24,80,37,0
Victor Hugo,BRA,"MF,FW",Flamengo,18,2004,14.2,31,18,5,22,4,16,37,43.2,21,12,1,11,13,44,9,0
Vitor Hugo,BRA,DF,Bahia,31,1991,23.7,38,24,29,9,0,18,24,75.0,6,21,12,9,32,70,82,0
Hulk,BRA,FW,Atlético Mineiro,36,1986,32.7,28,21,6,14,8,8,22,36.4,14,13,3,10,1,29,37,0
José Hurtado,ECU,DF,Red Bull Bragantino,21,2001,18.0,36,26,16,17,3,25,47,53.2,22,19,6,13,21,57,34,0
Hyoran,BRA,"MF,FW",Atlético Mineiro,29,1993,7.7,15,8,5,6,4,9,26,34.6,17,13,2,11,3,18,6,0
Igor,BRA,MF,Flamengo,19,2003,0.9,2,1,0,2,0,1,4,25.0,3,0,0,0,3,5,0,0
André Inácio,BRA,FW,Flamengo,20,2002,0.2,2,2,2,0,0,2,3,66.7,1,0,0,0,0,2,1,0
Gabriel Inocêncio,BRA,DF,Santos,28,1994,14.2,53,30,30,13,10,29,49,59.2,20,26,8,18,15,68,40,1
Isaac,BRA,FW,Atlético Mineiro,18,2004,0.2,1,1,0,0,1,1,1,100.0,0,0,0,0,0,1,0,0
Isaac,BRA,"MF,DF",Fluminense,18,2004,1.5,8,4,4,0,4,3,5,60.0,2,2,0,2,3,11,2,0
Juan Iturbe,PAR,"FW,MF",Grêmio,29,1993,0.8,5,5,4,1,0,2,5,40.0,3,1,0,1,2,7,3,0
Zé Ivaldo,BRA,DF,Ath Paranaense,25,1997,11.3,17,13,13,4,0,10,14,71.4,4,7,5,2,16,33,45,0
Ivonei,BRA,MF,Santos,20,2002,0.0,0,0,0,0,0,0,1,0.0,1,0,0,0,0,0,0,0
Vítor Jacaré,BRA,"DF,MF",Bahia,23,1999,9.8,22,17,13,6,3,15,37,40.5,22,17,2,15,10,32,20,0
Jadsom,BRA,MF,Red Bull Bragantino,21,2001,21.1,41,21,11,24,6,19,43,44.2,24,37,7,30,27,68,25,0
Jair,BRA,MF,Vasco da Gama,28,1994,17.7,40,24,18,18,4,24,57,42.1,33,29,3,26,15,55,15,0
Jamerson,BRA,"DF,FW",Coritiba,24,1998,21.0,50,32,32,14,4,29,43,67.4,14,27,6,21,28,78,51,0
Janderson,BRA,"FW,MF",Botafogo (RJ),23,1999,4.6,8,5,2,3,3,2,5,40.0,3,3,0,3,2,10,3,0
Jandrei,BRA,GK,São Paulo,29,1993,5.0,0,0,0,0,0,0,0,,0,0,0,0,0,0,3,0
Léo Jardim,BRA,GK,Vasco da Gama,27,1995,38.0,1,0,1,0,0,0,0,,0,0,0,0,0,1,11,0
Jemerson,BRA,DF,Atlético Mineiro,30,1992,27.5,30,20,19,10,1,16,33,48.5,17,30,24,6,31,61,105,1
Jesé,ESP,MF,Coritiba,29,1993,1.1,0,0,0,0,0,0,1,0.0,1,1,0,1,0,0,0,0
Alexandre Jesus,BRA,DF,Fluminense,21,2001,0.1,0,0,0,0,0,0,1,0.0,1,0,0,0,1,1,1,0
Jhow,BRA,DF,América (MG),19,2003,0.2,0,0,0,0,0,0,0,,0,0,0,0,0,0,1,0
Joaquim,BRA,DF,Santos,24,1998,30.3,61,45,46,14,1,38,52,73.1,14,39,24,15,45,106,183,1
John,BRA,GK,Internacional,26,1996,9.0,0,0,0,0,0,0,0,,0,0,0,0,1,1,7,0
Felipe Jonatan,BRA,DF,Santos,24,1998,1.0,0,0,0,0,0,0,1,0.0,1,2,0,2,0,0,0,0
Jori,BRA,GK,América (MG),26,1996,11.0,1,1,1,0,0,1,2,50.0,1,0,0,0,0,1,9,0
Josué,BRA,MF,Grêmio,17,2005,1.3,2,0,1,1,0,0,1,0.0,1,3,1,2,6,8,5,0
Jhonatan Jowjow,BRA,"MF,FW",Palmeiras,20,2002,9.9,19,15,8,6,5,5,17,29.4,12,19,3,16,9,28,11,0
Daniel Jr,BRA,MF,Cruzeiro,20,2002,0.3,0,0,0,0,0,0,1,0.0,1,0,0,0,0,0,0,0
Luciano Juba,BRA,"DF,MF",Bahia,23,1999,7.2,14,9,8,5,1,9,15,60.0,6,5,0,5,9,23,14,0
Juninho,BRA,MF,América (MG),35,1987,32.5,44,26,14,23,7,15,51,29.4,36,33,7,26,31,75,43,0
Pedrinho Junqueira,BRA,"FW,MF",Goiás,18,2004,2.2,5,5,0,4,1,1,4,25.0,3,2,1,1,0,5,1,0
Jussa,BRA,MF,Cruzeiro,26,1996,19.6,34,23,9,23,2,18,29,62.1,11,15,4,11,15,49,32,0
Justen,BRA,DF,Fluminense,19,2003,0.6,2,1,2,0,0,1,2,50.0,1,1,0,1,2,4,4,0
Kaiki,BRA,"DF,FW",Cruzeiro,19,2003,2.5,7,6,3,3,1,2,3,66.7,1,2,1,1,5,12,6,0
Kaio,BRA,"MF,FW",Coritiba,18,2004,9.8,22,16,12,4,6,9,28,32.1,19,9,3,6,7,29,5,0
Lucas Kal,BRA,MF,América (MG),26,1996,13.7,17,7,13,3,1,10,31,32.3,21,13,5,8,15,32,24,0
Walter Kannemann,ARG,DF,Grêmio,31,1991,26.2,50,33,30,18,2,27,53,50.9,26,36,16,20,45,95,116,0
Kanu,BRA,DF,Bahia,25,1997,32.3,34,25,26,5,3,21,39,53.8,18,38,18,20,47,81,103,1
Alan Kardec,BRA,"FW,MF",Atlético Mineiro,34,1989,2.9,0,0,0,0,0,0,0,,0,1,0,1,1,1,1,0
Kauan,BRA,FW,Fortaleza,17,2005,0.1,0,0,0,0,0,0,1,0.0,1,0,0,0,0,0,0,0
Vinicius Kaue,BRA,"DF,MF",Ath Paranaense,19,2003,3.8,7,2,4,3,0,4,8,50.0,4,6,1,5,3,10,12,0
Kayque,BRA,MF,Botafogo (RJ),22,2000,0.3,1,1,0,0,1,0,0,,0,0,0,0,1,2,0,0
Renato Kayser,BRA,"FW,MF",América (MG),26,1996,0.4,0,0,0,0,0,0,0,,0,0,0,0,0,0,0,0
Keiller,BRA,GK,Internacional,26,1996,10.0,0,0,0,0,0,0,1,0.0,1,0,0,0,0,0,2,1
John Kennedy,BRA,"FW,MF",Fluminense,20,2002,15.2,15,9,5,7,3,9,19,47.4,10,12,1,11,3,18,10,0
Keno,BRA,"FW,MF",Fluminense,33,1989,17.9,31,15,11,14,6,16,31,51.6,15,11,1,10,11,42,17,0
Kevin,BRA,"FW,DF",Palmeiras,20,2003,2.6,6,4,4,1,1,4,5,80.0,1,2,0,2,3,9,2,0
Kevyson,BRA,DF,Santos,18,2004,10.8,30,23,18,11,1,13,22,59.1,9,8,3,5,22,52,22,1
Khellven,BRA,DF,Ath Paranaense,21,2001,11.1,14,11,6,8,0,11,21,52.4,10,9,5,4,16,30,29,0
Maurício Kozlinski,BRA,GK,Fortaleza,31,1991,1.0,0,0,0,0,0,0,0,,0,0,0,0,0,0,1,0
Benjamín Kuscevic,CHI,DF,Coritiba,26,1996,22.5,41,26,27,12,2,27,47,57.4,20,44,28,16,38,79,111,0
Derik Lacerda,BRA,"FW,MF",Cuiabá,23,1999,7.3,13,10,9,3,1,8,16,50.0,8,6,1,5,3,16,4,0
Ignacio Laquintana,URU,FW,Red Bull Bragantino,23,1999,2.0,4,3,0,3,1,0,1,0.0,1,1,0,1,1,5,0,0
Thauan Lara,BRA,"DF,MF",Internacional,19,2004,3.7,7,6,4,2,1,4,9,44.4,5,4,2,2,4,11,9,0
Lelê,BRA,"FW,MF",Fluminense,25,1997,12.7,16,11,7,6,3,3,8,37.5,5,14,1,13,3,19,8,0
Mauricio Lemos,URU,DF,Atlético Mineiro,27,1995,24.6,41,29,30,9,2,27,35,77.1,8,31,25,6,42,83,120,0
Marcos Leonardo,BRA,FW,Santos,19,2003,28.8,7,3,1,4,2,2,6,33.3,4,11,5,6,2,9,25,0
Lian,BRA,MF,Grêmio,17,2005,0.1,0,0,0,0,0,0,0,,0,0,0,0,0,0,0,0
Lima,BRA,"MF,FW",Fluminense,26,1996,28.1,38,20,9,24,5,16,50,32.0,34,31,9,22,21,59,22,0
Lucas Lima,BRA,"MF,FW",Santos,32,1990,24.5,60,41,19,35,6,26,72,36.1,46,27,4,23,3,63,9,0
Leonardo Linck,BRA,GK,Ath Paranaense,21,2001,5.0,0,0,0,0,0,0,0,,0,0,0,0,0,0,2,1
Liziero,BRA,MF,Coritiba,24,1998,6.5,15,10,4,11,0,9,23,39.1,14,8,3,5,8,23,9,0
Marcelo Lomba,BRA,GK,Palmeiras,36,1986,3.0,0,0,0,0,0,0,0,,0,0,0,0,0,0,0,1
José López,ARG,"FW,MF",Palmeiras,22,2000,6.6,9,4,1,4,4,1,10,10.0,9,5,1,4,4,13,13,0
Lucão,BRA,DF,Red Bull Bragantino,24,1998,2.2,3,1,3,0,0,1,1,100.0,0,0,0,0,5,8,6,0
Lucão,BRA,GK,Red Bull Bragantino,21,2001,5.0,0,0,0,0,0,0,0,,0,0,0,0,0,0,5,0
Lucas,BRA,DF,Santos,21,2001,6.8,14,8,10,4,0,7,20,35.0,13,11,3,8,6,20,20,0
Ayrton Lucas,BRA,DF,Flamengo,25,1997,28.8,63,45,31,21,11,37,66,56.1,29,21,5,16,14,77,52,0
Jean Lucas,BRA,MF,Santos,24,1998,20.1,32,22,15,12,5,16,43,37.2,27,16,2,14,14,46,16,1
Jhonny Lucas,BRA,MF,Goiás,22,2000,0.2,0,0,0,0,0,0,0,,0,1,0,1,0,0,0,0
João Lucas,BRA,DF,Santos,24,1998,9.0,21,15,9,10,2,11,19,57.9,8,16,3,13,15,36,22,0
Ruan Lucas,BRA,"MF,FW",Coritiba,18,2004,0.3,0,0,0,0,0,0,2,0.0,2,2,0,2,0,0,0,0
Ian Luccas,BRA,MF,Cruzeiro,19,2003,5.3,14,6,5,5,4,3,9,33.3,6,2,0,2,5,19,11,0
Pedro Luccas,BRA,GK,Coritiba,19,2004,3.0,0,0,0,0,0,0,0,,0,0,0,0,0,0,1,0
Luciano,BRA,"MF,FW",São Paulo,29,1993,23.5,26,18,9,15,2,12,23,52.2,11,15,0,15,4,30,10,0
Thomas Luciano,BRA,DF,Grêmio,21,2002,3.5,9,7,7,2,0,8,15,53.3,7,5,3,2,7,16,13,0
Luis,BRA,FW,Cruzeiro,17,2005,0.1,2,1,0,2,0,1,1,100.0,0,1,0,1,1,3,1,0
Filipe Luís,BRA,DF,Flamengo,37,1985,5.9,18,9,11,6,1,8,9,88.9,1,5,3,2,11,29,13,0
Victor Luis,BRA,DF,Coritiba,29,1993,17.4,27,21,16,9,2,15,31,48.4,16,25,11,14,27,54,41,0
David Luiz,BRA,DF,Flamengo,35,1987,11.0,13,9,8,4,1,6,12,50.0,6,13,11,2,10,23,56,0
Wallisson Luiz,BRA,MF,Cruzeiro,25,1997,4.4,15,11,5,8,2,4,12,33.3,8,3,0,3,7,22,3,0
Machado,BRA,MF,Cruzeiro,27,1996,25.3,38,23,13,16,9,12,29,41.4,17,18,5,13,33,71,25,2
Imanol Machuca,ARG,FW,Fortaleza,23,2000,7.5,18,10,5,9,4,9,18,50.0,9,11,0,11,3,21,1,0
Mádson,BRA,"DF,MF",Ath Paranaense,31,1992,14.8,12,4,5,7,0,5,9,55.6,4,12,5,7,11,23,41,0
João Magno,BRA,FW,Goiás,25,1997,10.9,5,4,1,3,1,1,5,20.0,4,9,1,8,2,7,19,0
Maguinho,BRA,DF,Goiás,30,1993,31.7,50,32,28,16,6,26,53,49.1,27,43,21,22,40,90,87,1
Pablo Maia,BRA,MF,São Paulo,21,2002,28.7,63,36,19,39,5,33,78,42.3,45,36,13,23,19,82,31,1
Thiago Maia,BRA,MF,Flamengo,25,1997,23.3,49,31,21,24,4,27,62,43.5,35,23,12,11,29,78,37,1
Maicon,BRA,DF,Santos,34,1988,0.5,0,0,0,0,0,0,0,,0,0,0,0,1,1,6,0
Maicon,BRA,DF,Vasco da Gama,34,1988,13.9,18,12,14,4,0,8,12,66.7,4,23,17,6,17,35,84,0
Iago Maidana,BRA,DF,América (MG),26,1996,24.0,32,15,22,9,1,12,22,54.5,10,31,21,10,32,64,107,0
Hugo Mallo,ESP,DF,Internacional,31,1991,3.6,7,3,7,0,0,4,8,50.0,4,8,3,5,6,13,10,0
Léo Mana,BRA,DF,Corinthians,18,2004,1.5,2,2,1,0,1,1,2,50.0,1,4,1,3,2,4,2,0
Alef Manga,BRA,"FW,MF",Coritiba,28,1994,8.9,10,7,4,3,3,5,8,62.5,3,4,0,4,3,13,5,0
Manoel,BRA,DF,Fluminense,32,1990,3.2,4,3,2,2,0,4,5,80.0,1,5,4,1,2,6,14,0
Fernando Marçal,BRA,DF,Botafogo (RJ),33,1989,18.1,37,16,17,16,4,16,35,45.7,19,17,3,14,39,76,47,0
Marcelo,BRA,DF,Fluminense,34,1988,14.7,26,19,7,12,7,15,29,51.7,14,13,4,9,12,38,17,1
Marcelo,BRA,DF,Fortaleza,27,1996,12.0,18,12,10,7,1,9,17,52.9,8,16,11,5,17,35,46,0
João Marcelo,BRA,DF,Cruzeiro,22,2000,1.8,3,3,2,1,0,1,1,100.0,0,2,2,0,4,7,9,0
Marcinho,BRA,DF,América (MG),26,1996,8.9,11,7,7,3,1,6,22,27.3,16,14,5,9,17,28,32,1
Erick Marcus,BRA,"MF,FW",Vasco da Gama,18,2004,4.4,10,5,0,6,4,6,11,54.5,5,1,0,1,4,14,5,0
Mariano,BRA,DF,Atlético Mineiro,36,1986,17.4,49,31,31,16,2,35,51,68.6,16,11,4,7,20,69,33,1
Marinho,BRA,"FW,DF",Flamengo,32,1990,0.9,2,2,0,1,1,0,3,0.0,3,2,1,1,0,2,0,0
Marinho,BRA,"FW,MF",Fortaleza,32,1990,12.7,14,7,7,4,3,5,23,21.7,18,17,0,17,3,17,5,0
Marlon,BRA,DF,Cruzeiro,25,1997,35.5,114,73,70,35,9,74,123,60.2,49,47,4,43,49,163,92,1
Marlon,BRA,DF,América (MG),28,1994,18.6,37,26,20,16,1,22,37,59.5,15,32,6,26,31,68,49,0
Marlon,BRA,DF,Fluminense,27,1995,10.4,11,5,7,3,1,8,10,80.0,2,12,9,3,9,20,30,0
Igor Marques,BRA,DF,Cruzeiro,24,1999,1.3,5,2,2,3,0,2,5,40.0,3,3,1,2,1,6,4,0
Renato Marques,BRA,"FW,MF",América (MG),19,2003,5.7,4,2,3,1,0,2,5,40.0,3,1,0,1,2,6,5,0
Juan Martín Lucero,ARG,FW,Fortaleza,31,1991,23.0,13,7,3,4,6,5,17,29.4,12,11,3,8,4,17,12,1
Martinelli,BRA,"MF,DF",Fluminense,21,2001,20.9,31,24,12,12,7,15,27,55.6,12,35,18,17,13,44,27,0
Andre Martins,BRA,"FW,MF",Grêmio,21,2001,4.1,9,9,2,5,2,4,7,57.1,3,6,1,5,1,10,5,0
Gustavo Martins Santos,BRA,"DF,MF",Grêmio,20,2002,7.7,21,13,15,5,1,7,11,63.6,4,14,8,6,5,26,37,0
Gonzalo Mastriani,URU,FW,América (MG),29,1993,19.9,11,7,0,6,5,6,20,30.0,14,10,3,7,1,12,11,0
Matheusinho,BRA,"MF,FW",América (MG),24,1998,2.5,5,3,3,1,1,1,3,33.3,2,4,0,4,1,6,0,0
Matheusinho,BRA,"FW,MF",Goiás,24,1998,2.2,2,1,1,1,0,1,9,11.1,8,1,1,0,1,3,1,0
Matheusinho,BRA,DF,Cuiabá,24,1998,4.8,11,8,9,2,0,8,16,50.0,8,3,1,2,5,16,14,0
Matheuzinho,BRA,DF,Flamengo,22,2000,6.9,20,9,12,6,2,12,20,60.0,8,12,4,8,7,27,15,0
Mauricio,BRA,"FW,MF",Internacional,21,2001,19.6,19,11,7,10,2,12,36,33.3,24,14,2,12,10,29,9,0
Maycon,BRA,MF,Corinthians,25,1997,26.7,43,26,20,17,6,23,58,39.7,35,39,5,34,33,76,36,0
Mayke,BRA,"DF,FW",Palmeiras,30,1992,27.8,53,32,24,23,6,30,43,69.8,13,28,8,20,43,96,37,0
Gary Medel,CHI,"DF,MF",Vasco da Gama,35,1987,19.2,22,5,13,8,1,10,29,34.5,19,26,20,6,20,42,77,1
Bruno Melo,BRA,DF,Goiás,30,1992,32.1,21,13,15,5,1,8,18,44.4,10,24,15,9,18,39,131,2
Felipe Melo,BRA,DF,Fluminense,39,1983,11.0,12,10,4,7,1,5,11,45.5,6,12,7,5,8,20,44,0
Darlan Mendes,BRA,MF,Grêmio,24,1998,0.5,2,1,2,0,0,0,4,0.0,4,0,0,0,0,2,1,0
Matheus Mendes,BRA,GK,Atlético Mineiro,23,1999,2.0,0,0,0,0,0,0,0,,0,0,0,0,0,0,2,0
Nathan Mendes,BRA,DF,São Paulo,20,2002,13.1,21,14,11,7,3,10,16,62.5,6,15,3,12,17,38,21,0
Vitor Mendes,BRA,DF,Fluminense,23,1999,1.2,0,0,0,0,0,0,1,0.0,1,1,1,0,1,1,13,0
Bruno Méndez,URU,DF,Corinthians,23,1999,18.3,39,22,22,15,2,23,40,57.5,17,23,11,12,22,61,71,0
Jhegson Méndez,ECU,MF,São Paulo,25,1997,4.1,6,4,2,4,0,1,5,20.0,4,4,0,4,6,12,2,0
Óscar Méndez,URU,MF,América (MG),28,1994,2.9,8,6,0,8,0,4,10,40.0,6,3,1,2,4,12,11,0
Stiven Mendoza,COL,"FW,MF",Santos,30,1992,18.6,25,13,5,13,7,13,26,50.0,13,20,0,20,11,36,5,0
Gabriel Menino,BRA,MF,Palmeiras,22,2000,17.7,36,24,18,14,4,18,42,42.9,24,28,4,24,15,51,14,0
Gabriel Mercado,ARG,DF,Internacional,35,1987,24.2,32,18,22,9,1,18,33,54.5,15,21,12,9,23,55,87,0
Higor Meritão,BRA,MF,Goiás,28,1994,2.5,8,2,4,3,1,4,12,33.3,8,4,0,4,3,11,6,0
Messias,BRA,DF,Santos,28,1994,26.6,23,15,17,5,1,16,21,76.2,5,32,23,9,37,60,163,1
Bruno Mezenga,BRA,"FW,MF",Santos,34,1988,1.9,3,1,0,2,1,1,2,50.0,1,3,0,3,0,3,3,0
Carlos Miguel,BRA,GK,Corinthians,24,1998,1.2,0,0,0,0,0,0,0,,0,0,0,0,0,0,0,0
Fernando Miguel,BRA,GK,Fortaleza,37,1985,5.1,1,0,1,0,0,1,1,100.0,0,0,0,0,1,2,1,1
Mikael,BRA,FW,América (MG),23,1999,1.7,2,1,0,2,0,1,5,20.0,4,0,0,0,0,2,0,0
Lucas Milla,BRA,MF,Grêmio,20,2003,3.4,10,4,3,6,1,5,14,35.7,9,10,4,6,4,14,6,0
Mina,BRA,DF,Goiás,19,2003,0.5,2,0,2,0,0,0,0,,0,0,0,0,0,2,0,0
Lucas Mineiro,BRA,MF,Cuiabá,26,1996,6.8,10,3,1,4,5,3,10,30.0,7,9,5,4,4,14,6,0
Vinicius Mingotti,BRA,FW,Bahia,23,2000,7.3,5,4,3,1,1,1,4,25.0,3,3,1,2,2,7,4,0
Miranda,BRA,DF,Vasco da Gama,23,2000,4.3,4,3,2,2,0,3,5,60.0,2,2,1,1,4,8,19,0
Moises,BRA,"MF,FW",Fortaleza,26,1996,4.1,3,3,1,1,1,1,9,11.1,8,1,0,1,3,6,1,0
Rodrigo Moledo,BRA,DF,Internacional,35,1987,5.3,2,2,1,1,0,0,3,0.0,3,10,8,2,3,5,35,0
Rafael Monteiro,BRA,MF,Fluminense,18,2004,0.0,0,0,0,0,0,0,0,,0,0,0,0,0,0,0,0
Júnior Moraes,UKR,DF,Corinthians,35,1987,0.0,1,1,0,0,1,0,0,,0,0,0,0,0,1,0,0
João Moreira,POR,DF,São Paulo,18,2004,0.8,1,1,1,0,0,1,1,100.0,0,0,0,0,1,2,0,0
Everton Morelli,BRA,MF,Goiás,25,1997,28.7,69,49,37,27,5,32,58,55.2,26,28,6,22,28,97,43,1
Alfredo Morelos,COL,"FW,MF",Santos,26,1996,0.9,1,1,1,0,0,0,0,,0,0,0,0,1,2,0,0
Marcelino Moreno,ARG,MF,Coritiba,28,1994,25.6,33,19,11,20,2,8,27,29.6,19,15,2,13,13,46,5,0
Gabriel Moscardo,BRA,MF,Corinthians,17,2005,12.6,37,22,20,15,2,19,42,45.2,23,29,9,20,20,57,28,0
Henry Mosquera,COL,"FW,MF",Red Bull Bragantino,21,2001,11.8,16,11,6,7,3,9,15,60.0,6,13,4,9,1,17,3,0
Gustavo Mosquito,BRA,"FW,MF",Corinthians,25,1997,3.4,7,5,2,3,2,3,7,42.9,4,2,1,1,1,8,10,0
Hugo Moura,BRA,MF,Ath Paranaense,25,1998,14.7,41,19,21,19,1,14,45,31.1,31,31,4,27,19,60,27,0
Lucas Moura,BRA,"FW,MF",São Paulo,30,1992,9.6,6,0,1,4,1,2,13,15.4,11,7,1,6,7,13,8,0
Neto Moura,BRA,MF,Cruzeiro,26,1996,5.5,9,3,3,5,1,4,23,17.4,19,4,0,4,7,16,3,0
Lucas Mugni,ARG,"MF,FW",Bahia,31,1992,4.0,6,5,4,2,0,1,11,9.1,10,3,0,3,4,10,2,0
Murillo,BRA,DF,Corinthians,20,2002,12.9,16,9,7,9,0,4,12,33.3,8,31,22,9,16,32,65,1
Andrey Ramos do Nascimento,BRA,MF,Coritiba,24,1998,12.5,37,21,18,16,3,14,35,40.0,21,19,3,16,20,57,23,0
Bruno Nascimento,BRA,"FW,MF",Cruzeiro,25,1997,31.3,36,23,12,14,10,11,28,39.3,17,29,0,29,8,44,22,0
Matheus Nascimento,BRA,"FW,MF",Botafogo (RJ),18,2004,1.1,1,1,0,1,0,0,0,,0,2,0,2,0,1,0,0
Nata,BRA,"FW,DF",Grêmio,21,2001,0.2,0,0,0,0,0,0,0,,0,0,0,0,0,0,1,0
Natan,BRA,DF,Red Bull Bragantino,21,2001,9.3,6,5,5,1,0,4,7,57.1,3,15,10,5,9,15,30,1
Natanael,BRA,DF,Coritiba,21,2002,27.8,91,63,55,29,7,54,87,62.1,33,39,10,29,31,122,70,1
Nathan,BRA,DF,Santos,21,2001,5.5,14,13,10,3,1,10,19,52.6,9,4,0,4,8,22,8,0
Nathan,BRA,"MF,FW",Grêmio,26,1996,7.6,11,6,4,3,4,3,10,30.0,7,15,2,13,8,19,5,0
Rafael Navarro,BRA,FW,Palmeiras,22,2000,1.4,0,0,0,0,0,0,0,,0,4,0,4,1,1,1,0
Kaiky Naves,BRA,"DF,FW",Palmeiras,20,2002,5.8,14,9,6,8,0,11,16,68.8,5,10,6,4,4,18,17,0
Felipe Negrucci,BRA,MF,São Paulo,18,2004,0.2,0,0,0,0,0,0,0,,0,0,0,0,0,0,1,0
Emerson Negueba,BRA,FW,Cuiabá,22,2000,5.4,7,4,2,4,1,2,5,40.0,3,8,0,8,3,10,5,0
Neris,BRA,DF,Cruzeiro,30,1992,23.5,31,18,19,10,2,21,30,70.0,9,17,9,8,35,66,98,1
Rodrigo Nestor,BRA,"MF,FW",São Paulo,22,2000,16.1,23,15,6,16,1,11,34,32.4,23,11,0,11,11,34,5,0
João Neto,BRA,"MF,DF",Fluminense,19,2003,0.6,1,1,0,0,1,1,1,100.0,0,0,0,0,0,1,1,0
Gabriel Neves,URU,MF,São Paulo,25,1997,10.7,24,14,6,12,6,10,39,25.6,29,20,2,18,3,27,15,0
Newton,BRA,MF,Botafogo (RJ),22,2000,0.1,0,0,0,0,0,0,1,0.0,1,0,0,0,0,0,0,0
Nicolas,BRA,DF,América (MG),25,1997,8.0,12,6,9,3,0,5,14,35.7,9,19,5,14,11,23,28,0
Nikão,BRA,"FW,MF",Cruzeiro,30,1992,8.9,15,10,7,8,0,8,13,61.5,5,8,1,7,6,21,4,0
Nino,BRA,DF,Fluminense,25,1997,23.9,11,6,10,1,0,5,8,62.5,3,18,14,4,22,33,96,2
Freddy Noguera,PAR,FW,Grêmio,19,2004,0.3,0,0,0,0,0,0,0,,0,0,0,0,0,0,0,0
Nonato,BRA,MF,Santos,24,1998,7.3,21,15,6,13,2,11,23,47.8,12,14,3,11,14,35,3,0
Gabriel Novaes,BRA,FW,Goiás,23,1999,1.1,1,1,0,1,0,1,5,20.0,4,2,1,1,0,1,2,0
Ruan Oliveira Ferreira,BRA,"MF,FW",Corinthians,22,2000,9.8,24,15,13,10,1,12,35,34.3,23,12,1,11,8,32,13,1
Lucas Oliveira,BRA,DF,Cruzeiro,26,1996,14.6,16,10,12,4,0,7,17,41.2,10,30,19,11,21,37,66,0
Cauly Oliveira Souza,BRA,"MF,FW",Bahia,27,1995,28.3,22,12,2,17,3,6,23,26.1,17,17,1,16,12,34,6,0
Luca Orellano,ARG,"FW,MF",Vasco da Gama,22,2000,6.9,14,7,7,5,2,8,18,44.4,10,10,1,9,3,17,3,0
Leo Ortiz,BRA,DF,Red Bull Bragantino,27,1996,17.8,18,11,13,5,0,9,15,60.0,6,21,18,3,30,48,75,1
Otávio,BRA,MF,Atlético Mineiro,28,1994,25.6,74,40,33,34,7,34,85,40.0,51,40,16,24,28,102,35,0
João Othavio Basso,BRA,DF,Santos,26,1997,12.8,20,10,14,4,2,11,23,47.8,12,9,6,3,23,43,57,0
Luis Oyama,BRA,MF,Goiás,26,1997,6.2,7,5,1,6,0,1,10,10.0,9,8,2,6,8,15,4,0
Pablinho,BRA,FW,Cuiabá,19,2003,0.4,3,2,0,3,0,1,3,33.3,2,1,0,1,0,3,0,0
Pablo,BRA,FW,Ath Paranaense,30,1992,15.5,18,10,4,11,3,7,16,43.8,9,11,1,10,8,26,19,0
Pablo,BRA,DF,Flamengo,31,1991,4.7,4,3,4,0,0,0,0,,0,3,1,2,7,11,35,1
Bruno Pacheco,BRA,DF,Fortaleza,31,1991,29.7,69,45,38,25,6,39,66,59.1,27,26,3,23,39,108,57,0
Helibelton Palacios,COL,DF,Cruzeiro,29,1993,7.0,14,12,5,8,1,7,15,46.7,8,11,0,11,5,19,20,0
Julián Palacios,ARG,"FW,MF",Goiás,23,1999,18.1,27,16,4,13,10,9,45,20.0,36,13,0,13,12,39,6,0
Nino Paraíba,BRA,DF,América (MG),37,1986,2.2,2,2,0,2,0,0,2,0.0,2,2,0,2,4,6,2,0
Mateus Pasinato,BRA,GK,América (MG),30,1992,10.0,0,0,0,0,0,0,1,0.0,1,0,0,0,0,0,6,2
Weslley Patati,BRA,"FW,MF",Santos,19,2003,1.5,5,2,1,3,1,3,9,33.3,6,3,0,3,4,9,1,0
Alexandre Pato,BRA,"FW,MF",São Paulo,33,1989,1.8,1,0,1,0,0,1,2,50.0,1,0,0,0,0,1,1,0
Patrick,BRA,"MF,FW",Atlético Mineiro,30,1992,6.2,28,19,9,10,9,11,26,42.3,15,11,1,10,6,34,8,0
Alan Patrick,BRA,"MF,FW",Internacional,31,1991,27.2,23,8,8,11,4,14,44,31.8,30,21,2,19,9,32,7,0
Luan Patrick,BRA,DF,Red Bull Bragantino,21,2002,12.4,9,6,5,4,0,5,12,41.7,7,12,10,2,17,26,33,1
Patryck,BRA,DF,São Paulo,20,2003,4.2,6,4,4,1,1,3,7,42.9,4,5,1,4,7,13,13,0
Giuliano de Paula,BRA,"MF,FW",Corinthians,32,1990,18.1,34,16,9,20,5,14,44,31.8,30,15,3,12,13,47,20,0
Jair Paula,BRA,DF,Santos,17,2005,0.4,0,0,0,0,0,0,0,,0,0,0,0,0,0,2,0
Paulinho,BRA,DF,América (MG),18,2004,0.3,1,0,1,0,0,1,1,100.0,0,0,0,0,0,1,1,0
Paulinho,BRA,"FW,MF",Atlético Mineiro,22,2000,33.2,43,31,14,24,5,18,37,48.6,19,25,1,24,17,60,17,0
Paulinho,BRA,MF,Vasco da Gama,26,1997,18.7,42,23,18,19,5,15,36,41.7,21,26,3,23,16,58,16,0
Paulinho,BRA,"MF,FW",Corinthians,34,1988,1.6,4,3,2,2,0,3,5,60.0,2,4,1,3,1,5,4,0
Caio Paulista,BRA,DF,São Paulo,24,1998,23.1,27,19,13,11,3,16,37,43.2,21,20,3,17,20,47,22,0
Wellington Paulista,BRA,FW,América (MG),38,1984,2.5,0,0,0,0,0,0,1,0.0,1,1,0,1,0,0,1,0
João Paulo,BRA,GK,Santos,27,1995,35.7,1,1,1,0,0,1,1,100.0,0,0,0,0,0,1,15,1
Marcos Paulo,BRA,"FW,MF",São Paulo,21,2001,5.9,7,7,1,3,3,3,14,21.4,11,11,2,9,6,13,2,0
Cristian Pavón,ARG,"FW,MF",Atlético Mineiro,27,1996,21.5,33,28,13,11,9,17,58,29.3,41,24,0,24,20,53,9,0
Dimitri Payet,FRA,"MF,FW",Vasco da Gama,35,1987,8.9,7,5,4,3,0,6,14,42.9,8,4,0,4,2,9,0,0
Pedrinho,BRA,"FW,MF",América (MG),23,1999,4.6,5,1,2,3,0,2,9,22.2,7,1,0,1,6,11,2,0
Pedrinho,BRA,"DF,MF",Ath Paranaense,20,2002,4.0,6,4,1,5,0,3,8,37.5,5,10,0,10,9,15,10,0
Pedrinho,BRA,"MF,FW",Atlético Mineiro,24,1998,7.0,13,5,4,7,2,4,5,80.0,1,7,0,7,1,14,2,0
Pedrinho,BRA,FW,Flamengo,19,2003,0.2,0,0,0,0,0,0,0,,0,0,0,0,1,1,1,0
Pedro,BRA,FW,Flamengo,25,1997,23.9,18,13,2,10,6,4,16,25.0,12,17,0,17,8,26,15,0
João Pedro,BRA,FW,Cruzeiro,19,2003,0.1,0,0,0,0,0,0,0,,0,0,0,0,0,0,0,0
João Pedro,ITA,FW,Grêmio,30,1992,6.8,5,4,1,3,1,1,3,33.3,2,8,2,6,4,9,7,0
João Pedro,BRA,DF,Grêmio,26,1996,23.1,34,17,15,15,4,13,31,41.9,18,24,8,16,13,47,45,1
João Pedro Pepê,BRA,MF,Grêmio,25,1998,15.5,41,31,24,15,2,15,33,45.5,18,15,6,9,15,56,26,0
Jean Pedroso,BRA,DF,Coritiba,19,2004,6.5,10,9,8,2,0,5,15,33.3,10,8,3,5,8,18,13,1
Matheus Peixoto,BRA,FW,Goiás,27,1995,9.8,9,5,3,3,3,4,6,66.7,2,7,2,5,4,13,13,0
Léo Pelé,BRA,DF,Vasco da Gama,26,1996,30.2,26,17,14,11,1,12,19,63.2,7,26,14,12,14,40,123,1
Carlos de Pena,URU,"MF,FW",Internacional,30,1992,15.8,26,13,5,17,4,12,36,33.3,24,13,2,11,21,47,20,0
Léo Pereira,BRA,DF,Flamengo,27,1996,29.4,46,29,21,24,1,30,52,57.7,22,45,30,15,29,75,86,1
Matheus Pereira,BRA,"FW,MF",Cruzeiro,26,1996,11.4,6,4,0,4,2,4,17,23.5,13,7,0,7,6,12,3,0
Bruno Peres,BRA,"DF,MF",Ath Paranaense,32,1990,1.7,3,1,2,1,0,2,3,66.7,1,1,1,0,0,3,4,0
Lucas Perri,BRA,GK,Botafogo (RJ),25,1997,37.5,0,0,0,0,0,0,1,0.0,1,0,0,0,0,0,19,3
Lucas Piazon,BRA,FW,Botafogo (RJ),29,1994,0.2,0,0,0,0,0,0,0,,0,0,0,0,0,0,0,0
Yago Pikachu,BRA,"FW,MF",Fortaleza,30,1992,19.5,20,14,9,9,2,8,28,28.6,20,22,3,19,13,33,13,0
Rodrigo Pinho,BRA,FW,Coritiba,31,1991,4.3,5,1,1,4,0,0,8,0.0,8,6,2,4,1,6,4,0
Joaquín Piquerez,URU,DF,Palmeiras,24,1998,28.1,46,32,22,18,6,27,63,42.9,36,35,6,29,29,75,47,0
Gabriel Pirani,BRA,"MF,FW",Fluminense,20,2002,4.4,8,5,4,1,3,2,6,33.3,4,6,2,4,2,10,5,0
Rafael Pires,BRA,GK,São Paulo,33,1989,33.0,2,2,2,0,0,2,3,66.7,1,1,0,1,1,3,11,0
Lucas Piton,BRA,DF,Vasco da Gama,22,2000,36.5,45,25,24,18,3,20,48,41.7,28,27,7,20,41,86,89,0
Isidro Pitta,PAR,FW,Cuiabá,23,1999,9.1,2,1,0,1,1,0,3,0.0,3,2,1,1,2,4,5,0
Tomas Pochettino,ARG,"MF,FW",Fortaleza,26,1996,22.1,44,22,11,28,5,24,62,38.7,38,29,6,23,17,61,22,0
Luan Polli,BRA,GK,Coritiba,29,1993,4.3,0,0,0,0,0,0,0,,0,0,0,0,0,0,3,3
Wesley Pombo,BRA,MF,Coritiba,20,2002,0.6,2,0,0,1,1,2,3,66.7,1,0,0,0,0,2,0,0
Mateo Ponte,URU,DF,Botafogo (RJ),19,2003,0.2,1,0,0,1,0,1,1,100.0,0,1,0,1,1,2,0,0
William Pottker,BRA,"FW,MF",Coritiba,29,1993,1.3,2,2,1,1,0,0,1,0.0,1,1,1,0,1,3,1,0
Bruno Praxedes,BRA,MF,Vasco da Gama,20,2002,14.9,34,26,18,11,5,16,35,45.7,19,19,4,15,12,46,13,0
Bruno Praxedes,BRA,MF,Red Bull Bragantino,20,2002,0.1,0,0,0,0,0,0,0,,0,0,0,0,0,0,0,0
Erick Pulgar,CHI,MF,Flamengo,29,1994,22.2,42,26,14,25,3,23,66,34.8,43,29,10,19,25,67,30,1
Nicolás Quagliata,URU,"FW,MF",Cuiabá,23,1999,2.6,3,2,3,0,0,2,12,16.7,10,7,0,7,0,3,1,0
Du Queiroz,BRA,"MF,DF",Corinthians,23,2000,2.0,2,1,1,1,0,1,5,20.0,4,0,0,0,3,5,4,0
Yani Quintero,COL,MF,Red Bull Bragantino,20,2002,1.1,4,3,2,2,0,1,2,50.0,1,3,0,3,1,5,0,0
Igor Rabello,BRA,DF,Atlético Mineiro,27,1995,7.7,17,12,13,4,0,11,23,47.8,12,12,8,4,10,27,40,0
Rafael,BRA,DF,Botafogo (RJ),32,1990,5.4,25,12,11,12,2,15,28,53.6,13,9,2,7,4,29,18,0
Zé Rafael,BRA,MF,Palmeiras,29,1993,28.5,81,51,35,41,5,42,111,37.8,69,31,5,26,23,104,23,0
Rafinha,BRA,DF,São Paulo,37,1985,22.5,41,26,26,12,3,27,46,58.7,19,17,9,8,16,57,34,1
Rai,BRA,MF,Botafogo (RJ),20,2002,0.0,0,0,0,0,0,0,0,,0,0,0,0,0,0,0,0
Eric Ramires,BRA,MF,Red Bull Bragantino,22,2000,15.3,18,10,3,12,3,9,35,25.7,26,27,1,26,12,30,7,0
Lucas Ramos,BRA,FW,Internacional,22,2001,0.0,0,0,0,0,0,0,0,,0,0,0,0,0,0,0,0
Raí Ramos,BRA,DF,São Paulo,28,1994,3.1,5,4,4,1,0,5,7,71.4,2,2,1,1,1,6,7,0
Marcelo Rangel,BRA,GK,Goiás,34,1988,3.0,0,0,0,0,0,0,0,,0,0,0,0,0,0,0,0
Pedro Rangel,BRA,GK,Fluminense,22,2000,2.0,0,0,0,0,0,0,0,,0,0,0,0,0,0,1,0
Raniele,BRA,"MF,DF",Cuiabá,26,1996,32.1,74,41,30,39,5,30,76,39.5,46,52,28,24,37,111,99,0
Rafael Ratão,BRA,"FW,MF",Bahia,27,1995,8.7,25,17,11,11,3,13,29,44.8,16,7,0,7,2,27,3,0
Wellington Rato,BRA,"FW,MF",São Paulo,30,1992,19.6,23,13,14,8,1,14,30,46.7,16,17,3,14,6,29,26,0
Raul,BRA,"MF,DF",Red Bull Bragantino,26,1996,1.2,3,0,2,0,1,2,3,66.7,1,2,1,1,1,4,2,0
Pedro Raul,BRA,FW,Vasco da Gama,26,1996,9.3,3,2,0,1,2,1,6,16.7,5,7,3,4,5,8,11,0
Leonardo Realpe,ECU,DF,Red Bull Bragantino,21,2001,18.7,24,10,16,7,1,13,25,52.0,12,10,7,3,25,49,69,0
Reinaldo,BRA,FW,Ath Paranaense,21,2001,0.2,1,1,0,1,0,0,0,,0,0,0,0,0,1,0,0
Reinaldo,BRA,DF,Grêmio,33,1989,29.8,40,20,18,16,6,26,42,61.9,16,21,5,16,16,56,73,0
Renê,BRA,DF,Internacional,30,1992,25.4,53,33,28,24,1,33,58,56.9,25,30,5,25,36,89,90,1
Réver,BRA,"DF,FW",Atlético Mineiro,38,1985,1.3,0,0,0,0,0,0,0,,0,2,2,0,1,1,11,0
Rezende,BRA,"MF,DF",Bahia,28,1995,30.1,95,60,53,40,2,29,70,41.4,41,69,10,59,63,158,69,1
Everton Ribeiro,BRA,"FW,MF",Flamengo,33,1989,16.4,24,14,9,11,4,11,41,26.8,30,10,4,6,10,34,4,0
João Ricardo Riedi,BRA,GK,Fortaleza,34,1988,31.9,0,0,0,0,0,0,0,,0,0,0,0,1,1,5,3
Zé Ricardo,BRA,MF,Goiás,23,1999,11.9,25,14,12,10,3,9,28,32.1,19,20,9,11,15,40,13,1
Richard,BRA,MF,Cruzeiro,28,1994,3.8,9,6,4,5,0,3,4,75.0,1,6,0,6,7,16,5,0
Rikelme,BRA,DF,Cuiabá,19,2003,26.0,61,46,39,15,7,39,78,50.0,39,33,7,26,40,101,87,1
Tomás Rincón,VEN,MF,Santos,35,1988,13.2,30,16,7,19,4,13,35,37.1,22,16,1,15,24,54,26,1
Richard Ríos,COL,MF,Palmeiras,22,2000,20.6,45,33,19,21,5,19,60,31.7,41,39,3,36,19,64,23,1
Robert,BRA,"MF,FW",Cruzeiro,17,2005,2.1,5,2,4,1,0,3,8,37.5,5,4,0,4,1,6,2,0
Zé Roberto,BRA,"FW,MF",Coritiba,29,1993,5.8,5,4,1,3,1,0,5,0.0,5,4,1,3,1,6,6,0
Robson,BRA,"MF,FW",Coritiba,31,1991,26.1,52,29,23,23,6,20,56,35.7,36,28,5,23,20,72,28,1
Kaique Rocha,BRA,DF,Ath Paranaense,21,2001,7.2,6,3,3,2,1,3,4,75.0,1,8,3,5,13,19,46,0
Marcos Rocha,BRA,DF,Palmeiras,34,1988,14.0,38,22,19,14,5,15,31,48.4,16,15,3,12,8,46,23,0
Pedro Rocha Neves,BRA,FW,Fortaleza,28,1994,0.4,1,0,0,1,0,0,1,0.0,1,0,0,0,0,1,0,0
Sergio Rochet,URU,GK,Internacional,29,1993,19.0,0,0,0,0,0,0,1,0.0,1,0,0,0,0,0,3,5
Rodrigo,BRA,"MF,FW",São Paulo,18,2004,2.6,4,3,2,2,0,3,10,30.0,7,2,0,2,2,6,4,0
James Rodríguez,COL,"MF,FW",São Paulo,31,1991,7.1,7,4,0,3,4,5,11,45.5,6,2,0,2,0,7,1,0
Rodriguinho,BRA,"DF,MF",América (MG),19,2003,13.9,24,16,17,7,0,13,38,34.2,25,18,2,16,9,33,21,0
Matías Rojas,PAR,"MF,FW",Corinthians,27,1995,7.0,7,4,1,5,1,3,11,27.3,8,7,1,6,1,8,4,0
Romarinho,BRA,"FW,MF",Fortaleza,28,1994,3.2,1,1,0,1,0,0,6,0.0,6,1,0,1,1,2,0,0
Ángel Romero,PAR,FW,Corinthians,30,1992,13.3,26,14,13,11,2,16,40,40.0,24,14,0,14,6,32,17,0
Silvio Romero,ARG,FW,Fortaleza,34,1988,4.4,2,2,0,1,1,1,3,33.3,2,3,0,3,0,2,4,0
Rômulo,BRA,"FW,MF",Ath Paranaense,20,2002,5.7,15,8,5,8,2,5,16,31.3,11,5,0,5,5,20,8,0
Romulo,BRA,"MF,DF",Internacional,22,2000,13.5,26,17,8,13,5,15,24,62.5,9,18,4,14,17,43,31,0
Ronald,BRA,MF,Grêmio,19,2003,4.6,11,4,3,6,2,8,14,57.1,6,4,3,1,3,14,10,0
Ronald,BRA,MF,Cuiabá,25,1997,6.5,20,9,8,10,2,8,26,30.8,18,4,0,4,9,29,7,0
Budiga Roni,BRA,MF,Corinthians,23,1999,7.5,23,13,12,11,0,10,26,38.5,16,15,6,9,6,29,12,0
Lucas Ronier,BRA,"FW,MF",Coritiba,18,2004,0.6,1,1,1,0,0,1,2,50.0,1,1,0,1,0,1,0,0
Rony,BRA,FW,Palmeiras,27,1995,18.2,9,8,3,5,1,2,10,20.0,8,8,1,7,2,11,12,0
Vitor Roque,BRA,FW,Ath Paranaense,17,2005,19.0,19,10,8,8,3,7,18,38.9,11,12,2,10,2,21,2,0
Diego Rosa,BRA,"MF,DF",Bahia,20,2002,2.7,16,10,6,9,1,9,14,64.3,5,2,0,2,5,21,5,0
Rossi,BRA,"MF,FW",Vasco da Gama,29,1993,4.4,4,2,2,2,0,3,5,60.0,2,3,0,3,4,8,3,0
Agustín Rossi,ARG,GK,Flamengo,27,1995,15.0,0,0,0,0,0,0,0,,0,0,0,0,0,0,3,0
Rubens,BRA,"DF,MF",Atlético Mineiro,21,2001,15.0,80,48,47,22,11,30,56,53.6,26,16,3,13,19,99,58,0
Daniel Ruiz Rivera,COL,"FW,MF",Santos,21,2001,2.7,7,3,3,2,2,4,8,50.0,4,4,0,4,1,8,1,0
Rwan,BRA,"MF,FW",Vasco da Gama,21,2001,0.4,1,1,0,1,0,0,0,,0,0,0,0,0,1,0,0
Victor Sá,BRA,FW,Botafogo (RJ),28,1994,23.6,61,37,19,33,9,29,65,44.6,36,28,6,22,30,91,18,0
Arthur Sales,BRA,"FW,MF",Bahia,20,2002,3.2,3,3,0,0,3,0,1,0.0,1,3,0,3,0,3,1,0
Andreas Samaris,GRE,MF,Coritiba,33,1989,2.0,4,2,1,2,1,3,7,42.9,4,3,0,3,4,8,3,0
Philipe Sampaio,BRA,DF,Botafogo (RJ),28,1994,5.5,10,7,7,3,0,5,7,71.4,2,3,2,1,6,16,33,0
Sander,BRA,DF,Goiás,32,1990,17.1,38,24,19,18,1,25,42,59.5,17,19,5,14,23,61,47,0
Sandry,BRA,MF,Santos,20,2002,2.1,6,3,4,1,1,2,6,33.3,4,4,3,1,2,8,0,0
Alex Santana,BRA,MF,Ath Paranaense,27,1995,11.1,15,11,5,7,3,9,19,47.4,10,10,7,3,11,26,8,0
Santos,BRA,GK,Flamengo,32,1990,5.4,0,0,0,0,0,0,0,,0,0,0,0,0,0,3,2
Ademir Santos,BRA,"FW,MF",Bahia,27,1995,19.3,32,18,7,13,12,14,38,36.8,24,16,1,15,10,42,3,0
Allyson Aires dos Santos,BRA,DF,Cuiabá,32,1990,12.6,18,14,13,5,0,9,13,69.2,4,16,11,5,8,26,64,1
Andrey Santos,BRA,MF,Vasco da Gama,18,2004,4.7,15,7,9,4,2,5,22,22.7,17,5,1,4,11,26,7,1
Bruno Araújo dos Santos,BRA,DF,Goiás,29,1993,5.0,10,6,7,2,1,6,11,54.5,5,7,2,5,7,17,20,0
Eduardo Santos,BRA,DF,Red Bull Bragantino,25,1997,11.3,15,9,10,4,1,10,13,76.9,3,19,15,4,14,29,51,1
Fábio Santos,BRA,DF,Corinthians,37,1985,18.6,24,15,13,9,2,17,31,54.8,14,23,12,11,19,43,57,0
Juan Santos,BRA,FW,São Paulo,20,2002,14.2,20,15,9,10,1,6,13,46.2,7,11,1,10,6,26,13,0
Júnior Santos,BRA,FW,Botafogo (RJ),28,1994,24.0,37,24,16,13,8,18,33,54.5,15,33,5,28,12,49,21,1
Luis Eduardo Marques dos Santos,BRA,DF,Fortaleza,25,1997,4.3,12,7,7,2,3,5,8,62.5,3,14,3,11,6,18,10,0
Pedrinho Santos,BRA,"FW,MF",Corinthians,16,2006,6.9,9,4,7,2,0,6,14,42.9,8,6,2,4,5,14,3,0
Renzo Saravia,ARG,DF,Atlético Mineiro,29,1993,19.0,60,38,28,25,7,37,73,50.7,36,35,7,28,16,76,48,0
Eduardo Sasha,BRA,"FW,MF",Red Bull Bragantino,30,1992,24.8,15,5,1,11,3,4,12,33.3,8,8,2,6,10,25,15,0
Lucas Sasha,BRA,MF,Fortaleza,32,1990,11.3,58,40,30,27,1,29,66,43.9,37,21,2,19,27,85,22,0
Gustavo Sauer,BRA,"FW,MF",Botafogo (RJ),29,1993,2.9,6,4,2,1,3,4,11,36.4,7,2,1,1,3,9,1,0
Cleiton Schwengber,BRA,GK,Red Bull Bragantino,25,1997,33.0,0,0,0,0,0,0,1,0.0,1,0,0,0,2,2,19,2
Luis Segovia,ECU,DF,Botafogo (RJ),25,1997,1.1,0,0,0,0,0,0,0,,0,0,0,0,0,0,6,0
Matias Segovia,PAR,FW,Botafogo (RJ),20,2003,7.2,22,18,11,11,0,16,33,48.5,17,4,1,3,8,30,7,0
Sidimar,BRA,DF,Goiás,30,1992,11.2,14,6,10,3,1,3,7,42.9,4,13,11,2,11,25,80,0
Aderlan Silva,BRA,DF,Red Bull Bragantino,32,1990,15.8,54,31,30,21,3,30,69,43.5,39,21,2,19,26,80,26,0
Gabriel Silva,BRA,"FW,MF",Coritiba,20,2002,1.0,3,2,0,3,0,1,1,100.0,0,0,0,0,1,4,0,0
Kauan Silva,BRA,FW,Palmeiras,18,2004,0.0,0,0,0,0,0,0,0,,0,0,0,0,0,0,0,0
Luan Silva,BRA,MF,São Paulo,23,1999,6.8,13,5,6,6,1,6,13,46.2,7,8,2,6,9,22,6,0
Lucas Silva,BRA,MF,Cruzeiro,29,1993,16.4,28,18,8,14,6,15,22,68.2,7,12,1,11,9,37,5,1
Lucas Silva,BRA,MF,Grêmio,29,1993,2.5,10,6,5,5,0,4,7,57.1,3,1,0,1,1,11,3,0
Nathan Silva,BRA,DF,Atlético Mineiro,25,1997,4.0,3,2,3,0,0,2,2,100.0,0,3,2,1,0,3,14,0
Ricardo Silva,BRA,DF,América (MG),30,1992,17.9,25,17,19,6,0,18,28,64.3,10,27,17,10,26,51,94,1
Wellington Silva,BRA,FW,Cuiabá,30,1993,14.8,23,15,10,8,5,12,30,40.0,18,19,0,19,6,29,8,0
Maximiliano Silvera,URU,"MF,FW",Santos,25,1997,5.0,9,7,2,7,0,3,9,33.3,6,9,0,9,1,10,2,0
Simioni,BRA,MF,Goiás,19,2003,0.5,2,1,0,2,0,1,1,100.0,0,0,0,0,2,4,2,0
Jailson Siqueira,BRA,"MF,DF",Palmeiras,27,1995,1.8,4,3,1,2,1,2,5,40.0,3,1,0,1,2,6,3,0
Islam Slimani,ALG,FW,Coritiba,34,1988,9.1,2,0,0,1,1,0,6,0.0,6,6,1,5,0,2,14,0
Everton Soares,BRA,"FW,MF",Flamengo,26,1996,19.3,32,22,8,10,14,12,33,36.4,21,26,6,20,11,43,11,0
Tiquinho Soares,BRA,FW,Botafogo (RJ),32,1991,27.1,18,10,3,8,7,9,19,47.4,10,15,3,12,3,21,29,0
Fernando Sobral,BRA,MF,Cuiabá,28,1994,21.1,70,45,39,22,9,32,70,45.7,38,45,5,40,15,85,15,0
Yeferson Soteldo,VEN,"FW,MF",Santos,25,1997,17.3,16,9,5,9,2,5,16,31.3,11,10,0,10,6,22,6,0
Yago Souza,BRA,MF,América (MG),16,2006,0.2,0,0,0,0,0,0,0,,0,0,0,0,0,0,0,0
Everaldo Stum,BRA,FW,Bahia,31,1991,24.2,11,8,2,5,4,5,11,45.5,6,10,2,8,2,13,16,0
Luis Suárez,URU,FW,Grêmio,36,1987,32.0,10,5,2,2,6,4,20,20.0,16,9,2,7,3,13,5,0
Bruno Tabata,BRA,"MF,FW",Palmeiras,25,1997,1.4,1,1,0,1,0,0,3,0.0,3,0,0,0,0,1,2,0
Tadeu,BRA,GK,Goiás,30,1992,35.0,1,0,1,0,0,1,3,33.3,2,0,0,0,0,1,17,2
Talisson,BRA,FW,Red Bull Bragantino,20,2002,1.7,4,1,2,1,1,2,2,100.0,0,2,1,1,2,6,2,0
Tchê Tchê,BRA,"MF,DF",Botafogo (RJ),30,1992,29.5,32,19,14,15,3,12,33,36.4,21,16,3,13,13,45,25,0
Alex Teixeira,BRA,"FW,MF",Vasco da Gama,33,1990,12.6,9,6,2,6,1,2,4,50.0,2,5,0,5,1,10,4,0
David Terans,URU,"MF,FW",Ath Paranaense,28,1994,4.4,3,1,0,2,1,1,5,20.0,4,4,0,4,1,4,0,0
Miguel Terceros,BOL,"MF,FW",Santos,18,2004,0.4,0,0,0,0,0,0,0,,0,1,0,1,1,1,0,0
Thaciano,BRA,"MF,FW",Bahia,27,1995,32.1,49,25,15,28,6,24,55,43.6,31,41,8,33,26,75,26,0
Thiago,BRA,"FW,MF",Ath Paranaense,22,2000,2.5,5,3,3,2,0,3,7,42.9,4,1,0,1,1,6,0,0
Guilherme Tinga,BRA,DF,Fortaleza,29,1993,28.7,54,31,33,15,6,29,68,42.6,39,28,14,14,41,95,105,0
Titi,BRA,DF,Fortaleza,34,1988,31.6,48,35,30,16,2,25,43,58.1,18,29,18,11,34,82,116,1
Stênio Toledo,BRA,"FW,MF",Cruzeiro,19,2003,3.2,7,7,3,4,0,2,3,66.7,1,2,0,2,3,10,1,0
Uendel,BRA,DF,Cuiabá,34,1988,4.0,2,1,1,0,1,0,1,0.0,1,4,1,3,0,2,9,0
Júnior Urso,BRA,MF,Coritiba,33,1989,3.3,4,3,3,1,0,3,7,42.9,4,2,0,2,2,6,4,0
Bruno Uvini,BRA,DF,Grêmio,31,1991,16.1,16,11,11,4,1,10,19,52.6,9,28,19,9,22,38,67,0
Enner Valencia,ECU,FW,Internacional,33,1989,16.0,4,3,1,3,0,0,4,0.0,4,7,2,5,2,6,10,0
Vanderlan,BRA,DF,Palmeiras,20,2002,10.1,29,18,23,4,2,13,16,81.3,3,7,1,6,12,41,23,0
Rodrigo Varanda,BRA,"FW,MF",América (MG),20,2003,5.7,8,5,3,2,3,4,15,26.7,11,9,0,9,0,8,5,0
Guillermo Varela,URU,DF,Flamengo,29,1993,2.6,1,1,1,0,0,0,1,0.0,1,3,1,2,4,5,5,0
Eduardo Vargas,CHI,FW,Atlético Mineiro,33,1989,5.2,3,1,1,2,0,3,12,25.0,9,4,0,4,0,3,1,0
Pablo Vegetti,ARG,FW,Vasco da Gama,34,1988,19.9,7,5,1,4,2,2,18,11.1,16,18,8,10,4,11,36,0
Raphael Veiga,BRA,MF,Palmeiras,27,1995,27.3,27,13,10,12,5,10,28,35.7,18,12,0,12,7,34,17,0
Fausto Vera,ARG,MF,Corinthians,22,2000,15.3,27,12,13,11,3,14,47,29.8,33,28,10,18,17,44,30,0
Patrick Verhon,BRA,FW,Bahia,18,2004,0.0,0,0,0,0,0,0,0,,0,0,0,0,0,0,0,0
Lucas Veríssimo,BRA,DF,Corinthians,27,1995,14.5,19,11,11,6,2,13,16,81.3,3,17,11,6,10,29,76,0
Bruno Viana,BRA,DF,Coritiba,27,1995,9.0,11,6,7,4,0,5,8,62.5,3,14,8,6,12,23,40,0
Marcos Victor,BRA,DF,Bahia,21,2001,0.1,0,0,0,0,0,0,0,,0,0,0,0,0,0,0,0
Paulo Victor,BRA,DF,Vasco da Gama,21,2001,0.1,0,0,0,0,0,0,0,,0,0,0,0,0,0,0,0
Arturo Vidal,CHI,MF,Ath Paranaense,35,1987,4.2,11,8,3,6,2,2,7,28.6,5,2,1,1,6,17,4,0
Arturo Vidal,CHI,"MF,DF",Flamengo,35,1987,2.8,5,5,3,2,0,5,12,41.7,7,2,1,1,2,7,5,0
Felipe Vieira,,DF,Fluminense,,,2.3,3,1,2,1,0,2,2,100.0,0,2,1,1,4,7,7,0
Luan Vieira,BRA,"FW,MF",Grêmio,29,1993,0.6,1,1,0,1,0,0,1,0.0,1,2,2,0,0,1,0,0
Gustavo Vilar,BRA,DF,Coritiba,22,2000,1.0,0,0,0,0,0,0,0,,0,0,0,0,1,1,3,0
Pedro Vilhena,BRA,FW,São Paulo,20,2002,0.2,0,0,0,0,0,0,0,,0,0,0,0,0,0,0,0
Mathías Villasanti,PAR,MF,Grêmio,26,1997,29.4,94,57,46,37,11,42,115,36.5,73,47,11,36,34,128,48,0
Marcos Vinicios Sorriso,BRA,"FW,DF",Red Bull Bragantino,21,2001,10.4,22,15,5,11,6,5,13,38.5,8,18,0,18,8,30,6,0
Vinicius,BRA,MF,Santos,23,1999,0.3,0,0,0,0,0,0,0,,0,0,0,0,0,0,0,0
Vinícius,BRA,FW,Goiás,29,1993,13.0,19,14,7,9,3,9,21,42.9,12,8,1,7,12,31,24,0
Vinícius,BRA,FW,Grêmio,31,1991,7.3,3,1,1,2,0,2,10,20.0,8,5,0,5,7,10,5,0
Marcos Vinicius,BRA,"DF,MF",Coritiba,25,1997,1.9,4,4,1,3,0,1,2,50.0,1,0,0,0,4,8,6,0
Mateus Vital,BRA,MF,Cruzeiro,24,1998,20.9,24,14,8,14,2,10,24,41.7,14,14,1,13,7,31,4,0
Vitão,BRA,DF,Internacional,22,2000,22.7,16,13,10,6,0,9,23,39.1,14,25,16,9,16,32,104,0
Vitão,BRA,DF,Cuiabá,22,2000,0.1,0,0,0,0,0,0,1,0.0,1,1,1,0,0,0,1,0
Vitinho,BRA,"FW,MF",Red Bull Bragantino,23,1999,22.8,35,21,12,18,5,10,43,23.3,33,28,1,27,11,46,10,0
Paulo Vitor,BRA,"MF,DF",Cruzeiro,23,1999,1.4,2,2,0,2,0,0,2,0.0,2,2,1,1,0,2,1,0
Paulo Vitor,BRA,MF,Atlético Mineiro,18,2004,0.2,0,0,0,0,0,0,2,0.0,2,0,0,0,1,1,0,0
Rayan Vitor,BRA,"FW,MF",Vasco da Gama,16,2006,2.9,2,1,0,2,0,0,2,0.0,2,1,0,1,0,2,2,0
Zé Vitor,BRA,DF,Vasco da Gama,20,2002,1.2,0,0,0,0,0,0,1,0.0,1,4,2,2,0,0,4,0
Vladimir,BRA,GK,Santos,33,1989,2.3,0,0,0,0,0,0,1,0.0,1,0,0,0,0,0,0,1
Walter,BRA,GK,Cuiabá,35,1987,35.0,0,0,0,0,0,0,0,,0,0,0,0,2,2,9,1
Talles Wander,BRA,"FW,MF",São Paulo,19,2003,0.2,0,0,0,0,0,0,1,0.0,1,0,0,0,0,0,1,0
Wanderson,BRA,DF,América (MG),31,1991,5.6,5,4,4,0,1,1,7,14.3,6,6,4,2,4,9,28,0
Wanderson,BRA,"FW,MF",Internacional,28,1994,26.0,35,24,12,14,9,15,41,36.6,26,19,3,16,16,51,13,0
Deivid Washington,BRA,FW,Santos,17,2005,4.7,4,1,0,1,3,2,8,25.0,6,4,0,4,1,5,3,0
Welington,BRA,DF,São Paulo,21,2001,10.4,17,13,10,3,4,12,19,63.2,7,10,3,7,3,20,26,0
José Welison,BRA,MF,Fortaleza,27,1995,18.6,49,30,20,25,4,18,34,52.9,16,23,5,18,23,72,24,0
João Wellington,BRA,MF,Cruzeiro,19,2004,4.1,5,4,4,1,0,2,3,66.7,1,4,0,4,1,6,10,0
Wesley,BRA,"FW,MF",Cruzeiro,23,1999,19.7,36,23,12,20,4,17,47,36.2,30,17,0,17,12,48,9,0
Wesley,BRA,DF,Flamengo,19,2003,27.9,74,48,43,25,6,33,70,47.1,37,24,10,14,40,114,63,1
Wesley,BRA,"FW,MF",Corinthians,17,2005,9.6,15,11,8,5,2,9,22,40.9,13,8,0,8,6,21,4,0
Wesley,BRA,DF,Grêmio,19,2004,1.0,3,2,2,1,0,2,3,66.7,1,0,0,0,1,4,0,1
Wéverton,BRA,GK,Palmeiras,35,1987,35.0,0,0,0,0,0,0,1,0.0,1,1,0,1,1,1,10,1
William,BRA,DF,Cruzeiro,27,1995,29.4,66,39,38,17,11,32,85,37.6,53,53,4,49,49,115,58,1
Willian,BRA,"FW,MF",Ath Paranaense,36,1986,6.4,9,7,0,7,2,2,8,25.0,6,3,0,3,1,10,0,0
Willian,BRA,MF,Goiás,29,1993,24.4,53,31,21,28,4,24,50,48.0,26,30,15,15,49,102,61,1
Xavier,BRA,DF,Goiás,22,2000,0.7,5,4,3,2,0,2,4,50.0,2,0,0,0,1,6,1,0
Samuel Xavier,BRA,DF,Fluminense,32,1990,23.4,29,18,12,11,6,20,30,66.7,10,27,12,15,16,45,32,0
Yago,BRA,MF,Bahia,27,1995,15.1,45,25,15,18,12,23,54,42.6,31,22,2,20,16,61,14,1
Vinícius Zanocelo,BRA,"MF,FW",Fortaleza,22,2001,0.9,1,1,1,0,0,1,4,25.0,3,2,1,1,3,4,3,0
Bruno Zapelli,ARG,"MF,FW",Ath Paranaense,20,2002,12.7,16,7,6,8,2,13,21,61.9,8,17,1,16,7,23,3,0
Federico Zaracho,ARG,"MF,FW",Atlético Mineiro,24,1998,21.6,71,42,27,37,7,26,91,28.6,65,29,4,25,31,102,21,0
Zinho,BRA,"FW,MF",Grêmio,19,2003,2.7,2,2,1,0,1,0,8,0.0,8,1,0,1,1,3,1,0
